Levy Year,School District Name,School District Code,Number of Basic Exemptions,Amount of Basic Reimbursement ,Number of Enhanced Exemptions,Amount of Enhanced Reimbursement ,Total Amount of Reimbursement ,Data Preparation Date
2019,Albany,010100,7405,4638527,2206,2977857,7616384,04/22/2020
2019,Cohoes,010300,1571,834586,678,782924,1617510,04/22/2020
2019,Watervliet,011800,920,395238,361,339728,734966,04/22/2020
2019,Berne-Knox-Westerlo,012001,1304,711291,454,542370,1253661,04/22/2020
2019,Bethlehem,012206,4861,2913813,972,1327910,4241723,04/22/2020
2019,Ravena-Coeymans-Selkirk,012402,2182,1304820,800,1052114,2356934,04/22/2020
2019,South Colonie,012601,7038,3632068,2418,2791945,6424013,04/22/2020
2019,North Colonie,012605,6024,2967064,1539,1712959,4680023,04/22/2020
2019,Menands,012615,289,150303,80,94727,245030,04/22/2020
2019,Green Island,012801,181,102388,104,134722,237110,04/22/2020
2019,Guilderland,013002,5386,2822315,1590,1902907,4725222,04/22/2020
2019,Voorheesville,013403,1442,782802,396,490493,1273295,04/22/2020
2019,Alfred-Almond,022001,683,464353,269,380992,845345,04/22/2020
2019,Andover,023001,343,234430,170,224333,458763,04/22/2020
2019,Genesee Valley,023202,593,249981,326,278729,528710,04/22/2020
2019,Belfast,023401,362,166128,211,188834,354962,04/22/2020
2019,Canaseraga,024002,287,157646,163,174828,332474,04/22/2020
2019,Cuba-Rushford,024801,1039,420844,563,454772,875616,04/22/2020
2019,Friendship,025001,315,200050,160,186410,386460,04/22/2020
2019,Fillmore,025801,587,219360,287,219639,438999,04/22/2020
2019,Whitesville,026001,178,94355,97,95981,190336,04/22/2020
2019,Scio,026601,360,233262,194,238810,472072,04/22/2020
2019,Wellsville,027001,1222,760188,703,833964,1594152,04/22/2020
2019,Bolivar-Richburg,027602,727,312534,361,285230,597764,04/22/2020
2019,Binghamton,030200,4018,2631242,2103,2755900,5387142,04/22/2020
2019,Chenango Forks,032001,1649,1108780,692,1007296,2116076,04/22/2020
2019,South Mountain-Hickory,032201,85,6434,19,3294,9728,04/22/2020
2019,Harpursville,032601,884,372026,401,354900,726926,04/22/2020
2019,Susquehanna Valley,032801,1908,1535493,926,1658015,3193508,04/22/2020
2019,Chenango Valley,033001,2012,1590419,1014,1790035,3380454,04/22/2020
2019,Maine-Endwell,033801,2757,2162062,1097,1859016,4021078,04/22/2020
2019,Deposit,034201,470,179443,314,255140,434583,04/22/2020
2019,Whitney Point,034401,1406,794771,545,653529,1448300,04/22/2020
2019,Union-Endicott,034601,4112,2913256,2103,3319269,6232525,04/22/2020
2019,Johnson City,034602,2306,1564904,1280,1874780,3439684,04/22/2020
2019,Vestal,034801,4069,2634890,1630,2348044,4982934,04/22/2020
2019,Windsor,035001,1652,1000414,733,942989,1943403,04/22/2020
2019,Olean,041200,1954,1266010,1000,1183719,2449729,04/22/2020
2019,Salamanca,041600,704,25481,449,29831,55312,04/22/2020
2019,Allegany-Limestone,042001,1187,569478,608,558808,1128286,04/22/2020
2019,West Valley,042204,381,211542,202,244988,456530,04/22/2020
2019,Ellicottville,043601,517,126131,266,151432,277563,04/22/2020
2019,Franklinville,044001,774,395214,363,362332,757546,04/22/2020
2019,Hinsdale,044601,493,132440,219,121294,253734,04/22/2020
2019,Cattaraugus - Little Valley,046402,1168,426840,498,366825,793665,04/22/2020
2019,Gowanda,047201,1203,531532,524,465222,996754,04/22/2020
2019,Portville,047401,830,539729,425,554748,1094477,04/22/2020
2019,Randolph,047601,979,280577,439,254279,534856,04/22/2020
2019,Yorkshire-Pioneer,048401,2661,1019049,1119,896736,1915785,04/22/2020
2019,Auburn,050100,3885,2069197,1768,2078316,4147513,04/22/2020
2019,Weedsport,052201,899,565561,408,567384,1132945,04/22/2020
2019,Cato-Meridian,052401,1055,536242,421,489647,1025889,04/22/2020
2019,Southern Cayuga,053001,997,390456,358,306973,697429,04/22/2020
2019,Port Byron,053801,1006,613699,498,641200,1254899,04/22/2020
2019,Moravia,054201,1046,440091,455,416685,856776,04/22/2020
2019,Union Springs,055401,971,396873,408,369183,766056,04/22/2020
2019,Dunkirk,060300,1632,863780,1083,1117868,1981648,04/22/2020
2019,Jamestown,060800,3367,1885800,1667,1671071,3556871,04/22/2020
2019,Southwestern,062201,1547,898006,812,1000928,1898934,04/22/2020
2019,Frewsburg,062401,816,600776,389,606541,1207317,04/22/2020
2019,Cassadaga Valley,062601,1105,496779,543,494001,990780,04/22/2020
2019,Chautauqua Lake,062803,888,232981,473,258631,491612,04/22/2020
2019,Pine Valley,063001,712,347560,269,268844,616404,04/22/2020
2019,Clymer,063201,477,191587,238,214622,406209,04/22/2020
2019,Bemus Point,063601,839,357614,421,383410,741024,04/22/2020
2019,Falconer,063801,1172,630974,631,696086,1327060,04/22/2020
2019,Silver Creek,064601,921,464686,511,544461,1009147,04/22/2020
2019,Forestville,064603,733,374011,349,384521,758532,04/22/2020
2019,Panama,064801,616,284194,263,326195,610389,04/22/2020
2019,Fredonia,065801,1634,1067710,790,1163189,2230899,04/22/2020
2019,Brocton,066001,568,441090,335,541412,982502,04/22/2020
2019,Ripley,066201,325,211334,207,265612,476946,04/22/2020
2019,Sherman,066601,427,205793,216,213652,419445,04/22/2020
2019,Westfield,067201,714,415145,460,554349,969494,04/22/2020
2019,Elmira,070400,5662,3369003,2692,3311175,6680178,04/22/2020
2019,Horseheads,073401,4265,2249245,1924,2283546,4532791,04/22/2020
2019,Elmira Heights,073402,951,618566,469,658826,1277392,04/22/2020
2019,Norwich,081100,1687,928183,728,824205,1752388,04/22/2020
2019,Afton,082001,609,343837,336,390351,734188,04/22/2020
2019,Bainbridge-Guilford,082201,883,496349,445,526700,1023049,04/22/2020
2019,Greene,083001,1123,570528,487,541620,1112148,04/22/2020
2019,Unadilla Valley,083803,810,330157,379,327770,657927,04/22/2020
2019,Georgetown-So Otselic Valley,084401,423,208917,171,179186,388103,04/22/2020
2019,Oxford Academy,084601,784,428025,381,426034,854059,04/22/2020
2019,Sherburne-Earlville,085601,1260,562258,610,573778,1136036,04/22/2020
2019,Plattsburgh,091300,1505,1011500,725,1055243,2066743,04/22/2020
2019,Ausable Valley,092201,1476,730606,673,677889,1408495,04/22/2020
2019,Beekmantown,092401,2109,1070531,928,970360,2040891,04/22/2020
2019,Northeastern Clinton,092801,1522,906320,679,859317,1765637,04/22/2020
2019,Chazy,093001,539,320935,223,286865,607800,04/22/2020
2019,Northern Adirondack,093601,1041,349830,449,302221,652051,04/22/2020
2019,Peru,094001,2035,1182922,730,896418,2079340,04/22/2020
2019,Saranac,094401,1856,1092708,731,902357,1995065,04/22/2020
2019,Hudson,100600,1563,712860,688,695071,1407931,04/22/2020
2019,Taconic Hills,102801,1559,518420,684,504083,1022503,04/22/2020
2019,Germantown,103602,686,281867,321,287550,569417,04/22/2020
2019,Chatham,103801,1428,665612,505,518260,1183872,04/22/2020
2019,Kinderhook,104401,2210,1131405,807,916277,2047682,04/22/2020
2019,New Lebanon,104801,670,261257,267,226810,488067,04/22/2020
2019,Cortland,110200,2099,1081590,1080,1253953,2335543,04/22/2020
2019,Cincinnatus,112001,547,271311,291,300718,572029,04/22/2020
2019,Mc Graw,112204,557,299034,240,276581,575615,04/22/2020
2019,Homer,113001,1981,1134554,848,1082276,2216830,04/22/2020
2019,Marathon,113401,713,302142,319,273063,575205,04/22/2020
2019,Andes,122002,178,38482,147,70329,108811,04/22/2020
2019,Downsville,122401,334,91047,177,107689,198736,04/22/2020
2019,Charlotte Valley,122601,438,164329,261,205091,369420,04/22/2020
2019,Delhi,122801,1033,417303,485,438632,855935,04/22/2020
2019,Franklin,123201,344,136036,159,141624,277660,04/22/2020
2019,Hancock,123606,337,121936,220,176926,298862,04/22/2020
2019,Margaretville,124601,459,113777,356,198457,312234,04/22/2020
2019,Roxbury,124802,349,127979,242,198503,326482,04/22/2020
2019,Sidney,125001,1024,485456,573,582682,1068138,04/22/2020
2019,Stamford,125201,423,199778,229,240965,440743,04/22/2020
2019,South Kortright,125202,438,192499,254,240478,432977,04/22/2020
2019,Walton,125601,973,345896,510,396352,742248,04/22/2020
2019,Beacon,130200,2692,1623538,818,1132457,2755995,04/22/2020
2019,Poughkeepsie,131300,2101,1221964,777,1025232,2247196,04/22/2020
2019,Dover,132602,1204,1054694,350,658924,1713618,04/22/2020
2019,Hyde Park,133201,4131,3613292,1452,2758835,6372127,04/22/2020
2019,Northeast,133801,662,293411,317,310751,604162,04/22/2020
2019,Pawling,134001,1318,1145444,386,761599,1907043,04/22/2020
2019,Pine Plains,134201,1370,620829,536,550715,1171544,04/22/2020
2019,Arlington,134601,8437,7624269,1979,3907774,11532043,04/22/2020
2019,Spackenkill,134602,1353,1240563,336,659641,1900204,04/22/2020
2019,Red Hook,134801,1733,1346703,645,1134570,2481273,04/22/2020
2019,Rhinebeck,135001,1301,763358,537,705575,1468933,04/22/2020
2019,Wappingers,135601,12124,7489515,3240,4441888,11931403,04/22/2020
2019,Millbrook,135801,1075,582656,324,401895,984551,04/22/2020
2019,Buffalo,140200,22105,5609682,6357,3064732,8674414,04/22/2020
2019,Lackawanna,140900,2037,683974,1022,672567,1356541,04/22/2020
2019,Tonawanda,141600,2481,1170353,1174,1242571,2412924,04/22/2020
2019,Alden,142001,2208,1121170,898,1008954,2130124,04/22/2020
2019,Amherst,142201,3968,2309975,1204,1581126,3891101,04/22/2020
2019,Williamsville,142203,11870,5919147,3617,4024752,9943899,04/22/2020
2019,Sweet Home,142207,3982,1604528,1871,1717100,3321628,04/22/2020
2019,East Aurora,142401,2250,993560,859,861767,1855327,04/22/2020
2019,Cheektowaga,143001,2966,1459977,1420,1480169,2940146,04/22/2020
2019,Cheektowaga-Maryvale,143002,2946,1551564,1525,1788775,3340339,04/22/2020
2019,Cleveland Hill,143003,1947,1494167,690,1160832,2654999,04/22/2020
2019,Depew,143007,2459,1487902,1277,1753123,3241025,04/22/2020
2019,Cheektowaga-Sloan,143009,1885,1691810,945,1898737,3590547,04/22/2020
2019,Clarence,143201,4695,1913911,1443,1273180,3187091,04/22/2020
2019,Springville-Griffith,143801,2338,1168707,916,1002314,2171021,04/22/2020
2019,Eden,144001,1947,1070252,728,908699,1978951,04/22/2020
2019,Iroquois,144201,3397,1567516,1344,1397904,2965420,04/22/2020
2019,Evans-Brant,144401,2823,1339327,1324,1331670,2670997,04/22/2020
2019,Grand Island,144601,3771,2067093,1249,1553163,3620256,04/22/2020
2019,Hamburg,144801,4240,2363922,1663,2103017,4466939,04/22/2020
2019,Frontier,144804,6294,2679232,2547,2409487,5088719,04/22/2020
2019,Holland,145001,1338,529548,476,422149,951697,04/22/2020
2019,Lancaster,145201,7781,3578580,2849,2873929,6452509,04/22/2020
2019,Akron,145601,1587,684275,744,675883,1360158,04/22/2020
2019,North Collins,145801,799,399172,301,329523,728695,04/22/2020
2019,Orchard Park,146001,5536,2966073,1879,2286495,5252568,04/22/2020
2019,Kenmore,146401,11046,6328213,5307,6938796,13267009,04/22/2020
2019,West Seneca,146801,9117,4668313,4433,5024263,9692576,04/22/2020
2019,Crown Point,152203,314,94065,160,97651,191716,04/22/2020
2019,Boquet Valley,152402,587,234238,311,267169,501407,04/22/2020
2019,Keene,153001,103,47344,70,41052,88396,04/22/2020
2019,Minerva,153401,148,47114,108,70751,117865,04/22/2020
2019,Moriah,153601,694,372062,414,442868,814930,04/22/2020
2019,Newcomb,153801,83,6158,50,7907,14065,04/22/2020
2019,Lake Placid,154002,673,144178,341,146890,291068,04/22/2020
2019,Schroon Lake,154601,325,73991,192,94593,168584,04/22/2020
2019,Ticonderoga,154801,747,211397,481,289240,500637,04/22/2020
2019,Willsboro,155201,378,128360,239,160747,289107,04/22/2020
2019,Tupper Lake,162001,922,345428,403,309053,654481,04/22/2020
2019,Chateaugay,163401,571,225476,261,223521,448997,04/22/2020
2019,Salmon River,164201,613,184252,324,201274,385526,04/22/2020
2019,Saranac Lake,164601,1623,450595,577,347946,798541,04/22/2020
2019,Malone,164801,2369,1119990,1078,1032666,2152656,04/22/2020
2019,Brushton-Moira,165001,805,398957,343,355707,754664,04/22/2020
2019,St. Regis Falls,165401,353,176518,193,191683,368201,04/22/2020
2019,Gloversville,170500,2115,1354568,1159,1407658,2762226,04/22/2020
2019,Johnstown,170800,1646,739559,726,704554,1444113,04/22/2020
2019,Broadalbin-Perth,172201,1831,953859,809,898753,1852612,04/22/2020
2019,Wheelerville,172401,251,61036,156,83537,144573,04/22/2020
2019,Mayfield,173001,1004,490269,544,561564,1051833,04/22/2020
2019,Northville,173201,451,144156,254,183409,327565,04/22/2020
2019,Batavia,180200,2315,1472626,972,1345004,2817630,04/22/2020
2019,Alexander,182202,966,595861,380,523122,1118983,04/22/2020
2019,Byron-Bergen,183001,1246,899595,486,720668,1620263,04/22/2020
2019,Elba,183401,467,281561,196,257588,539149,04/22/2020
2019,Le Roy,183601,1308,904509,514,776243,1680752,04/22/2020
2019,Oakfield-Alabama,183801,867,550314,334,471657,1021971,04/22/2020
2019,Pavilion,184001,854,517515,359,469526,987041,04/22/2020
2019,Pembroke,184202,1241,703191,495,627248,1330439,04/22/2020
2019,Cairo-Durham,192401,1249,496269,692,591409,1087678,04/22/2020
2019,Catskill,192601,1563,757014,688,726374,1483388,04/22/2020
2019,Coxsackie-Athens,192801,1426,673611,638,657206,1330817,04/22/2020
2019,Greenville,193201,1451,790669,646,768045,1558714,04/22/2020
2019,Hunter-Tannersville,193601,440,135859,283,189176,325035,04/22/2020
2019,Windham-Ashland-Jewett,194601,380,86952,238,120571,207523,04/22/2020
2019,Piseco,202001,63,3116,30,3317,6433,04/22/2020
2019,Indian Lake,202601,246,50362,147,65690,116052,04/22/2020
2019,Inlet,202801,57,5833,46,10774,16607,04/22/2020
2019,Lake Pleasant,203001,148,34157,92,47890,82047,04/22/2020
2019,Long Lake,203201,99,11429,81,21006,32435,04/22/2020
2019,Raquette Lake,203202,17,173,13,343,516,04/22/2020
2019,Wells,203601,158,45874,115,74774,120648,04/22/2020
2019,Little Falls,210900,975,790464,467,714445,1504909,04/22/2020
2019,West Canada Valley,212402,864,433844,327,357844,791688,04/22/2020
2019,Frankfort-Schuyler,212602,1132,737635,530,709558,1447193,04/22/2020
2019,Central Valley,212803,1947,1076436,980,1108172,2184608,04/22/2020
2019,Herkimer,213001,1079,690497,643,841900,1532397,04/22/2020
2019,Dolgeville,213602,798,304660,419,364445,669105,04/22/2020
2019,Poland,213803,817,315350,301,244319,559669,04/22/2020
2019,Van Hornesville-Owen D. Young,215001,242,118468,107,115396,233864,04/22/2020
2019,Town Of Webb,215401,340,29425,244,47650,77075,04/22/2020
2019,Mount Markham,215601,1186,641012,501,570309,1211321,04/22/2020
2019,Watertown,221800,2623,729195,1047,636631,1365826,04/22/2020
2019,South Jefferson,222001,1803,596779,587,420593,1017372,04/22/2020
2019,Alexandria,222202,653,203633,282,190923,394556,04/22/2020
2019,Indian River,222401,1425,134594,497,101715,236309,04/22/2020
2019,General Brown,222601,1570,434496,525,323773,758269,04/22/2020
2019,Thousand Islands,223201,1200,370451,557,379303,749754,04/22/2020
2019,Belleville-Henderson,223402,591,144479,306,163531,308010,04/22/2020
2019,Sackets Harbor,223801,482,164438,173,132141,296579,04/22/2020
2019,Lyme,224401,446,128934,228,145657,274591,04/22/2020
2019,La Fargeville,224601,461,119664,182,104992,224656,04/22/2020
2019,Carthage,226001,1892,426293,705,344472,770765,04/22/2020
2019,Copenhagen,232201,501,121473,167,88296,209769,04/22/2020
2019,Harrisville,232401,370,174590,230,212177,386767,04/22/2020
2019,Lowville,233601,1234,257401,510,230476,487877,04/22/2020
2019,South Lewis,234001,1229,455240,540,424718,879958,04/22/2020
2019,Beaver River,234401,1028,314369,408,276581,590950,04/22/2020
2019,Avon,242001,1030,748055,368,543744,1291799,04/22/2020
2019,Caledonia-Mumford,242201,1011,572965,426,523618,1096583,04/22/2020
2019,Geneseo,242601,1059,509910,376,404977,914887,04/22/2020
2019,Livonia,243401,1885,1157709,718,950301,2108010,04/22/2020
2019,Mount Morris,243601,462,357538,215,338602,696140,04/22/2020
2019,Dansville,243801,1563,765000,754,780916,1545916,04/22/2020
2019,Dalton-Nunda,244001,823,491776,398,484467,976243,04/22/2020
2019,York,245201,937,547508,367,454637,1002145,04/22/2020
2019,Oneida,251200,2009,1281131,1010,1406990,2688121,04/22/2020
2019,Brookfield,252009,237,107652,102,95493,203145,04/22/2020
2019,Cazenovia,252201,1659,834495,544,608310,1442805,04/22/2020
2019,De Ruyter,252401,420,196714,167,169177,365891,04/22/2020
2019,Morrisville-Eaton,252601,788,360713,295,284698,645411,04/22/2020
2019,Hamilton,253201,654,337439,249,283660,621099,04/22/2020
2019,Canastota,253601,1520,1048118,685,1023311,2071429,04/22/2020
2019,Madison,254001,480,264450,205,246212,510662,04/22/2020
2019,Stockbridge Valley,254601,505,281056,182,217316,498372,04/22/2020
2019,Chittenango,254801,2334,1558085,988,1378415,2936500,04/22/2020
2019,Rochester,261400,16509,6191562,4468,3087379,9278941,04/22/2020
2019,Brighton,262001,3264,2394320,1034,1677365,4071685,04/22/2020
2019,Gates-Chili,262601,5640,4339649,2807,4614892,8954541,04/22/2020
2019,Greece,262801,12610,8978018,5903,9397106,18375124,04/22/2020
2019,East Irondequoit,263401,4485,3766112,2097,3956881,7722993,04/22/2020
2019,West Irondequoit,263403,4413,3498117,1867,3358850,6856967,04/22/2020
2019,Honeoye Falls-Lima,263601,2255,1575616,645,1004107,2579723,04/22/2020
2019,Spencerport,263801,3910,2778343,1628,2602997,5381340,04/22/2020
2019,Hilton,264001,4751,3221881,2092,3162605,6384486,04/22/2020
2019,Penfield,264201,5339,3992943,1993,3333255,7326198,04/22/2020
2019,Fairport,264401,6796,4463741,2570,3764142,8227883,04/22/2020
2019,East Rochester,264413,1205,920981,615,977469,1898450,04/22/2020
2019,Pittsford,264601,4885,3697122,1296,2206573,5903695,04/22/2020
2019,Churchville-Chili,264801,4433,3002187,1735,2618599,5620786,04/22/2020
2019,Rush-Henrietta,265001,6687,3912686,2650,3450177,7362863,04/22/2020
2019,Brockport,265201,3618,2622129,1333,2073132,4695261,04/22/2020
2019,Webster,265401,9378,5780043,3873,5411044,11191087,04/22/2020
2019,Wheatland-Chili,265601,957,628363,422,600058,1228421,04/22/2020
2019,Amsterdam,270100,3001,1671159,1639,1862181,3533340,04/22/2020
2019,Canajoharie,272201,1008,568340,459,546499,1114839,04/22/2020
2019,Fonda-Fultonville,272801,1564,749952,599,607110,1357062,04/22/2020
2019,Fort Plain,273001,699,422169,410,510860,933029,04/22/2020
2019,Oppenheim-Ephratah-St.Johnsvil,273803,914,406884,512,471799,878683,04/22/2020
2019,Glen Cove,280500,2584,2501810,919,1937177,4438987,04/22/2020
2019,Long Beach,281000,4983,3986334,991,1709179,5695513,04/22/2020
2019,Hempstead,282001,2147,3146611,412,1281176,4427787,04/22/2020
2019,Uniondale,282002,4104,3936496,779,1618016,5554512,04/22/2020
2019,East Meadow,282003,8721,10312116,2434,5469691,15781807,04/22/2020
2019,North Bellmore,282004,4588,6377377,970,2901579,9278956,04/22/2020
2019,Levittown,282005,8735,14136088,2032,7128320,21264408,04/22/2020
2019,Seaford,282006,2998,4149004,659,1900523,6049527,04/22/2020
2019,Bellmore,282007,2098,2894894,409,1228998,4123892,04/22/2020
2019,Roosevelt,282008,1716,1927000,296,716092,2643092,04/22/2020
2019,Freeport,282009,4439,5781753,961,2544776,8326529,04/22/2020
2019,Baldwin,282010,5380,7962830,928,2878637,10841467,04/22/2020
2019,Oceanside,282011,6485,8047344,1330,3428378,11475722,04/22/2020
2019,Malverne,282012,2358,3417056,496,1565195,4982251,04/22/2020
2019,Valley Stream 13,282013,4776,5989441,1166,3050882,9040323,04/22/2020
2019,Hewlett-Woodmere,282014,2875,4963909,469,1723353,6687262,04/22/2020
2019,Lawrence,282015,3724,2670362,639,979869,3650231,04/22/2020
2019,Elmont,282016,6558,7689029,1242,3167723,10856752,04/22/2020
2019,Franklin Square,282017,4064,4166963,1106,2470792,6637755,04/22/2020
2019,Garden City,282018,2962,2627775,465,889416,3517191,04/22/2020
2019,East Rockaway,282019,1594,2285394,414,1246148,3531542,04/22/2020
2019,Lynbrook,282020,2797,4080766,579,1757254,5838020,04/22/2020
2019,Rockville Centre,282021,3036,4005771,502,1373530,5379301,04/22/2020
2019,Floral Park-Bellerose,282022,3234,3303931,633,1417189,4721120,04/22/2020
2019,Wantagh,282023,3230,4441976,565,1690255,6132231,04/22/2020
2019,Valley Stream 24,282024,1964,2312786,386,991309,3304095,04/22/2020
2019,Merrick,282025,3043,4485721,516,1659819,6145540,04/22/2020
2019,Island Trees,282026,2683,3186474,701,1808027,4994501,04/22/2020
2019,West Hempstead,282027,2675,3363027,596,1629427,4992454,04/22/2020
2019,North Merrick,282029,2547,3545980,533,1578926,5124906,04/22/2020
2019,Valley Stream 30,282030,2472,2950434,374,970348,3920782,04/22/2020
2019,Island Park,282031,1144,907869,265,458559,1366428,04/22/2020
2019,Westbury,282201,2344,3792047,579,1969030,5761077,04/22/2020
2019,East Williston,282202,1029,1195361,178,450149,1645510,04/22/2020
2019,Roslyn,282203,2060,2371261,317,783185,3154446,04/22/2020
2019,Port Washington,282204,3138,2956385,601,1221322,4177707,04/22/2020
2019,New Hyde Park-Garden City,282205,3785,3915658,856,1931659,5847317,04/22/2020
2019,Manhasset,282206,1608,1048530,225,319860,1368390,04/22/2020
2019,Great Neck,282207,5694,4189614,872,1385755,5575369,04/22/2020
2019,Herricks,282209,4032,4493328,796,1933692,6427020,04/22/2020
2019,Mineola,282210,3616,3709293,918,2044919,5754212,04/22/2020
2019,Carle Place,282211,1469,1652985,364,892790,2545775,04/22/2020
2019,North Shore,282401,2368,2230057,429,880758,3110815,04/22/2020
2019,Syosset,282402,4544,6294810,831,2082316,8377126,04/22/2020
2019,Locust Valley,282403,1984,1784417,360,706212,2490629,04/22/2020
2019,Plainview-Old Bethpage,282404,4836,6636933,991,2966189,9603122,04/22/2020
2019,Oyster Bay-East Norwich,282406,1543,1135180,276,437288,1572468,04/22/2020
2019,Jericho,282415,1583,1802333,213,529668,2332001,04/22/2020
2019,Hicksville,282417,6147,5628399,1553,3014228,8642627,04/22/2020
2019,Plainedge,282418,3555,5805806,882,3139460,8945266,04/22/2020
2019,Bethpage,282421,3344,3843767,965,1895338,5739105,04/22/2020
2019,Farmingdale,282422,6767,9257177,1676,4952898,14210075,04/22/2020
2019,Massapequa,282423,8490,10689336,1870,5087304,15776640,04/22/2020
2019,Lockport,290900,4430,3415690,1945,2852573,6268263,04/22/2020
2019,Niagara Falls,291100,5677,2571682,2885,2685224,5256906,04/22/2020
2019,North Tonawanda,291200,4791,2620055,2352,2892838,5512893,04/22/2020
2019,Lewiston-Porter,292401,2985,1509394,1419,1631335,3140729,04/22/2020
2019,Newfane,292801,1761,1280641,865,1299101,2579742,04/22/2020
2019,Niagara-Wheatfield,293001,4242,2157482,1895,2074192,4231674,04/22/2020
2019,Starpoint,293201,3445,2011034,1183,1562114,3573148,04/22/2020
2019,Royalton-Hartland,293601,1554,962831,695,961856,1924687,04/22/2020
2019,Barker,293801,850,377316,417,418515,795831,04/22/2020
2019,Wilson,294201,1395,913902,635,936980,1850882,04/22/2020
2019,Rome,301300,4621,3056536,2013,2818768,5875304,04/22/2020
2019,Utica,301600,5741,3124034,2473,2806751,5930785,04/22/2020
2019,Adirondack,302601,1585,641639,702,596981,1238620,04/22/2020
2019,Camden,303001,2220,924038,949,783320,1707358,04/22/2020
2019,Clinton,304001,1436,1113147,568,984356,2097503,04/22/2020
2019,New Hartford,304801,2935,2070436,1062,1648739,3719175,04/22/2020
2019,New York Mills,304804,679,432437,368,525666,958103,04/22/2020
2019,Sauquoit Valley,305002,1147,683645,404,523583,1207228,04/22/2020
2019,Remsen,305201,582,345247,270,351853,697100,04/22/2020
2019,Waterville,305401,950,498376,362,407034,905410,04/22/2020
2019,Holland Patent,305801,1747,1067514,653,866695,1934209,04/22/2020
2019,Sherrill,306000,2051,1254872,976,1274825,2529697,04/22/2020
2019,Westmoreland,306801,1273,950151,496,801660,1751811,04/22/2020
2019,Oriskany,307001,777,463504,321,419264,882768,04/22/2020
2019,Whitesboro,307002,4060,2581863,1649,2365182,4947045,04/22/2020
2019,Syracuse,311500,10983,4786192,4013,3609729,8395921,04/22/2020
2019,West Genesee,312001,5585,3749755,2538,3724659,7474414,04/22/2020
2019,North Syracuse,312403,10475,7176348,3812,5520894,12697242,04/22/2020
2019,East Syracuse-Minoa,312601,3646,2715674,1755,2725833,5441507,04/22/2020
2019,Jamesville-Dewitt,312611,2796,1910962,758,1142939,3053901,04/22/2020
2019,Jordan-Elbridge,312801,1331,1025768,592,921164,1946932,04/22/2020
2019,Fabius-Pompey,313001,848,652733,327,541045,1193778,04/22/2020
2019,Westhill,313201,2015,1625965,784,1402419,3028384,04/22/2020
2019,Solvay,313202,1337,1073301,792,1308577,2381878,04/22/2020
2019,La Fayette,313407,787,439020,292,347016,786036,04/22/2020
2019,Baldwinsville,313601,5930,4096560,2144,3244302,7340862,04/22/2020
2019,Fayetteville-Manlius,313801,3745,2836202,1172,1982192,4818394,04/22/2020
2019,Marcellus,314001,2051,1419620,752,1161607,2581227,04/22/2020
2019,Onondaga,314201,1097,853481,502,847652,1701133,04/22/2020
2019,Liverpool,314801,7561,5970590,3188,5410957,11381547,04/22/2020
2019,Lyncourt,314804,576,520696,348,582788,1103484,04/22/2020
2019,Skaneateles,315001,1382,557139,565,516164,1073303,04/22/2020
2019,Tully,315402,1035,607507,332,429978,1037485,04/22/2020
2019,Canandaigua,320200,3382,1878172,1358,1670244,3548416,04/22/2020
2019,Geneva,320500,1994,1258283,954,1310194,2568477,04/22/2020
2019,East Bloomfield,322601,1043,712272,409,612007,1324279,04/22/2020
2019,Gorham-Middlesex,323201,1674,691410,704,633111,1324521,04/22/2020
2019,Manchester-Shortsville,323601,913,747072,403,710058,1457130,04/22/2020
2019,Naples,323801,932,423008,451,453668,876676,04/22/2020
2019,Phelps-Clifton Springs,324001,1746,1243691,707,1090800,2334491,04/22/2020
2019,Honeoye,324201,1046,473955,497,498952,972907,04/22/2020
2019,Victor,324801,3590,1758936,1168,1261431,3020367,04/22/2020
2019,Middletown,330900,4372,3668018,1220,2261894,5929912,04/22/2020
2019,Newburgh,331100,7071,6027736,2369,4361445,10389181,04/22/2020
2019,Port Jervis,331300,1892,1759229,850,1663199,3422428,04/22/2020
2019,Washingtonville,332002,3824,3277110,778,1492392,4769502,04/22/2020
2019,Chester,332201,953,737841,272,478444,1216285,04/22/2020
2019,Cornwall,332401,2533,2242314,538,1075046,3317360,04/22/2020
2019,Pine Bush,332601,4500,3389079,1148,1913574,5302653,04/22/2020
2019,Goshen,333001,2291,1791897,565,1002256,2794153,04/22/2020
2019,Highland Falls,333601,615,473447,184,308526,781973,04/22/2020
2019,Minisink Valley,333801,3640,2756129,825,1395613,4151742,04/22/2020
2019,Monroe-Woodbury,334001,5605,4898866,1150,2268189,7167055,04/22/2020
2019,Kiryas Joel Village,334002,739,282918,85,70929,353847,04/22/2020
2019,Valley,334201,3857,3071386,1144,2033354,5104740,04/22/2020
2019,Tuxedo,335003,343,150172,79,79243,229415,04/22/2020
2019,Warwick Valley,335401,3557,2676496,896,1537481,4213977,04/22/2020
2019,Greenwood Lake,335411,1101,836949,277,492761,1329710,04/22/2020
2019,Florida,335415,852,759870,235,473166,1233036,04/22/2020
2019,Albion,342001,1778,825257,827,806101,1631358,04/22/2020
2019,Kendall,343007,895,423620,381,400798,824418,04/22/2020
2019,Holley,343204,1148,789548,523,766199,1555747,04/22/2020
2019,Medina,343401,1522,950538,793,1018468,1969006,04/22/2020
2019,Lyndonville,343801,716,338957,343,346204,685161,04/22/2020
2019,Fulton,350400,2692,2131796,1190,1908910,4040706,04/22/2020
2019,Oswego,351200,3781,2255627,1554,1906816,4162443,04/22/2020
2019,Altmar Parish-Williamstown,352002,1239,525261,480,427371,952632,04/22/2020
2019,Hannibal,353001,1234,835335,507,725133,1560468,04/22/2020
2019,Central Square,353201,4164,2307687,1533,1832094,4139781,04/22/2020
2019,Mexico,353401,2082,1133083,824,958328,2091411,04/22/2020
2019,Pulaski,355001,910,549435,377,493235,1042670,04/22/2020
2019,Sandy Creek,355201,902,390877,450,401048,791925,04/22/2020
2019,Phoenix,355401,1964,1600948,806,1427404,3028352,04/22/2020
2019,Oneonta,361200,1886,1071300,771,949753,2021053,04/22/2020
2019,Gilbertsville-Mt Upton,362202,516,178399,281,206748,385147,04/22/2020
2019,Cherry Valley-Springfield,362401,747,252456,317,235407,487863,04/22/2020
2019,Edmeston,362801,536,191986,195,153566,345552,04/22/2020
2019,Laurens,363401,434,208719,214,236869,445588,04/22/2020
2019,Schenevus,363601,441,219591,227,245165,464756,04/22/2020
2019,Milford,364001,515,225196,260,251921,477117,04/22/2020
2019,Morris,364201,471,226603,200,202857,429460,04/22/2020
2019,Otego-Unadilla,364801,1088,600601,509,613178,1213779,04/22/2020
2019,Cooperstown,365001,897,285622,409,292186,577808,04/22/2020
2019,Richfield Springs,365601,631,188820,359,234295,423115,04/22/2020
2019,Worcester,366606,445,248105,194,235252,483357,04/22/2020
2019,Mahopac,372001,4357,4601611,1018,2436920,7038531,04/22/2020
2019,Carmel,372002,4889,5937798,1180,3222805,9160603,04/22/2020
2019,Haldane,372601,747,608815,270,461495,1070310,04/22/2020
2019,Garrison,372604,309,140087,78,81029,221116,04/22/2020
2019,Putnam Valley,372803,1916,2521671,419,1225545,3747216,04/22/2020
2019,Brewster,373001,3407,3362153,905,2038074,5400227,04/22/2020
2019,Rensselaer,381400,947,440025,366,359432,799457,04/22/2020
2019,Troy,381700,2957,1775278,1096,1428112,3203390,04/22/2020
2019,Lansingburgh,381701,1840,945897,854,957589,1903486,04/22/2020
2019,Berlin,382001,1199,551544,493,475739,1027283,04/22/2020
2019,Brunswick,382202,1403,739554,528,603423,1342977,04/22/2020
2019,East Greenbush,382401,5028,2652000,1574,1817174,4469174,04/22/2020
2019,Hoosick Falls,382801,1217,666450,536,621393,1287843,04/22/2020
2019,North Greenbush,383201,287,43891,121,42317,86208,04/22/2020
2019,Wynantskill,383204,685,409780,296,399418,809198,04/22/2020
2019,Averill Park,384001,3524,1872125,1027,1212083,3084208,04/22/2020
2019,Hoosic Valley,384201,1195,575377,425,451192,1026569,04/22/2020
2019,Schodack,384401,1125,713656,345,490071,1203727,04/22/2020
2019,Clarkstown,392001,8102,7821942,1795,3958181,11780123,04/22/2020
2019,Nanuet,392008,1796,1991156,534,1336840,3327996,04/22/2020
2019,Haverstraw-Stony Point,392201,5803,10340645,1782,6641497,16982142,04/22/2020
2019,South Orangetown,392401,3357,3489601,737,1749928,5239529,04/22/2020
2019,Nyack,392404,2944,3861474,707,2178718,6040192,04/22/2020
2019,Pearl River,392408,2536,2777448,639,1595025,4372473,04/22/2020
2019,Ramapo,392601,3634,5264057,1019,3258255,8522312,04/22/2020
2019,East Ramapo,392602,7756,6971954,1719,3196924,10168878,04/22/2020
2019,Ogdensburg,401200,1507,1160740,663,951543,2112283,04/22/2020
2019,Brasher Falls,402001,1018,648564,439,569732,1218296,04/22/2020
2019,Canton,402201,1412,849370,484,604845,1454215,04/22/2020
2019,Clifton-Fine,402601,379,124533,199,121886,246419,04/22/2020
2019,Colton-Pierrepont,402801,489,211620,251,238909,450529,04/22/2020
2019,Edwards-Knox,403401,573,165350,250,149319,314669,04/22/2020
2019,Gouverneur,404001,1406,546462,624,463823,1010285,04/22/2020
2019,Hammond,404201,347,139119,132,112671,251790,04/22/2020
2019,Hermon-Dekalb,404401,424,212549,202,207177,419726,04/22/2020
2019,Lisbon,405002,646,354519,247,285974,640493,04/22/2020
2019,Madrid-Waddington,405601,746,380686,354,382096,762782,04/22/2020
2019,Massena,405801,2589,1384123,1195,1303435,2687558,04/22/2020
2019,Morristown,406001,467,204440,239,224160,428600,04/22/2020
2019,Norwood-Norfolk,406201,1121,812558,539,810493,1623051,04/22/2020
2019,Heuvelton,406404,709,419532,260,330127,749659,04/22/2020
2019,Parishville-Hopkinton,406601,478,192373,246,200443,392816,04/22/2020
2019,Potsdam,407402,1422,983018,502,735246,1718264,04/22/2020
2019,Mechanicville,411000,1288,713563,506,640382,1353945,04/22/2020
2019,Saratoga Springs,411500,6727,2922693,1745,1646104,4568797,04/22/2020
2019,Burnt Hills-Ballston Lake,412001,3838,2576396,1196,1826459,4402855,04/22/2020
2019,Shenendehowa,412402,10560,6755431,2422,3459525,10214956,04/22/2020
2019,Corinth,412601,1156,496923,517,469060,965983,04/22/2020
2019,Edinburg,413001,246,44456,147,57359,101815,04/22/2020
2019,Galway,413201,1289,644170,486,521233,1165403,04/22/2020
2019,Ballston Spa,414201,4059,2753969,1168,1665922,4419891,04/22/2020
2019,South Glens Falls,414401,3213,1945316,1055,1414200,3359516,04/22/2020
2019,Schuylerville,415001,1787,1256731,524,783897,2040628,04/22/2020
2019,Stillwater,415201,1317,619478,430,441103,1060581,04/22/2020
2019,Waterford-Halfmoon,415401,754,583228,334,555329,1138557,04/22/2020
2019,Schenectady,421500,5455,3655282,2139,2872777,6528059,04/22/2020
2019,Duanesburg,422001,1027,521112,331,369720,890832,04/22/2020
2019,Scotia-Glenville,422202,3187,1871239,1054,1384908,3256147,04/22/2020
2019,Niskayuna,422401,4281,2424601,902,1167429,3592030,04/22/2020
2019,Schalmont,422801,2513,1393707,974,1220893,2614600,04/22/2020
2019,Rotterdam-Mohonasen,422803,3592,1756189,1580,1742990,3499179,04/22/2020
2019,Cobleskill-Richmondville,432602,1733,984948,899,1059224,2044172,04/22/2020
2019,Gilboa-Conesville,433401,411,133977,280,188971,322948,04/22/2020
2019,Jefferson,433601,304,128160,174,157300,285460,04/22/2020
2019,Middleburgh,433801,903,556805,509,637989,1194794,04/22/2020
2019,Schoharie,434201,1092,691523,491,669189,1360712,04/22/2020
2019,Sharon Springs,434601,303,166291,165,198962,365253,04/22/2020
2019,Odessa-Montour,442001,931,403088,417,399954,803042,04/22/2020
2019,Watkins Glen,442401,1339,438898,628,457846,896744,04/22/2020
2019,South Seneca,452801,962,398387,466,421894,820281,04/22/2020
2019,Romulus,453003,502,243664,226,242258,485922,04/22/2020
2019,Seneca Falls,453201,1435,999827,663,992929,1992756,04/22/2020
2019,Waterloo,453801,1668,961741,768,961100,1922841,04/22/2020
2019,Corning,460300,4995,3586807,2092,3189797,6776604,04/22/2020
2019,Hornell,460600,1343,696161,609,611070,1307231,04/22/2020
2019,Addison,462001,1156,589464,542,558476,1147940,04/22/2020
2019,Avoca,462201,606,215933,302,217400,433333,04/22/2020
2019,Bath,462402,1400,701056,599,619010,1320066,04/22/2020
2019,Bradford,462601,334,154542,149,152350,306892,04/22/2020
2019,Campbell-Savona,463002,926,487561,372,415995,903556,04/22/2020
2019,Canisteo-Greenwood,463202,943,464722,518,507353,972075,04/22/2020
2019,Arkport,465201,513,324486,269,326985,651471,04/22/2020
2019,Jasper-Troupsburg,465601,509,204070,217,183755,387825,04/22/2020
2019,Prattsburgh,466001,500,200670,211,170671,371341,04/22/2020
2019,Hammondsport,467201,757,222951,364,236312,459263,04/22/2020
2019,Wayland-Cohocton,467401,1509,715564,735,725244,1440808,04/22/2020
2019,Babylon,472001,1811,2178730,333,905538,3084268,04/22/2020
2019,West Babylon,472002,4021,4676817,984,2587035,7263852,04/22/2020
2019,North Babylon,472003,4792,5160260,1340,3287205,8447465,04/22/2020
2019,Lindenhurst,472004,6254,7698601,1668,4673853,12372454,04/22/2020
2019,Copiague,472005,3555,4634374,1050,1832178,6466552,04/22/2020
2019,Amityville,472006,3072,3405842,999,2025569,5431411,04/22/2020
2019,Deer Park,472007,3881,4427080,1196,3085005,7512085,04/22/2020
2019,Wyandanch,472009,806,975669,194,530243,1505912,04/22/2020
2019,Three Village,472201,6048,7029608,1378,3581557,10611165,04/22/2020
2019,Brookhaven-Comsewogue,472203,3201,3579581,876,2121931,5701512,04/22/2020
2019,South Country,472204,3631,3612140,785,1753366,5365506,04/22/2020
2019,Sachem,472205,12835,11840712,3063,6294233,18134945,04/22/2020
2019,Port Jefferson,472206,1030,679666,210,312445,992111,04/22/2020
2019,Mount Sinai,472207,2189,2483334,598,1533095,4016429,04/22/2020
2019,Miller Place,472208,2640,3046349,460,1194307,4240656,04/22/2020
2019,Rocky Point,472209,2956,3816267,522,1483715,5299982,04/22/2020
2019,Middle Country,472211,9095,10342575,2449,6199927,16542502,04/22/2020
2019,Longwood,472212,8891,10635464,3097,7516379,18151843,04/22/2020
2019,Patchogue-Medford,472224,6968,8046864,1729,4348836,12395700,04/22/2020
2019,William Floyd,472232,6654,8463405,1559,4312875,12776280,04/22/2020
2019,Center Moriches,472233,1293,1553245,269,721761,2275006,04/22/2020
2019,East Moriches,472234,990,1161935,188,500129,1662064,04/22/2020
2019,Eastport- South Manor,472235,2961,3414411,832,1955070,5369481,04/22/2020
2019,East Hampton,472401,756,120358,197,69077,189435,04/22/2020
2019,Wainscott,472402,52,2123,12,1114,3237,04/22/2020
2019,Amagansett,472403,123,10891,45,9010,19901,04/22/2020
2019,Springs,472404,655,200970,208,144360,345330,04/22/2020
2019,Sag Harbor,472405,800,189102,322,174070,363172,04/22/2020
2019,Montauk,472406,369,54517,136,45728,100245,04/22/2020
2019,Elwood,472601,2077,2354148,504,1298522,3652670,04/22/2020
2019,Cold Spring Harbor,472602,665,633558,84,180985,814543,04/22/2020
2019,Huntington,472603,4572,4492290,1035,2284085,6776375,04/22/2020
2019,Northport-East Northport,472604,5971,4475443,1295,2203777,6679220,04/22/2020
2019,Half Hollow Hills,472605,6097,5514806,1637,3254002,8768808,04/22/2020
2019,Harborfields,472606,2785,2925058,580,1381998,4307056,04/22/2020
2019,Commack,472610,6162,6922006,1534,3941493,10863499,04/22/2020
2019,South Huntington,472613,5712,6305688,1469,3678691,9984379,04/22/2020
2019,Bay Shore,472801,4089,4771184,968,2507592,7278776,04/22/2020
2019,Islip,472802,2835,3614039,693,1911472,5525511,04/22/2020
2019,East Islip,472803,4074,4420628,1004,2643193,7063821,04/22/2020
2019,Sayville,472804,2987,3339512,738,1892079,5231591,04/22/2020
2019,Bayport-Blue Point,472805,2192,2862353,475,1325889,4188242,04/22/2020
2019,Hauppauge,472806,3657,2511531,970,1519585,4031116,04/22/2020
2019,Connetquot,472807,6325,6724958,1760,4146141,10871099,04/22/2020
2019,West Islip,472809,4754,5042645,1189,2887493,7930138,04/22/2020
2019,Brentwood,472812,7261,5644265,1884,3345959,8990224,04/22/2020
2019,Central Islip,472813,3974,4922349,1088,3035646,7957995,04/22/2020
2019,Fire Island,472814,69,6733,15,3344,10077,04/22/2020
2019,Shoreham-Wading River,473001,2235,2307833,618,1368681,3676514,04/22/2020
2019,Riverhead,473002,4775,3569931,2193,3397658,6967589,04/22/2020
2019,Shelter Island,473201,369,52105,146,47213,99318,04/22/2020
2019,Smithtown,473401,9070,9298960,2212,5034639,14333599,04/22/2020
2019,Kings Park,473405,3746,3463131,865,1800691,5263822,04/22/2020
2019,Remsenburg-Speonk,473601,242,67550,71,45299,112849,04/22/2020
2019,Westhampton Beach,473602,620,193530,185,129007,322537,04/22/2020
2019,Quogue,473603,122,11764,35,7789,19553,04/22/2020
2019,Hampton Bays,473605,1557,1008253,604,895540,1903793,04/22/2020
2019,Southhampton,473606,973,105789,323,79896,185685,04/22/2020
2019,Bridgehampton,473609,135,11910,40,8080,19990,04/22/2020
2019,Sagaponack,473610,22,243,2,50,293,04/22/2020
2019,Tuckahoe Common,473613,293,103611,130,103119,206730,04/22/2020
2019,East Quogue,473617,744,403299,232,276323,679622,04/22/2020
2019,Oysterponds,473802,268,46695,110,43633,90328,04/22/2020
2019,Fishers Island,473804,27,4723,2,797,5520,04/22/2020
2019,Southold,473805,1055,441401,393,378185,819586,04/22/2020
2019,Greenport,473810,428,218116,201,234800,452916,04/22/2020
2019,Mattituck-Cutchogue,473812,1495,630170,492,472010,1102180,04/22/2020
2019,New Suffolk,473815,60,10164,24,9255,19419,04/22/2020
2019,Fallsburg,482801,795,550915,311,449449,1000364,04/22/2020
2019,Eldred,483401,778,309029,303,269154,578183,04/22/2020
2019,Liberty,483601,949,667127,499,762833,1429960,04/22/2020
2019,Tri-Valley,484201,955,508555,356,396812,905367,04/22/2020
2019,Roscoe,484401,265,109980,136,123568,233548,04/22/2020
2019,Livingston Manor,484402,459,193405,233,208171,401576,04/22/2020
2019,Monticello,484601,2198,1071866,955,986068,2057934,04/22/2020
2019,Sullivan West,484802,1535,595176,810,690252,1285428,04/22/2020
2019,Waverly,492001,1426,630534,622,591686,1222220,04/22/2020
2019,Candor,492401,790,435115,379,437615,872730,04/22/2020
2019,Newark Valley,492602,1340,768423,571,714524,1482947,04/22/2020
2019,Owego-Apalachin,493001,2172,1290670,978,1245461,2536131,04/22/2020
2019,Spencer-Van Etten,493401,995,443137,460,488743,931880,04/22/2020
2019,Tioga,493603,867,255647,415,268450,524097,04/22/2020
2019,Ithaca,500700,5535,2826047,1721,1873106,4699153,04/22/2020
2019,Dryden,502401,1795,1201998,705,954806,2156804,04/22/2020
2019,Groton,502801,950,563574,413,527811,1091385,04/22/2020
2019,Lansing,503201,1161,699594,418,557756,1257350,04/22/2020
2019,Newfield,503401,800,428525,349,372626,801151,04/22/2020
2019,Trumansburg,503601,1239,661754,502,586937,1248691,04/22/2020
2019,Kingston,510800,6283,4118393,2688,3866501,7984894,04/22/2020
2019,Highland,513203,1759,1218608,538,821520,2040128,04/22/2020
2019,Rondout Valley,513401,2558,1344480,1077,1252141,2596621,04/22/2020
2019,Marlboro,513601,1720,1404491,530,934030,2338521,04/22/2020
2019,New Paltz,513801,2364,1533561,640,932397,2465958,04/22/2020
2019,Onteora,514001,2262,795552,1294,1018469,1814021,04/22/2020
2019,Saugerties,514801,3135,1841266,1437,1895031,3736297,04/22/2020
2019,Wallkill,515201,3113,2569607,918,1500732,4070339,04/22/2020
2019,Ellenville,515602,1206,848147,534,734716,1582863,04/22/2020
2019,Glens Falls,520500,1880,970243,889,1032697,2002940,04/22/2020
2019,Bolton,522001,256,36816,156,50781,87597,04/22/2020
2019,Lake George,522201,1024,192117,462,196729,388846,04/22/2020
2019,North Warren,522402,760,146777,443,191137,337914,04/22/2020
2019,Johnsburg,523001,390,125516,223,160068,285584,04/22/2020
2019,Hadley-Luzerne,523201,1038,341290,526,368252,709542,04/22/2020
2019,Queensbury,523402,3147,1431750,1280,1264198,2695948,04/22/2020
2019,Glens Falls Common,523418,176,68115,73,61299,129414,04/22/2020
2019,Warrensburg,524001,868,340752,478,411158,751910,04/22/2020
2019,Argyle,532001,673,311011,310,305211,616222,04/22/2020
2019,Fort Ann,532802,613,240562,241,212706,453268,04/22/2020
2019,Fort Edward,533001,379,190192,181,206984,397176,04/22/2020
2019,Granville,533201,1070,499655,553,552404,1052059,04/22/2020
2019,Greenwich,533401,1143,558319,481,527821,1086140,04/22/2020
2019,Hartford,533801,509,257413,267,296843,554256,04/22/2020
2019,Hudson Falls,534401,1964,759013,924,801375,1560388,04/22/2020
2019,Putnam,534601,130,21204,58,20486,41690,04/22/2020
2019,Salem,534801,702,296061,275,254976,551037,04/22/2020
2019,Cambridge,535010,1049,451598,498,463018,914616,04/22/2020
2019,Whitehall,535201,683,207968,349,216075,424043,04/22/2020
2019,Newark,542001,2003,1237167,938,1257603,2494770,04/22/2020
2019,Clyde-Savannah,542401,825,492840,416,525730,1018570,04/22/2020
2019,Lyons,542801,940,558534,402,483599,1042133,04/22/2020
2019,Gananda,543002,1092,1011286,223,467661,1478947,04/22/2020
2019,Marion,543201,1028,708394,400,614453,1322847,04/22/2020
2019,Wayne,543401,2712,1677315,1089,1507026,3184341,04/22/2020
2019,Palmyra-Macedon,543601,1844,1400425,883,1483655,2884080,04/22/2020
2019,Sodus,544201,1069,646230,580,737563,1383793,04/22/2020
2019,Williamson,544602,1119,823555,487,806148,1629703,04/22/2020
2019,North Rose-Wolcott,544801,1255,546491,706,664254,1210745,04/22/2020
2019,Red Creek,544803,850,344920,423,366114,711034,04/22/2020
2019,Mount Vernon,550800,3666,11326419,1064,5650505,16976924,04/22/2020
2019,New Rochelle,551000,5212,10993212,1262,5157664,16150876,04/22/2020
2019,Peekskill,551200,2253,4972529,599,2374139,7346668,04/22/2020
2019,Rye,551400,818,910538,224,525129,1435667,04/22/2020
2019,White Plains,551700,4505,9914542,933,3870709,13785251,04/22/2020
2019,Yonkers,551800,13331,22029230,3597,10898126,32927356,04/22/2020
2019,Katonah-Lewisboro,552001,2744,4556187,495,1868050,6424237,04/22/2020
2019,Bedford,552002,2587,3463729,633,1735167,5198896,04/22/2020
2019,Croton-Harmon,552202,1292,2240520,276,1037060,3277580,04/22/2020
2019,Hendrick Hudson,552203,2182,3369865,471,1487294,4857159,04/22/2020
2019,Eastchester,552401,2005,4686582,526,2471977,7158559,04/22/2020
2019,Tuckahoe,552402,816,1453087,142,542322,1995409,04/22/2020
2019,Bronxville,552403,280,665965,39,241382,907347,04/22/2020
2019,Tarrytowns,552601,1492,3035854,397,1673603,4709457,04/22/2020
2019,Irvington,552602,762,1689484,178,791912,2481396,04/22/2020
2019,Dobbs Ferry,552603,689,1542669,177,810573,2353242,04/22/2020
2019,Hastings On Hudson,552604,856,1101218,204,1647347,2748565,04/22/2020
2019,Ardsley,552605,1441,2691194,252,1076840,3768034,04/22/2020
2019,Edgemont,552606,526,1349049,86,446818,1795867,04/22/2020
2019,Greenburgh,552607,2574,4572644,762,2609130,7181774,04/22/2020
2019,Elmsford,552609,858,1400134,263,965392,2365526,04/22/2020
2019,Harrison,552801,1643,1998069,497,1259033,3257102,04/22/2020
2019,Mamaroneck,553201,2140,3152754,428,1278377,4431131,04/22/2020
2019,Mount Pleasant,553401,2174,3266766,597,2031697,5298463,04/22/2020
2019,Pocantico Hills,553402,308,240695,70,119124,359819,04/22/2020
2019,Valhalla,553405,1278,2259230,322,1256994,3516224,04/22/2020
2019,Pleasantville,553409,1228,2321931,272,1056669,3378600,04/22/2020
2019,Chappaqua,553604,1510,2624043,200,779738,3403781,04/22/2020
2019,Byram Hills,553801,1449,1833304,192,548125,2381429,04/22/2020
2019,North Salem,554001,1021,1396917,241,661034,2057951,04/22/2020
2019,Ossining,554201,3586,8171091,829,4007499,12178590,04/22/2020
2019,Briarcliff Manor,554202,833,1584048,88,385876,1969924,04/22/2020
2019,Pelham,554401,979,1822198,257,969782,2791980,04/22/2020
2019,Rye Neck,554801,815,1220918,251,772881,1993799,04/22/2020
2019,Port Chester-Rye,554804,1979,3374391,803,2700738,6075129,04/22/2020
2019,Blind Brook-Rye,554805,709,961698,148,458682,1420380,04/22/2020
2019,Scarsdale,555001,1503,1839340,177,494895,2334235,04/22/2020
2019,Somers,555201,3092,5099558,1151,3846159,8945717,04/22/2020
2019,Lakeland,555401,5843,11594261,1717,6448209,18042470,04/22/2020
2019,Yorktown,555402,3313,6478552,704,3054364,9532916,04/22/2020
2019,Attica,562201,1832,861860,682,716223,1578083,04/22/2020
2019,Letchworth,562601,1064,424823,421,348638,773461,04/22/2020
2019,Wyoming,563802,307,145665,127,132453,278118,04/22/2020
2019,Perry,564201,902,424454,443,429224,853678,04/22/2020
2019,Warsaw,564801,1018,618675,411,551192,1169867,04/22/2020
2019,Penn Yan,573001,2152,654964,1027,694373,1349337,04/22/2020
2019,Dundee,573401,862,270572,436,290406,560978,04/22/2020
2019,New York City School,650000,379641,107971221,95556,57497839,165469060,04/22/2020
2018,Albany,010100,7989,5084237,2446,3277351,8361588,03/11/2020
2018,Cohoes,010300,1711,917471,680,775273,1692744,03/11/2020
2018,Watervliet,011800,997,442357,370,347151,789508,03/11/2020
2018,Berne-Knox-Westerlo,012001,1414,784175,450,533705,1317880,03/11/2020
2018,Bethlehem,012206,5720,3561246,1008,1385534,4946780,03/11/2020
2018,Ravena-Coeymans-Selkirk,012402,2375,1436910,790,1025645,2462555,03/11/2020
2018,South Colonie,012601,7630,4056831,2492,2877178,6934009,03/11/2020
2018,North Colonie,012605,6827,3444294,1533,1693526,5137820,03/11/2020
2018,Menands,012615,325,172988,79,92702,265690,03/11/2020
2018,Green Island,012801,197,113230,111,142061,255291,03/11/2020
2018,Guilderland,013002,6121,3275311,1684,1962704,5238015,03/11/2020
2018,Voorheesville,013403,1662,932915,407,504046,1436961,03/11/2020
2018,Alfred-Almond,022001,712,503965,287,407955,911920,03/11/2020
2018,Andover,023001,365,253279,166,217743,471022,03/11/2020
2018,Genesee Valley,023202,643,274494,333,280061,554555,03/11/2020
2018,Belfast,023401,378,179594,217,193836,373430,03/11/2020
2018,Canaseraga,024002,301,166974,165,175122,342096,03/11/2020
2018,Cuba-Rushford,024801,1093,448380,586,466435,914815,03/11/2020
2018,Friendship,025001,331,214369,159,178840,393209,03/11/2020
2018,Fillmore,025801,632,240611,292,223447,464058,03/11/2020
2018,Whitesville,026001,196,104236,95,92360,196596,03/11/2020
2018,Scio,026601,389,252931,196,233174,486105,03/11/2020
2018,Wellsville,027001,1325,838181,724,851128,1689309,03/11/2020
2018,Bolivar-Richburg,027602,770,339516,367,289197,628713,03/11/2020
2018,Binghamton,030200,4489,2957598,2116,2739482,5697080,03/11/2020
2018,Chenango Forks,032001,1771,1205694,698,1001857,2207551,03/11/2020
2018,South Mountain-Hickory,032201,111,11378,17,3880,15258,03/11/2020
2018,Harpursville,032601,934,397437,403,350176,747613,03/11/2020
2018,Susquehanna Valley,032801,2043,1677054,900,1591296,3268350,03/11/2020
2018,Chenango Valley,033001,2201,1771869,996,1746798,3518667,03/11/2020
2018,Maine-Endwell,033801,2984,2368828,1115,1864650,4233478,03/11/2020
2018,Deposit,034201,508,195844,317,253146,448990,03/11/2020
2018,Whitney Point,034401,1490,840032,559,669227,1509259,03/11/2020
2018,Union-Endicott,034601,4488,3224788,2140,3339685,6564473,03/11/2020
2018,Johnson City,034602,2485,1708749,1293,1870349,3579098,03/11/2020
2018,Vestal,034801,4589,3033809,1629,2339583,5373392,03/11/2020
2018,Windsor,035001,1775,1076898,724,924793,2001691,03/11/2020
2018,Olean,041200,2137,1366410,1017,1201860,2568270,03/11/2020
2018,Salamanca,041600,723,26571,464,29934,56505,03/11/2020
2018,Allegany-Limestone,042001,1286,667913,607,569098,1237011,03/11/2020
2018,West Valley,042204,399,235123,208,258966,494089,03/11/2020
2018,Ellicottville,043601,534,132630,279,153385,286015,03/11/2020
2018,Franklinville,044001,805,426006,373,376616,802622,03/11/2020
2018,Hinsdale,044601,513,138085,240,128049,266134,03/11/2020
2018,Cattaraugus - Little Valley,046402,1225,474969,502,378953,853922,03/11/2020
2018,Gowanda,047201,1236,561373,560,499458,1060831,03/11/2020
2018,Portville,047401,867,574629,460,589597,1164226,03/11/2020
2018,Randolph,047601,998,294539,462,265114,559653,03/11/2020
2018,Yorkshire-Pioneer,048401,2828,1095565,1128,909150,2004715,03/11/2020
2018,Auburn,050100,4274,2331922,1806,2113180,4445102,03/11/2020
2018,Weedsport,052201,966,616840,392,537976,1154816,03/11/2020
2018,Cato-Meridian,052401,1133,583031,404,462693,1045724,03/11/2020
2018,Southern Cayuga,053001,1058,434180,373,324070,758250,03/11/2020
2018,Port Byron,053801,1069,663781,501,633340,1297121,03/11/2020
2018,Moravia,054201,1121,481472,446,404338,885810,03/11/2020
2018,Union Springs,055401,1022,427183,433,389896,817079,03/11/2020
2018,Dunkirk,060300,1739,941369,1130,1162315,2103684,03/11/2020
2018,Jamestown,060800,3611,2044920,1727,1720585,3765505,03/11/2020
2018,Southwestern,062201,1693,1000083,836,1020278,2020361,03/11/2020
2018,Frewsburg,062401,871,646980,406,622080,1269060,03/11/2020
2018,Cassadaga Valley,062601,1165,532887,557,500519,1033406,03/11/2020
2018,Chautauqua Lake,062803,946,249616,477,259099,508715,03/11/2020
2018,Pine Valley,063001,708,354496,311,309024,663520,03/11/2020
2018,Clymer,063201,500,203625,243,215409,419034,03/11/2020
2018,Bemus Point,063601,889,388251,447,404904,793155,03/11/2020
2018,Falconer,063801,1239,706806,630,713751,1420557,03/11/2020
2018,Silver Creek,064601,994,513291,526,558254,1071545,03/11/2020
2018,Forestville,064603,726,373541,378,410098,783639,03/11/2020
2018,Panama,064801,670,355087,269,296535,651622,03/11/2020
2018,Fredonia,065801,1749,1188750,819,1217008,2405758,03/11/2020
2018,Brocton,066001,598,476214,345,558657,1034871,03/11/2020
2018,Ripley,066201,333,215815,220,277824,493639,03/11/2020
2018,Sherman,066601,459,222893,209,204233,427126,03/11/2020
2018,Westfield,067201,768,452231,466,554673,1006904,03/11/2020
2018,Elmira,070400,6125,3694232,2726,3308900,7003132,03/11/2020
2018,Horseheads,073401,4777,2545221,1907,2234783,4780004,03/11/2020
2018,Elmira Heights,073402,1049,688045,466,644357,1332402,03/11/2020
2018,Norwich,081100,1802,1000363,766,843646,1844009,03/11/2020
2018,Afton,082001,650,366911,353,410914,777825,03/11/2020
2018,Bainbridge-Guilford,082201,947,539600,438,514205,1053805,03/11/2020
2018,Greene,083001,1169,602874,518,567035,1169909,03/11/2020
2018,Unadilla Valley,083803,837,343863,415,353658,697521,03/11/2020
2018,Georgetown-So Otselic Valley,084401,429,218159,187,189096,407255,03/11/2020
2018,Oxford Academy,084601,838,463609,394,429985,893594,03/11/2020
2018,Sherburne-Earlville,085601,1329,635917,645,628727,1264644,03/11/2020
2018,Plattsburgh,091300,1640,1117411,765,1090568,2207979,03/11/2020
2018,Ausable Valley,092201,1552,774329,712,702200,1476529,03/11/2020
2018,Beekmantown,092401,2260,1156624,935,953034,2109658,03/11/2020
2018,Northeastern Clinton,092801,1609,967618,681,853363,1820981,03/11/2020
2018,Chazy,093001,573,343807,225,285409,629216,03/11/2020
2018,Northern Adirondack,093601,1103,372598,450,297503,670101,03/11/2020
2018,Peru,094001,2220,1309590,714,859386,2168976,03/11/2020
2018,Saranac,094401,1993,1185642,736,894903,2080545,03/11/2020
2018,Hudson,100600,1704,838419,716,758549,1596968,03/11/2020
2018,Taconic Hills,102801,1650,568753,723,536829,1105582,03/11/2020
2018,Germantown,103602,732,308705,342,308076,616781,03/11/2020
2018,Chatham,103801,1514,730423,535,550901,1281324,03/11/2020
2018,Kinderhook,104401,2419,1290425,842,954626,2245051,03/11/2020
2018,New Lebanon,104801,724,288206,268,237754,525960,03/11/2020
2018,Cortland,110200,2281,1194070,1095,1258177,2452247,03/11/2020
2018,Cincinnatus,112001,580,292975,302,309206,602181,03/11/2020
2018,Mc Graw,112204,612,333144,233,260877,594021,03/11/2020
2018,Homer,113001,2195,1281256,846,1070442,2351698,03/11/2020
2018,Marathon,113401,780,334049,309,261362,595411,03/11/2020
2018,Andes,122002,186,40776,162,76591,117367,03/11/2020
2018,Downsville,122401,332,92239,198,119754,211993,03/11/2020
2018,Charlotte Valley,122601,453,171885,269,207391,379276,03/11/2020
2018,Delhi,122801,1051,430063,541,481906,911969,03/11/2020
2018,Franklin,123201,344,137414,180,156958,294372,03/11/2020
2018,Hancock,123606,354,133723,225,182663,316386,03/11/2020
2018,Margaretville,124601,486,122637,370,203227,325864,03/11/2020
2018,Roxbury,124802,375,141103,267,217201,358304,03/11/2020
2018,Sidney,125001,1048,504547,644,643941,1148488,03/11/2020
2018,Stamford,125201,429,209178,245,255371,464549,03/11/2020
2018,South Kortright,125202,433,192390,275,256879,449269,03/11/2020
2018,Walton,125601,1008,362010,542,414047,776057,03/11/2020
2018,Beacon,130200,2955,1844396,843,1190319,3034715,03/11/2020
2018,Poughkeepsie,131300,2234,1368303,834,1106819,2475122,03/11/2020
2018,Dover,132602,1308,1222324,343,694671,1916995,03/11/2020
2018,Hyde Park,133201,4374,3950749,1604,3055603,7006352,03/11/2020
2018,Northeast,133801,714,338885,326,339914,678799,03/11/2020
2018,Pawling,134001,1502,1367578,377,755447,2123025,03/11/2020
2018,Pine Plains,134201,1476,689044,552,570301,1259345,03/11/2020
2018,Arlington,134601,9434,8870304,2095,4232558,13102862,03/11/2020
2018,Spackenkill,134602,1513,1433341,359,705906,2139247,03/11/2020
2018,Red Hook,134801,1925,1537482,665,1174608,2712090,03/11/2020
2018,Rhinebeck,135001,1445,901434,562,774400,1675834,03/11/2020
2018,Wappingers,135601,13323,8554107,3479,4823736,13377843,03/11/2020
2018,Millbrook,135801,1215,689377,330,413490,1102867,03/11/2020
2018,Buffalo,140200,22972,6179538,6685,3279422,9458960,03/11/2020
2018,Lackawanna,140900,2131,710031,1056,666824,1376855,03/11/2020
2018,Tonawanda,141600,2628,1271661,1194,1263865,2535526,03/11/2020
2018,Alden,142001,2309,1197664,933,1045012,2242676,03/11/2020
2018,Amherst,142201,4484,2636292,1237,1599440,4235732,03/11/2020
2018,Williamsville,142203,13594,6860708,3803,4157599,11018307,03/11/2020
2018,Sweet Home,142207,4258,1739036,1968,1783387,3522423,03/11/2020
2018,East Aurora,142401,2518,1125341,872,861254,1986595,03/11/2020
2018,Cheektowaga,143001,3191,1612884,1467,1522211,3135095,03/11/2020
2018,Cheektowaga-Maryvale,143002,3110,1701056,1601,1883974,3585030,03/11/2020
2018,Cleveland Hill,143003,2106,1690424,700,1186000,2876424,03/11/2020
2018,Depew,143007,2635,1665220,1316,1841034,3506254,03/11/2020
2018,Cheektowaga-Sloan,143009,2032,1905964,977,1976104,3882068,03/11/2020
2018,Clarence,143201,5410,2329808,1549,1375348,3705156,03/11/2020
2018,Springville-Griffith,143801,2466,1250518,925,999563,2250081,03/11/2020
2018,Eden,144001,2086,1183514,743,929261,2112775,03/11/2020
2018,Iroquois,144201,3689,1733829,1384,1432760,3166589,03/11/2020
2018,Evans-Brant,144401,3076,1477794,1295,1275450,2753244,03/11/2020
2018,Grand Island,144601,4077,2358470,1319,1677949,4036419,03/11/2020
2018,Hamburg,144801,4634,2630072,1679,2107047,4737119,03/11/2020
2018,Frontier,144804,6810,2956972,2635,2465235,5422207,03/11/2020
2018,Holland,145001,1409,564778,469,410546,975324,03/11/2020
2018,Lancaster,145201,8437,3952950,2902,2893345,6846295,03/11/2020
2018,Akron,145601,1694,757407,748,680313,1437720,03/11/2020
2018,North Collins,145801,832,434786,319,353510,788296,03/11/2020
2018,Orchard Park,146001,6304,3431725,1944,2335284,5767009,03/11/2020
2018,Kenmore,146401,11890,7072544,5438,7176005,14248549,03/11/2020
2018,West Seneca,146801,9774,5112706,4537,5098684,10211390,03/11/2020
2018,Crown Point,152203,330,99745,166,100488,200233,03/11/2020
2018,Elizabethtown-Lewis,152401,389,155351,191,159606,314957,03/11/2020
2018,Keene,153001,202,53167,65,37673,90840,03/11/2020
2018,Minerva,153401,154,49449,113,74819,124268,03/11/2020
2018,Moriah,153601,730,401184,437,460030,861214,03/11/2020
2018,Newcomb,153801,84,6345,59,9184,15529,03/11/2020
2018,Lake Placid,154002,734,154094,350,157537,311631,03/11/2020
2018,Schroon Lake,154601,339,78382,202,97640,176022,03/11/2020
2018,Ticonderoga,154801,787,226710,500,292466,519176,03/11/2020
2018,Westport,155001,238,101908,123,110523,212431,03/11/2020
2018,Willsboro,155201,405,138576,256,171378,309954,03/11/2020
2018,Tupper Lake,162001,968,368066,418,313946,682012,03/11/2020
2018,Chateaugay,163401,572,232093,287,244091,476184,03/11/2020
2018,Salmon River,164201,628,193216,340,210700,403916,03/11/2020
2018,Saranac Lake,164601,1724,483173,589,350589,833762,03/11/2020
2018,Malone,164801,2508,1201928,1106,1040990,2242918,03/11/2020
2018,Brushton-Moira,165001,835,416310,354,363559,779869,03/11/2020
2018,St. Regis Falls,165401,360,183462,206,201015,384477,03/11/2020
2018,Gloversville,170500,2260,1454958,1206,1441295,2896253,03/11/2020
2018,Johnstown,170800,1736,774145,755,717101,1491246,03/11/2020
2018,Broadalbin-Perth,172201,1915,1039701,861,943331,1983032,03/11/2020
2018,Wheelerville,172401,273,67448,157,82985,150433,03/11/2020
2018,Mayfield,173001,1057,520304,568,578864,1099168,03/11/2020
2018,Northville,173201,485,157684,266,188921,346605,03/11/2020
2018,Batavia,180200,2489,1603904,1020,1357567,2961471,03/11/2020
2018,Alexander,182202,1016,634963,378,509871,1144834,03/11/2020
2018,Byron-Bergen,183001,1287,946223,529,743009,1689232,03/11/2020
2018,Elba,183401,481,294084,215,278884,572968,03/11/2020
2018,Le Roy,183601,1390,973204,528,783048,1756252,03/11/2020
2018,Oakfield-Alabama,183801,908,598076,362,511560,1109636,03/11/2020
2018,Pavilion,184001,911,558956,341,438098,997054,03/11/2020
2018,Pembroke,184202,1282,736178,506,619343,1355521,03/11/2020
2018,Cairo-Durham,192401,1335,538012,716,603704,1141716,03/11/2020
2018,Catskill,192601,1663,816574,708,734974,1551548,03/11/2020
2018,Coxsackie-Athens,192801,1532,736069,647,661317,1397386,03/11/2020
2018,Greenville,193201,1528,841333,689,809051,1650384,03/11/2020
2018,Hunter-Tannersville,193601,451,141007,310,204328,345335,03/11/2020
2018,Windham-Ashland-Jewett,194601,392,91107,256,128910,220017,03/11/2020
2018,Piseco,202001,68,3540,34,3932,7472,03/11/2020
2018,Indian Lake,202601,252,52063,167,73780,125843,03/11/2020
2018,Inlet,202801,66,8284,46,12856,21140,03/11/2020
2018,Lake Pleasant,203001,150,34930,104,53198,88128,03/11/2020
2018,Long Lake,203201,112,13447,87,21727,35174,03/11/2020
2018,Raquette Lake,203202,15,167,16,397,564,03/11/2020
2018,Wells,203601,170,50135,117,75373,125508,03/11/2020
2018,Little Falls,210900,1033,840764,507,771500,1612264,03/11/2020
2018,West Canada Valley,212402,894,461455,351,386673,848128,03/11/2020
2018,Frankfort-Schuyler,212602,1175,756721,570,768338,1525059,03/11/2020
2018,Central Valley,212803,2054,1140307,1007,1150748,2291055,03/11/2020
2018,Herkimer,213001,1115,720269,682,878467,1598736,03/11/2020
2018,Dolgeville,213602,831,325043,438,379965,705008,03/11/2020
2018,Poland,213803,821,316439,337,272745,589184,03/11/2020
2018,Van Hornesville-Owen D. Young,215001,256,128153,109,116125,244278,03/11/2020
2018,Town Of Webb,215401,361,31823,255,49540,81363,03/11/2020
2018,Mount Markham,215601,1233,678332,528,587256,1265588,03/11/2020
2018,Watertown,221800,2815,789455,1106,661260,1450715,03/11/2020
2018,South Jefferson,222001,1904,636070,607,425881,1061951,03/11/2020
2018,Alexandria,222202,693,218212,293,195013,413225,03/11/2020
2018,Indian River,222401,1477,184541,514,134214,318755,03/11/2020
2018,General Brown,222601,1626,454910,606,364913,819823,03/11/2020
2018,Thousand Islands,223201,1297,406042,594,399489,805531,03/11/2020
2018,Belleville-Henderson,223402,605,149673,320,169068,318741,03/11/2020
2018,Sackets Harbor,223801,516,183063,176,135165,318228,03/11/2020
2018,Lyme,224401,480,140546,235,148844,289390,03/11/2020
2018,La Fargeville,224601,495,130084,184,104457,234541,03/11/2020
2018,Carthage,226001,1995,458835,732,356251,815086,03/11/2020
2018,Copenhagen,232201,527,142949,175,100268,243217,03/11/2020
2018,Harrisville,232401,390,186749,249,228122,414871,03/11/2020
2018,Lowville,233601,1304,275173,535,237775,512948,03/11/2020
2018,South Lewis,234001,1279,484300,563,436085,920385,03/11/2020
2018,Beaver River,234401,1069,332416,407,270007,602423,03/11/2020
2018,Avon,242001,1098,809739,374,568396,1378135,03/11/2020
2018,Caledonia-Mumford,242201,1091,643821,413,512577,1156398,03/11/2020
2018,Geneseo,242601,1168,585040,370,403494,988534,03/11/2020
2018,Livonia,243401,2045,1272390,727,947770,2220160,03/11/2020
2018,Mount Morris,243601,486,395373,227,358324,753697,03/11/2020
2018,Dansville,243801,1692,858771,746,780081,1638852,03/11/2020
2018,Dalton-Nunda,244001,892,547690,394,470019,1017709,03/11/2020
2018,York,245201,980,604099,361,457111,1061210,03/11/2020
2018,Oneida,251200,2175,1411847,1029,1407699,2819546,03/11/2020
2018,Brookfield,252009,251,116024,98,88785,204809,03/11/2020
2018,Cazenovia,252201,1850,947216,571,622307,1569523,03/11/2020
2018,De Ruyter,252401,444,209696,175,173276,382972,03/11/2020
2018,Morrisville-Eaton,252601,824,380834,306,290442,671276,03/11/2020
2018,Hamilton,253201,718,376048,265,294788,670836,03/11/2020
2018,Canastota,253601,1570,1102555,749,1088812,2191367,03/11/2020
2018,Madison,254001,497,277990,226,266771,544761,03/11/2020
2018,Stockbridge Valley,254601,522,303779,186,227033,530812,03/11/2020
2018,Chittenango,254801,2514,1726851,1007,1385445,3112296,03/11/2020
2018,Rochester,261400,17912,6757709,4504,3027346,9785055,03/11/2020
2018,Brighton,262001,3911,2898981,1004,1607301,4506282,03/11/2020
2018,Gates-Chili,262601,6043,4694488,2902,4712284,9406772,03/11/2020
2018,Greece,262801,14002,10109721,5696,8938586,19048307,03/11/2020
2018,East Irondequoit,263401,4971,4229793,2074,3859167,8088960,03/11/2020
2018,West Irondequoit,263403,4878,3919085,1842,3263852,7182937,03/11/2020
2018,Honeoye Falls-Lima,263601,2627,1853979,633,971111,2825090,03/11/2020
2018,Spencerport,263801,4307,3133976,1623,2579451,5713427,03/11/2020
2018,Hilton,264001,5275,3666119,2069,3108733,6774852,03/11/2020
2018,Penfield,264201,6093,4702234,1976,3267959,7970193,03/11/2020
2018,Fairport,264401,7633,5157811,2594,3789063,8946874,03/11/2020
2018,East Rochester,264413,1305,1007807,662,1025429,2033236,03/11/2020
2018,Pittsford,264601,6252,4873038,1299,2214586,7087624,03/11/2020
2018,Churchville-Chili,264801,4792,3335217,1745,2610722,5945939,03/11/2020
2018,Rush-Henrietta,265001,7266,4342953,2595,3354340,7697293,03/11/2020
2018,Brockport,265201,3927,2932788,1330,2066978,4999766,03/11/2020
2018,Webster,265401,10610,6791411,3829,5362925,12154336,03/11/2020
2018,Wheatland-Chili,265601,1041,721127,415,599862,1320989,03/11/2020
2018,Amsterdam,270100,3202,1815513,1735,1976617,3792130,03/11/2020
2018,Canajoharie,272201,1055,600362,479,562478,1162840,03/11/2020
2018,Fonda-Fultonville,272801,1650,802486,606,612130,1414616,03/11/2020
2018,Fort Plain,273001,766,470337,406,502603,972940,03/11/2020
2018,Oppenheim-Ephratah-St.Johnsvil,273803,974,444752,497,452702,897454,03/11/2020
2018,Glen Cove,280500,2984,2898774,944,1980459,4879233,03/11/2020
2018,Long Beach,281000,5736,4669953,1019,1812441,6482394,03/11/2020
2018,Hempstead,282001,2309,3365141,434,1369718,4734859,03/11/2020
2018,Uniondale,282002,4344,4252042,791,1722278,5974320,03/11/2020
2018,East Meadow,282003,9716,11872582,2567,6061495,17934077,03/11/2020
2018,North Bellmore,282004,5180,7223834,1005,3103865,10327699,03/11/2020
2018,Levittown,282005,9509,15729451,2134,7865613,23595064,03/11/2020
2018,Seaford,282006,3396,4771593,704,2084745,6856338,03/11/2020
2018,Bellmore,282007,2537,3473286,427,1312881,4786167,03/11/2020
2018,Roosevelt,282008,1806,2139019,296,771350,2910369,03/11/2020
2018,Freeport,282009,4827,6598796,964,2709454,9308250,03/11/2020
2018,Baldwin,282010,6089,9211221,918,2975377,12186598,03/11/2020
2018,Oceanside,282011,7440,9303222,1391,3704354,13007576,03/11/2020
2018,Malverne,282012,2625,3862303,518,1709253,5571556,03/11/2020
2018,Valley Stream 13,282013,5312,6855972,1225,3380666,10236638,03/11/2020
2018,Hewlett-Woodmere,282014,3583,6270896,508,1929311,8200207,03/11/2020
2018,Lawrence,282015,4647,3518024,671,1113782,4631806,03/11/2020
2018,Elmont,282016,7044,8518361,1260,3396614,11914975,03/11/2020
2018,Franklin Square,282017,4441,4672559,1146,2707219,7379778,03/11/2020
2018,Garden City,282018,4126,3694599,490,965706,4660305,03/11/2020
2018,East Rockaway,282019,1749,2497879,438,1334637,3832516,03/11/2020
2018,Lynbrook,282020,3259,4777120,606,1884433,6661553,03/11/2020
2018,Rockville Centre,282021,3994,5324919,520,1455490,6780409,03/11/2020
2018,Floral Park-Bellerose,282022,3773,3911413,696,1575926,5487339,03/11/2020
2018,Wantagh,282023,3855,5339667,605,1879130,7218797,03/11/2020
2018,Valley Stream 24,282024,2160,2565282,404,1078928,3644210,03/11/2020
2018,Merrick,282025,3799,5566996,516,1698587,7265583,03/11/2020
2018,Island Trees,282026,2890,3444654,736,1956613,5401267,03/11/2020
2018,West Hempstead,282027,3079,3917323,591,1683303,5600626,03/11/2020
2018,North Merrick,282029,2972,4122741,561,1705389,5828130,03/11/2020
2018,Valley Stream 30,282030,2661,3212459,385,1040978,4253437,03/11/2020
2018,Island Park,282031,1276,1053900,256,492116,1546016,03/11/2020
2018,Westbury,282201,2554,4157860,591,2064894,6222754,03/11/2020
2018,East Williston,282202,1443,1719391,181,483101,2202492,03/11/2020
2018,Roslyn,282203,2822,3365905,307,806015,4171920,03/11/2020
2018,Port Washington,282204,4180,3989830,621,1312511,5302341,03/11/2020
2018,New Hyde Park-Garden City,282205,4242,4439923,908,2137026,6576949,03/11/2020
2018,Manhasset,282206,2327,1556724,242,363697,1920421,03/11/2020
2018,Great Neck,282207,7042,5254158,888,1436019,6690177,03/11/2020
2018,Herricks,282209,5012,5737836,837,2153828,7891664,03/11/2020
2018,Mineola,282210,4017,4200617,945,2200818,6401435,03/11/2020
2018,Carle Place,282211,1654,1884518,373,954763,2839281,03/11/2020
2018,North Shore,282401,2895,2776756,446,958759,3735515,03/11/2020
2018,Syosset,282402,6113,8608845,843,2218588,10827433,03/11/2020
2018,Locust Valley,282403,2404,2145098,374,750656,2895754,03/11/2020
2018,Plainview-Old Bethpage,282404,6141,8607551,1055,3326082,11933633,03/11/2020
2018,Oyster Bay-East Norwich,282406,1939,1427202,295,473283,1900485,03/11/2020
2018,Jericho,282415,2181,2545389,219,575644,3121033,03/11/2020
2018,Hicksville,282417,6647,6284198,1621,3341599,9625797,03/11/2020
2018,Plainedge,282418,3976,6586883,946,3517396,10104279,03/11/2020
2018,Bethpage,282421,3742,4282971,1032,2071305,6354276,03/11/2020
2018,Farmingdale,282422,7465,10347228,1742,5333660,15680888,03/11/2020
2018,Massapequa,282423,9901,12357660,1948,5424124,17781784,03/11/2020
2018,Lockport,290900,4786,3792984,1994,2936627,6729611,03/11/2020
2018,Niagara Falls,291100,6038,2819894,3012,2795070,5614964,03/11/2020
2018,North Tonawanda,291200,5139,2902420,2414,2978146,5880566,03/11/2020
2018,Lewiston-Porter,292401,3218,1687306,1478,1712988,3400294,03/11/2020
2018,Newfane,292801,1879,1444361,870,1341146,2785507,03/11/2020
2018,Niagara-Wheatfield,293001,4460,2317181,2003,2168932,4486113,03/11/2020
2018,Starpoint,293201,3671,2213584,1231,1623217,3836801,03/11/2020
2018,Royalton-Hartland,293601,1668,1055225,691,946553,2001778,03/11/2020
2018,Barker,293801,902,410612,419,414163,824775,03/11/2020
2018,Wilson,294201,1490,1002885,658,964995,1967880,03/11/2020
2018,Rome,301300,4921,3287433,2105,2887113,6174546,03/11/2020
2018,Utica,301600,6118,3505941,2596,2985864,6491805,03/11/2020
2018,Adirondack,302601,1627,672316,725,609536,1281852,03/11/2020
2018,Camden,303001,2316,954822,977,809649,1764471,03/11/2020
2018,Clinton,304001,1525,1183099,641,1106298,2289397,03/11/2020
2018,New Hartford,304801,3398,2432571,1100,1676716,4109287,03/11/2020
2018,New York Mills,304804,717,467196,385,547360,1014556,03/11/2020
2018,Sauquoit Valley,305002,1203,719731,439,562200,1281931,03/11/2020
2018,Remsen,305201,608,364964,271,346948,711912,03/11/2020
2018,Waterville,305401,982,520386,381,419066,939452,03/11/2020
2018,Holland Patent,305801,1801,1111694,705,919323,2031017,03/11/2020
2018,Sherrill,306000,2203,1364977,981,1264776,2629753,03/11/2020
2018,Westmoreland,306801,1285,964235,527,831034,1795269,03/11/2020
2018,Oriskany,307001,805,484803,328,421416,906219,03/11/2020
2018,Whitesboro,307002,4330,2780133,1706,2422654,5202787,03/11/2020
2018,Syracuse,311500,11834,5055736,4049,3493861,8549597,03/11/2020
2018,West Genesee,312001,6217,4247376,2556,3692743,7940119,03/11/2020
2018,North Syracuse,312403,11418,7942067,3833,5461381,13403448,03/11/2020
2018,East Syracuse-Minoa,312601,3946,2994741,1756,2686640,5681381,03/11/2020
2018,Jamesville-Dewitt,312611,3362,2323247,752,1114070,3437317,03/11/2020
2018,Jordan-Elbridge,312801,1432,1127023,584,908829,2035852,03/11/2020
2018,Fabius-Pompey,313001,916,720152,336,550337,1270489,03/11/2020
2018,Westhill,313201,2331,1923613,795,1408497,3332110,03/11/2020
2018,Solvay,313202,1423,1159256,813,1319190,2478446,03/11/2020
2018,La Fayette,313407,877,493295,289,338579,831874,03/11/2020
2018,Baldwinsville,313601,6664,4692986,2109,3159237,7852223,03/11/2020
2018,Fayetteville-Manlius,313801,4564,3500031,1210,2012345,5512376,03/11/2020
2018,Marcellus,314001,2266,1594844,747,1137076,2731920,03/11/2020
2018,Onondaga,314201,1270,1100453,463,734595,1835048,03/11/2020
2018,Liverpool,314801,8231,6611654,3255,5443607,12055261,03/11/2020
2018,Lyncourt,314804,610,539062,367,581607,1120669,03/11/2020
2018,Skaneateles,315001,1604,685175,590,549431,1234606,03/11/2020
2018,Tully,315402,1138,677333,339,431001,1108334,03/11/2020
2018,Canandaigua,320200,3681,2070020,1415,1713991,3784011,03/11/2020
2018,Geneva,320500,2142,1372414,990,1339046,2711460,03/11/2020
2018,East Bloomfield,322601,1125,801533,404,617361,1418894,03/11/2020
2018,Gorham-Middlesex,323201,1755,735739,737,655891,1391630,03/11/2020
2018,Manchester-Shortsville,323601,959,815097,410,727205,1542302,03/11/2020
2018,Naples,323801,1015,468805,453,451367,920172,03/11/2020
2018,Phelps-Clifton Springs,324001,1857,1347405,713,1093054,2440459,03/11/2020
2018,Honeoye,324201,1148,541737,495,498923,1040660,03/11/2020
2018,Victor,324801,4158,2066553,1171,1260332,3326885,03/11/2020
2018,Middletown,330900,4743,4115235,1231,2286887,6402122,03/11/2020
2018,Newburgh,331100,7618,6887761,2506,4719467,11607228,03/11/2020
2018,Port Jervis,331300,2048,2095011,900,1865674,3960685,03/11/2020
2018,Washingtonville,332002,4349,4026394,843,1708389,5734783,03/11/2020
2018,Chester,332201,1069,890218,281,503729,1393947,03/11/2020
2018,Cornwall,332401,2895,2669980,565,1139463,3809443,03/11/2020
2018,Pine Bush,332601,4900,3805108,1177,1959401,5764509,03/11/2020
2018,Goshen,333001,2639,2184037,595,1080828,3264865,03/11/2020
2018,Highland Falls,333601,685,561364,207,359312,920676,03/11/2020
2018,Minisink Valley,333801,3970,3158373,837,1437950,4596323,03/11/2020
2018,Monroe-Woodbury,334001,6504,6127587,1226,2529238,8656825,03/11/2020
2018,Kiryas Joel Village,334002,774,378660,84,85195,463855,03/11/2020
2018,Valley,334201,4189,3576249,1201,2218976,5795225,03/11/2020
2018,Tuxedo,335003,409,186749,81,82297,269046,03/11/2020
2018,Warwick Valley,335401,4125,3310002,917,1628038,4938040,03/11/2020
2018,Greenwood Lake,335411,1199,990857,291,530518,1521375,03/11/2020
2018,Florida,335415,934,898302,239,502862,1401164,03/11/2020
2018,Albion,342001,1839,863385,886,857277,1720662,03/11/2020
2018,Kendall,343007,954,464256,395,413730,877986,03/11/2020
2018,Holley,343204,1203,852008,520,761356,1613364,03/11/2020
2018,Medina,343401,1619,1045346,810,1047695,2093041,03/11/2020
2018,Lyndonville,343801,764,365731,345,347817,713548,03/11/2020
2018,Fulton,350400,2862,2278025,1238,1945293,4223318,03/11/2020
2018,Oswego,351200,4116,2491190,1616,1966089,4457279,03/11/2020
2018,Altmar Parish-Williamstown,352002,1296,559596,496,436484,996080,03/11/2020
2018,Hannibal,353001,1307,908882,527,750652,1659534,03/11/2020
2018,Central Square,353201,4513,2546338,1575,1856410,4402748,03/11/2020
2018,Mexico,353401,2233,1224145,839,958840,2182985,03/11/2020
2018,Pulaski,355001,968,590454,387,499976,1090430,03/11/2020
2018,Sandy Creek,355201,958,419141,457,402534,821675,03/11/2020
2018,Phoenix,355401,2102,1796797,823,1404821,3201618,03/11/2020
2018,Oneonta,361200,2022,1157782,842,1016969,2174751,03/11/2020
2018,Gilbertsville-Mt Upton,362202,492,179579,307,221538,401117,03/11/2020
2018,Cherry Valley-Springfield,362401,748,256939,364,265114,522053,03/11/2020
2018,Edmeston,362801,561,203045,197,152739,355784,03/11/2020
2018,Laurens,363401,438,213512,232,248199,461711,03/11/2020
2018,Schenevus,363601,449,225700,243,258535,484235,03/11/2020
2018,Milford,364001,510,232042,288,275221,507263,03/11/2020
2018,Morris,364201,479,232336,231,219743,452079,03/11/2020
2018,Otego-Unadilla,364801,1098,613014,549,646671,1259685,03/11/2020
2018,Cooperstown,365001,1006,325486,439,308999,634485,03/11/2020
2018,Richfield Springs,365601,649,198673,391,250764,449437,03/11/2020
2018,Worcester,366606,417,232639,246,293201,525840,03/11/2020
2018,Mahopac,372001,5071,5577024,1048,2539538,8116562,03/11/2020
2018,Carmel,372002,5408,6899125,1237,3435229,10334354,03/11/2020
2018,Haldane,372601,898,748497,259,439153,1187650,03/11/2020
2018,Garrison,372604,389,182143,77,80286,262429,03/11/2020
2018,Putnam Valley,372803,2184,3019055,429,1273523,4292578,03/11/2020
2018,Brewster,373001,3881,3969572,937,2116083,6085655,03/11/2020
2018,Rensselaer,381400,1044,497377,359,346663,844040,03/11/2020
2018,Troy,381700,3281,1995982,1081,1392094,3388076,03/11/2020
2018,Lansingburgh,381701,2014,1052280,856,941135,1993415,03/11/2020
2018,Berlin,382001,1262,582701,500,480599,1063300,03/11/2020
2018,Brunswick,382202,1548,823545,531,601282,1424827,03/11/2020
2018,East Greenbush,382401,5653,2998600,1658,1901780,4900380,03/11/2020
2018,Hoosick Falls,382801,1321,733004,539,613727,1346731,03/11/2020
2018,North Greenbush,383201,314,50592,125,44759,95351,03/11/2020
2018,Wynantskill,383204,733,455421,288,392091,847512,03/11/2020
2018,Averill Park,384001,3911,2102150,1066,1238519,3340669,03/11/2020
2018,Hoosic Valley,384201,1285,623717,436,458642,1082359,03/11/2020
2018,Schodack,384401,1256,806543,350,489377,1295920,03/11/2020
2018,Clarkstown,392001,9654,9734428,1936,4330211,14064639,03/11/2020
2018,Nanuet,392008,2087,2352864,551,1352468,3705332,03/11/2020
2018,Haverstraw-Stony Point,392201,6576,11891881,1859,6792411,18684292,03/11/2020
2018,South Orangetown,392401,3927,4284696,797,1930000,6214696,03/11/2020
2018,Nyack,392404,3408,4739831,751,2384269,7124100,03/11/2020
2018,Pearl River,392408,2940,3513560,673,1779853,5293413,03/11/2020
2018,Ramapo,392601,4295,6786608,1129,3764674,10551282,03/11/2020
2018,East Ramapo,392602,8865,8605865,1828,3592537,12198402,03/11/2020
2018,Ogdensburg,401200,1608,1249493,705,989726,2239219,03/11/2020
2018,Brasher Falls,402001,1062,698616,459,597736,1296352,03/11/2020
2018,Canton,402201,1475,893854,519,639148,1533002,03/11/2020
2018,Clifton-Fine,402601,394,130239,220,131773,262012,03/11/2020
2018,Colton-Pierrepont,402801,516,225721,263,247671,473392,03/11/2020
2018,Edwards-Knox,403401,595,173907,270,158833,332740,03/11/2020
2018,Gouverneur,404001,1459,562704,665,496460,1059164,03/11/2020
2018,Hammond,404201,341,137595,147,121720,259315,03/11/2020
2018,Hermon-Dekalb,404401,434,222295,217,222399,444694,03/11/2020
2018,Lisbon,405002,696,384751,258,293835,678586,03/11/2020
2018,Madrid-Waddington,405601,789,406705,373,396741,803446,03/11/2020
2018,Massena,405801,2675,1458986,1330,1426377,2885363,03/11/2020
2018,Morristown,406001,503,225773,241,224076,449849,03/11/2020
2018,Norwood-Norfolk,406201,1144,848156,576,854823,1702979,03/11/2020
2018,Heuvelton,406404,717,429818,279,347857,777675,03/11/2020
2018,Parishville-Hopkinton,406601,499,202160,256,207277,409437,03/11/2020
2018,Potsdam,407402,1536,1076697,518,749155,1825852,03/11/2020
2018,Mechanicville,411000,1390,807819,522,673848,1481667,03/11/2020
2018,Saratoga Springs,411500,7600,3501491,1795,1768412,5269903,03/11/2020
2018,Burnt Hills-Ballston Lake,412001,4176,2894426,1284,1960187,4854613,03/11/2020
2018,Shenendehowa,412402,11933,8107926,2560,3777539,11885465,03/11/2020
2018,Corinth,412601,1233,553538,540,491881,1045419,03/11/2020
2018,Edinburg,413001,259,47873,155,57332,105205,03/11/2020
2018,Galway,413201,1377,713330,508,545066,1258396,03/11/2020
2018,Ballston Spa,414201,4446,3151510,1217,1747691,4899201,03/11/2020
2018,South Glens Falls,414401,3345,2100781,1151,1539118,3639899,03/11/2020
2018,Schuylerville,415001,1921,1424533,555,847538,2272071,03/11/2020
2018,Stillwater,415201,1429,699278,438,452312,1151590,03/11/2020
2018,Waterford-Halfmoon,415401,835,707010,342,613089,1320099,03/11/2020
2018,Schenectady,421500,5897,4123830,2307,3108904,7232734,03/11/2020
2018,Duanesburg,422001,1090,557421,337,372426,929847,03/11/2020
2018,Scotia-Glenville,422202,3416,2029873,1086,1406078,3435951,03/11/2020
2018,Niskayuna,422401,4988,2857140,963,1224555,4081695,03/11/2020
2018,Schalmont,422801,2704,1535988,982,1223356,2759344,03/11/2020
2018,Rotterdam-Mohonasen,422803,3838,1903992,1599,1742791,3646783,03/11/2020
2018,Cobleskill-Richmondville,432602,1849,1061016,931,1083648,2144664,03/11/2020
2018,Gilboa-Conesville,433401,425,141091,287,189833,330924,03/11/2020
2018,Jefferson,433601,325,139669,175,155766,295435,03/11/2020
2018,Middleburgh,433801,968,610588,510,628452,1239040,03/11/2020
2018,Schoharie,434201,1186,761439,492,659495,1420934,03/11/2020
2018,Sharon Springs,434601,325,188999,170,197452,386451,03/11/2020
2018,Odessa-Montour,442001,980,428943,424,401467,830410,03/11/2020
2018,Watkins Glen,442401,1405,476535,659,481724,958259,03/11/2020
2018,South Seneca,452801,989,415682,511,457003,872685,03/11/2020
2018,Romulus,453003,524,264228,246,267229,531457,03/11/2020
2018,Seneca Falls,453201,1526,1079621,702,1038933,2118554,03/11/2020
2018,Waterloo,453801,1746,1032603,816,1032026,2064629,03/11/2020
2018,Corning,460300,5531,4033156,2186,3284126,7317282,03/11/2020
2018,Hornell,460600,1426,741814,633,630090,1371904,03/11/2020
2018,Addison,462001,1234,652461,529,550790,1203251,03/11/2020
2018,Avoca,462201,637,230902,300,214911,445813,03/11/2020
2018,Bath,462402,1480,749490,622,636600,1386090,03/11/2020
2018,Bradford,462601,346,162277,158,156424,318701,03/11/2020
2018,Campbell-Savona,463002,966,513366,396,436557,949923,03/11/2020
2018,Canisteo-Greenwood,463202,973,480852,560,543061,1023913,03/11/2020
2018,Arkport,465201,536,341957,279,330645,672602,03/11/2020
2018,Jasper-Troupsburg,465601,518,210255,229,196891,407146,03/11/2020
2018,Prattsburgh,466001,525,214194,233,190043,404237,03/11/2020
2018,Hammondsport,467201,802,239612,383,243796,483408,03/11/2020
2018,Wayland-Cohocton,467401,1619,775041,717,698079,1473120,03/11/2020
2018,Babylon,472001,2171,2828479,355,999755,3828234,03/11/2020
2018,West Babylon,472002,4422,5462108,1011,2715934,8178042,03/11/2020
2018,North Babylon,472003,5176,5975260,1399,3545778,9521038,03/11/2020
2018,Lindenhurst,472004,6761,8851411,1681,4823360,13674771,03/11/2020
2018,Copiague,472005,3835,4560364,1098,2750624,7310988,03/11/2020
2018,Amityville,472006,3366,3871183,1022,2103559,5974742,03/11/2020
2018,Deer Park,472007,4184,5076027,1245,3279414,8355441,03/11/2020
2018,Wyandanch,472009,853,1104999,200,560102,1665101,03/11/2020
2018,Three Village,472201,7379,8749818,1475,3830427,12580245,03/11/2020
2018,Brookhaven-Comsewogue,472203,3579,4132010,908,2213911,6345921,03/11/2020
2018,South Country,472204,3989,4115875,827,1870365,5986240,03/11/2020
2018,Sachem,472205,14089,13450768,3130,6489417,19940185,03/11/2020
2018,Port Jefferson,472206,1261,849612,221,329098,1178710,03/11/2020
2018,Mount Sinai,472207,2569,3033818,626,1634711,4668529,03/11/2020
2018,Miller Place,472208,3061,3716149,468,1251755,4967904,03/11/2020
2018,Rocky Point,472209,3267,4382089,536,1553483,5935572,03/11/2020
2018,Middle Country,472211,9877,11512938,2509,6360768,17873706,03/11/2020
2018,Longwood,472212,9685,11842998,3243,7805485,19648483,03/11/2020
2018,Patchogue-Medford,472224,7619,9090797,1772,4499759,13590556,03/11/2020
2018,William Floyd,472232,7161,9246526,1588,4327997,13574523,03/11/2020
2018,Center Moriches,472233,1432,1788375,278,759926,2548301,03/11/2020
2018,East Moriches,472234,1149,1396178,187,503059,1899237,03/11/2020
2018,Eastport- South Manor,472235,3429,4127843,857,2024300,6152143,03/11/2020
2018,East Hampton,472401,818,130618,241,83761,214379,03/11/2020
2018,Wainscott,472402,58,2374,16,1470,3844,03/11/2020
2018,Amagansett,472403,128,11373,53,10503,21876,03/11/2020
2018,Springs,472404,673,207204,254,174552,381756,03/11/2020
2018,Sag Harbor,472405,874,227558,358,177341,404899,03/11/2020
2018,Montauk,472406,387,59832,166,57524,117356,03/11/2020
2018,Elwood,472601,2496,2968375,525,1392422,4360797,03/11/2020
2018,Cold Spring Harbor,472602,998,983677,83,183067,1166744,03/11/2020
2018,Huntington,472603,5460,5619154,1072,2417574,8036728,03/11/2020
2018,Northport-East Northport,472604,7108,5587571,1361,2381562,7969133,03/11/2020
2018,Half Hollow Hills,472605,7781,7318874,1779,3522256,10841130,03/11/2020
2018,Harborfields,472606,3523,3882697,621,1522782,5405479,03/11/2020
2018,Commack,472610,7387,8781444,1631,4298425,13079869,03/11/2020
2018,South Huntington,472613,6520,7478675,1537,3920204,11398879,03/11/2020
2018,Bay Shore,472801,4608,5693872,1004,2673649,8367521,03/11/2020
2018,Islip,472802,3179,4238384,700,1943946,6182330,03/11/2020
2018,East Islip,472803,4618,5443050,1040,2888392,8331442,03/11/2020
2018,Sayville,472804,3439,4108506,801,2126267,6234773,03/11/2020
2018,Bayport-Blue Point,472805,2555,3507895,484,1410370,4918265,03/11/2020
2018,Hauppauge,472806,4230,3037599,1005,1581520,4619119,03/11/2020
2018,Connetquot,472807,7019,7945053,1848,4479125,12424178,03/11/2020
2018,West Islip,472809,5394,6109370,1237,3117686,9227056,03/11/2020
2018,Brentwood,472812,7579,6198113,1957,3548701,9746814,03/11/2020
2018,Central Islip,472813,4212,5624339,1127,3270014,8894353,03/11/2020
2018,Fire Island,472814,77,8173,19,4493,12666,03/11/2020
2018,Shoreham-Wading River,473001,2652,2818614,643,1438009,4256623,03/11/2020
2018,Riverhead,473002,5181,4053250,2363,3653788,7707038,03/11/2020
2018,Shelter Island,473201,411,59111,158,50692,109803,03/11/2020
2018,Smithtown,473401,10784,11894200,2371,5505947,17400147,03/11/2020
2018,Kings Park,473405,4320,4294517,900,1954520,6249037,03/11/2020
2018,Remsenburg-Speonk,473601,289,82594,80,50859,133453,03/11/2020
2018,Westhampton Beach,473602,709,226236,208,144184,370420,03/11/2020
2018,Quogue,473603,149,14782,39,8671,23453,03/11/2020
2018,Hampton Bays,473605,1690,1126491,659,974027,2100518,03/11/2020
2018,Southhampton,473606,1070,119085,373,91961,211046,03/11/2020
2018,Bridgehampton,473609,149,13313,50,9947,23260,03/11/2020
2018,Sagaponack,473610,24,276,3,77,353,03/11/2020
2018,Tuckahoe Common,473613,333,122608,139,111839,234447,03/11/2020
2018,East Quogue,473617,834,476856,263,323047,799903,03/11/2020
2018,Oysterponds,473802,292,56658,121,52375,109033,03/11/2020
2018,Fishers Island,473804,29,5698,2,877,6575,03/11/2020
2018,Southold,473805,1180,532214,415,422413,954627,03/11/2020
2018,Greenport,473810,471,256456,213,267292,523748,03/11/2020
2018,Mattituck-Cutchogue,473812,1688,780162,529,545116,1325278,03/11/2020
2018,New Suffolk,473815,68,12383,24,9750,22133,03/11/2020
2018,Fallsburg,482801,849,597250,334,474557,1071807,03/11/2020
2018,Eldred,483401,827,337206,330,291517,628723,03/11/2020
2018,Liberty,483601,995,706896,530,796118,1503014,03/11/2020
2018,Tri-Valley,484201,1009,543987,380,418112,962099,03/11/2020
2018,Roscoe,484401,278,120432,148,137949,258381,03/11/2020
2018,Livingston Manor,484402,476,203976,236,208121,412097,03/11/2020
2018,Monticello,484601,2362,1171614,994,1015000,2186614,03/11/2020
2018,Sullivan West,484802,1607,637805,860,726036,1363841,03/11/2020
2018,Waverly,492001,1530,685626,628,587494,1273120,03/11/2020
2018,Candor,492401,832,463593,383,434741,898334,03/11/2020
2018,Newark Valley,492602,1417,824729,565,696868,1521597,03/11/2020
2018,Owego-Apalachin,493001,2348,1413639,971,1223365,2637004,03/11/2020
2018,Spencer-Van Etten,493401,1033,485591,479,476786,962377,03/11/2020
2018,Tioga,493603,912,272667,408,261026,533693,03/11/2020
2018,Ithaca,500700,6393,3350590,1723,1845313,5195903,03/11/2020
2018,Dryden,502401,1959,1353475,711,953898,2307373,03/11/2020
2018,Groton,502801,1024,630313,406,515807,1146120,03/11/2020
2018,Lansing,503201,1355,832038,414,545807,1377845,03/11/2020
2018,Newfield,503401,854,480316,349,365616,845932,03/11/2020
2018,Trumansburg,503601,1346,737672,498,576047,1313719,03/11/2020
2018,Kingston,510800,6813,4545491,2800,3989111,8534602,03/11/2020
2018,Highland,513203,1899,1348987,568,862883,2211870,03/11/2020
2018,Rondout Valley,513401,2762,1478302,1109,1279157,2757459,03/11/2020
2018,Marlboro,513601,1909,1578676,554,957610,2536286,03/11/2020
2018,New Paltz,513801,2588,1701402,658,947473,2648875,03/11/2020
2018,Onteora,514001,2406,859688,1382,1076363,1936051,03/11/2020
2018,Saugerties,514801,3395,2029284,1452,1890191,3919475,03/11/2020
2018,Wallkill,515201,3328,2816055,981,1553813,4369868,03/11/2020
2018,Ellenville,515602,1255,904744,557,764254,1668998,03/11/2020
2018,Glens Falls,520500,2058,1076557,917,1051096,2127653,03/11/2020
2018,Bolton,522001,279,40904,171,55382,96286,03/11/2020
2018,Lake George,522201,1117,212524,505,212144,424668,03/11/2020
2018,North Warren,522402,789,155135,481,204331,359466,03/11/2020
2018,Johnsburg,523001,408,132553,233,164605,297158,03/11/2020
2018,Hadley-Luzerne,523201,1085,364459,550,380612,745071,03/11/2020
2018,Queensbury,523402,3489,1604133,1321,1286152,2890285,03/11/2020
2018,Glens Falls Common,523418,193,75987,71,58866,134853,03/11/2020
2018,Warrensburg,524001,894,355911,499,423556,779467,03/11/2020
2018,Argyle,532001,712,338634,319,313091,651725,03/11/2020
2018,Fort Ann,532802,647,256798,239,207996,464794,03/11/2020
2018,Fort Edward,533001,407,207749,190,213778,421527,03/11/2020
2018,Granville,533201,1140,542112,566,557491,1099603,03/11/2020
2018,Greenwich,533401,1209,597564,502,542761,1140325,03/11/2020
2018,Hartford,533801,546,282017,273,302065,584082,03/11/2020
2018,Hudson Falls,534401,2083,820117,947,812496,1632613,03/11/2020
2018,Putnam,534601,137,22403,62,21314,43717,03/11/2020
2018,Salem,534801,700,298672,320,286849,585521,03/11/2020
2018,Cambridge,535010,1115,487456,522,478177,965633,03/11/2020
2018,Whitehall,535201,692,218183,373,232168,450351,03/11/2020
2018,Newark,542001,2138,1346572,976,1312123,2658695,03/11/2020
2018,Clyde-Savannah,542401,870,529584,442,550882,1080466,03/11/2020
2018,Lyons,542801,983,603733,419,500110,1103843,03/11/2020
2018,Gananda,543002,1168,1094662,226,463877,1558539,03/11/2020
2018,Marion,543201,1075,752647,404,615872,1368519,03/11/2020
2018,Wayne,543401,2874,1798333,1104,1501317,3299650,03/11/2020
2018,Palmyra-Macedon,543601,1983,1547046,900,1499621,3046667,03/11/2020
2018,Sodus,544201,1138,697927,600,750513,1448440,03/11/2020
2018,Williamson,544602,1195,887388,508,825374,1712762,03/11/2020
2018,North Rose-Wolcott,544801,1330,587998,736,686101,1274099,03/11/2020
2018,Red Creek,544803,904,375939,436,378914,754853,03/11/2020
2018,Mount Vernon,550800,4031,12246675,1098,5704249,17950924,03/11/2020
2018,New Rochelle,551000,6582,13821020,1311,5472499,19293519,03/11/2020
2018,Peekskill,551200,2422,5408191,616,2383174,7791365,03/11/2020
2018,Rye,551400,1197,1323857,227,540215,1864072,03/11/2020
2018,White Plains,551700,5679,12279046,981,4047621,16326667,03/11/2020
2018,Yonkers,551800,13921,23232134,3843,11466015,34698149,03/11/2020
2018,Katonah-Lewisboro,552001,3475,5881777,504,1892814,7774591,03/11/2020
2018,Bedford,552002,3207,4244208,666,1755928,6000136,03/11/2020
2018,Croton-Harmon,552202,1728,3095924,282,1049142,4145066,03/11/2020
2018,Hendrick Hudson,552203,2694,4268851,471,1472292,5741143,03/11/2020
2018,Eastchester,552401,2428,5641931,549,2676198,8318129,03/11/2020
2018,Tuckahoe,552402,993,1831520,152,599147,2430667,03/11/2020
2018,Bronxville,552403,353,823969,35,229868,1053837,03/11/2020
2018,Tarrytowns,552601,1759,3695022,430,1811218,5506240,03/11/2020
2018,Irvington,552602,1113,2414718,190,837194,3251912,03/11/2020
2018,Dobbs Ferry,552603,928,2111876,192,895105,3006981,03/11/2020
2018,Hastings On Hudson,552604,1232,2632984,221,969235,3602219,03/11/2020
2018,Ardsley,552605,1804,3545466,275,1201940,4747406,03/11/2020
2018,Edgemont,552606,850,2041924,89,473320,2515244,03/11/2020
2018,Greenburgh,552607,3046,5501864,794,2604909,8106773,03/11/2020
2018,Elmsford,552609,982,1622863,280,1010251,2633114,03/11/2020
2018,Harrison,552801,2131,2569407,531,1315808,3885215,03/11/2020
2018,Mamaroneck,553201,2932,4258070,471,1404927,5662997,03/11/2020
2018,Mount Pleasant,553401,2337,3555187,613,2055113,5610300,03/11/2020
2018,Pocantico Hills,553402,338,273406,67,115184,388590,03/11/2020
2018,Valhalla,553405,1453,2585792,338,1280780,3866572,03/11/2020
2018,Pleasantville,553409,1562,3165764,281,1121319,4287083,03/11/2020
2018,Chappaqua,553604,2251,4057099,215,838270,4895369,03/11/2020
2018,Byram Hills,553801,1578,2015131,208,580541,2595672,03/11/2020
2018,North Salem,554001,1308,1817946,262,722610,2540556,03/11/2020
2018,Ossining,554201,4364,10036327,821,3836873,13873200,03/11/2020
2018,Briarcliff Manor,554202,1092,2145889,95,415656,2561545,03/11/2020
2018,Pelham,554401,1550,2768321,274,1009058,3777379,03/11/2020
2018,Rye Neck,554801,989,1493456,263,805942,2299398,03/11/2020
2018,Port Chester-Rye,554804,2145,3675555,814,2725892,6401447,03/11/2020
2018,Blind Brook-Rye,554805,1049,1456393,157,484166,1940559,03/11/2020
2018,Scarsdale,555001,1963,2435647,204,560731,2996378,03/11/2020
2018,Somers,555201,3803,6419165,1221,3934431,10353596,03/11/2020
2018,Lakeland,555401,6774,14169410,1784,6691561,20860971,03/11/2020
2018,Yorktown,555402,4087,8510972,706,3138146,11649118,03/11/2020
2018,Attica,562201,1929,928203,698,732874,1661077,03/11/2020
2018,Letchworth,562601,1102,448509,449,374603,823112,03/11/2020
2018,Wyoming,563802,325,157245,140,144500,301745,03/11/2020
2018,Perry,564201,948,476364,463,459687,936051,03/11/2020
2018,Warsaw,564801,1104,676800,413,545924,1222724,03/11/2020
2018,Penn Yan,573001,2344,719753,1043,695163,1414916,03/11/2020
2018,Dundee,573401,907,289261,468,304706,593967,03/11/2020
2018,New York City School,650000,418153,121121366,100905,60202079,181323445,03/11/2020
2017,Albany,010100,8534,5364618,2821,3639653,9004271,03/11/2020
2017,Cohoes,010300,1850,972673,690,771612,1744285,03/11/2020
2017,Watervliet,011800,1051,461035,398,362788,823823,03/11/2020
2017,Berne-Knox-Westerlo,012001,1485,815235,456,529479,1344714,03/11/2020
2017,Bethlehem,012206,6005,3707284,1060,1420411,5127695,03/11/2020
2017,Ravena-Coeymans-Selkirk,012402,2489,1486391,815,1023913,2510304,03/11/2020
2017,South Colonie,012601,8080,4284749,2610,2943911,7228660,03/11/2020
2017,North Colonie,012605,7174,3576174,1626,1737910,5314084,03/11/2020
2017,Menands,012615,336,177489,86,98305,275794,03/11/2020
2017,Green Island,012801,210,119663,117,145561,265224,03/11/2020
2017,Guilderland,013002,6617,3611920,1572,1860434,5472354,03/11/2020
2017,Voorheesville,013403,1768,983847,398,480706,1464553,03/11/2020
2017,Alfred-Almond,022001,745,528107,297,406079,934186,03/11/2020
2017,Andover,023001,375,258145,177,225999,484144,03/11/2020
2017,Genesee Valley,023202,688,304229,336,285511,589740,03/11/2020
2017,Belfast,023401,408,197790,217,197180,394970,03/11/2020
2017,Canaseraga,024002,318,125791,168,226929,352720,03/11/2020
2017,Cuba-Rushford,024801,1153,479656,594,469476,949132,03/11/2020
2017,Friendship,025001,348,231075,154,172335,403410,03/11/2020
2017,Fillmore,025801,675,256252,298,222146,478398,03/11/2020
2017,Whitesville,026001,205,108295,99,94605,202900,03/11/2020
2017,Scio,026601,408,260991,201,234095,495086,03/11/2020
2017,Wellsville,027001,1396,886523,761,884631,1771154,03/11/2020
2017,Bolivar-Richburg,027602,800,370319,366,290821,661140,03/11/2020
2017,Binghamton,030200,4770,3123321,2184,2740402,5863723,03/11/2020
2017,Chenango Forks,032001,1864,1257737,693,968786,2226523,03/11/2020
2017,South Mountain-Hickory,032201,116,11742,18,3889,15631,03/11/2020
2017,Harpursville,032601,990,415514,390,331298,746812,03/11/2020
2017,Susquehanna Valley,032801,2147,1759355,904,1548213,3307568,03/11/2020
2017,Chenango Valley,033001,2313,1848387,1037,1768467,3616854,03/11/2020
2017,Maine-Endwell,033801,3144,2460079,1149,1872405,4332484,03/11/2020
2017,Deposit,034201,529,199183,320,254849,454032,03/11/2020
2017,Whitney Point,034401,1590,892077,540,632780,1524857,03/11/2020
2017,Union-Endicott,034601,4797,3407071,2191,3325950,6733021,03/11/2020
2017,Johnson City,034602,2662,1807892,1310,1837875,3645767,03/11/2020
2017,Vestal,034801,4811,3162781,1687,2367747,5530528,03/11/2020
2017,Windsor,035001,1864,1116944,733,909937,2026881,03/11/2020
2017,Olean,041200,2278,1519471,1024,1225069,2744540,03/11/2020
2017,Salamanca,041600,777,129112,469,131742,260854,03/11/2020
2017,Allegany-Limestone,042001,1365,760738,612,595504,1356242,03/11/2020
2017,West Valley,042204,424,262313,205,261527,523840,03/11/2020
2017,Ellicottville,043601,572,140345,270,146994,287339,03/11/2020
2017,Franklinville,044001,852,463377,363,370833,834210,03/11/2020
2017,Hinsdale,044601,543,144298,242,125558,269856,03/11/2020
2017,Cattaraugus - Little Valley,046402,1276,544409,517,418603,963012,03/11/2020
2017,Gowanda,047201,1285,601393,569,507663,1109056,03/11/2020
2017,Portville,047401,918,615202,456,578564,1193766,03/11/2020
2017,Randolph,047601,1039,317677,471,274300,591977,03/11/2020
2017,Yorkshire-Pioneer,048401,2990,1168655,1119,893588,2062243,03/11/2020
2017,Auburn,050100,4601,2486646,1845,2103884,4590530,03/11/2020
2017,Weedsport,052201,1025,647408,389,519092,1166500,03/11/2020
2017,Cato-Meridian,052401,1211,631107,414,470075,1101182,03/11/2020
2017,Southern Cayuga,053001,1086,456602,384,332777,789379,03/11/2020
2017,Port Byron,053801,1123,694794,502,620397,1315191,03/11/2020
2017,Moravia,054201,1193,509690,456,404371,914061,03/11/2020
2017,Union Springs,055401,1077,450564,442,388987,839551,03/11/2020
2017,Dunkirk,060300,1868,1016774,1135,1143630,2160404,03/11/2020
2017,Jamestown,060800,3845,2190954,1773,1755186,3946140,03/11/2020
2017,Southwestern,062201,1852,1101667,816,987571,2089238,03/11/2020
2017,Frewsburg,062401,940,692884,404,604405,1297289,03/11/2020
2017,Cassadaga Valley,062601,1218,561056,572,509771,1070827,03/11/2020
2017,Chautauqua Lake,062803,983,256117,502,265284,521401,03/11/2020
2017,Pine Valley,063001,736,381782,321,323234,705016,03/11/2020
2017,Clymer,063201,521,209508,247,213023,422531,03/11/2020
2017,Bemus Point,063601,943,410732,442,392366,803098,03/11/2020
2017,Falconer,063801,1286,744115,649,730574,1474689,03/11/2020
2017,Silver Creek,064601,1052,541795,525,547940,1089735,03/11/2020
2017,Forestville,064603,772,402398,374,402869,805267,03/11/2020
2017,Panama,064801,699,381111,283,312857,693968,03/11/2020
2017,Fredonia,065801,1859,1264703,819,1195452,2460155,03/11/2020
2017,Brocton,066001,643,508437,342,540825,1049262,03/11/2020
2017,Ripley,066201,369,250485,209,271538,522023,03/11/2020
2017,Sherman,066601,480,240328,203,201131,441459,03/11/2020
2017,Westfield,067201,832,483325,458,528538,1011863,03/11/2020
2017,Elmira,070400,6563,3906913,2745,3251718,7158631,03/11/2020
2017,Horseheads,073401,5012,2709924,1968,2300703,5010627,03/11/2020
2017,Elmira Heights,073402,1120,730977,470,632081,1363058,03/11/2020
2017,Norwich,081100,1911,1049152,786,846329,1895481,03/11/2020
2017,Afton,082001,673,375210,369,420681,795891,03/11/2020
2017,Bainbridge-Guilford,082201,1003,563714,442,502869,1066583,03/11/2020
2017,Greene,083001,1208,617714,554,589737,1207451,03/11/2020
2017,Unadilla Valley,083803,871,358324,425,354193,712517,03/11/2020
2017,Georgetown-So Otselic Valley,084401,451,229903,188,186901,416804,03/11/2020
2017,Oxford Academy,084601,883,486268,397,423191,909459,03/11/2020
2017,Sherburne-Earlville,085601,1403,667837,651,623425,1291262,03/11/2020
2017,Plattsburgh,091300,1734,1166012,783,1085744,2251756,03/11/2020
2017,Ausable Valley,092201,1635,807940,721,683905,1491845,03/11/2020
2017,Beekmantown,092401,2365,1212092,952,941182,2153274,03/11/2020
2017,Northeastern Clinton,092801,1694,1013160,678,827380,1840540,03/11/2020
2017,Chazy,093001,594,352443,224,275933,628376,03/11/2020
2017,Northern Adirondack,093601,1149,387735,466,300727,688462,03/11/2020
2017,Peru,094001,2326,1379112,721,858188,2237300,03/11/2020
2017,Saranac,094401,2118,1261381,733,878296,2139677,03/11/2020
2017,Hudson,100600,1756,865323,779,805010,1670333,03/11/2020
2017,Taconic Hills,102801,1758,611453,725,529283,1140736,03/11/2020
2017,Germantown,103602,768,334288,349,318206,652494,03/11/2020
2017,Chatham,103801,1582,758789,555,554402,1313191,03/11/2020
2017,Kinderhook,104401,2562,1354975,839,922914,2277889,03/11/2020
2017,New Lebanon,104801,750,305897,280,241797,547694,03/11/2020
2017,Cortland,110200,2537,1339638,1102,1252229,2591867,03/11/2020
2017,Cincinnatus,112001,609,303775,302,301900,605675,03/11/2020
2017,Mc Graw,112204,645,348580,234,257143,605723,03/11/2020
2017,Homer,113001,2307,1343039,862,1065940,2408979,03/11/2020
2017,Marathon,113401,802,344337,325,269963,614300,03/11/2020
2017,Andes,122002,190,41373,173,79266,120639,03/11/2020
2017,Downsville,122401,340,93527,216,126644,220171,03/11/2020
2017,Charlotte Valley,122601,469,176516,275,207118,383634,03/11/2020
2017,Delhi,122801,1100,447078,564,493172,940250,03/11/2020
2017,Franklin,123201,378,149754,190,161428,311182,03/11/2020
2017,Hancock,123606,373,140684,235,186023,326707,03/11/2020
2017,Margaretville,124601,523,130900,378,202847,333747,03/11/2020
2017,Roxbury,124802,397,150326,269,216682,367008,03/11/2020
2017,Sidney,125001,1109,526924,657,647278,1174202,03/11/2020
2017,Stamford,125201,453,218051,251,254774,472825,03/11/2020
2017,South Kortright,125202,455,199988,284,258630,458618,03/11/2020
2017,Walton,125601,1050,374232,559,415615,789847,03/11/2020
2017,Beacon,130200,3118,2034730,861,1251739,3286469,03/11/2020
2017,Poughkeepsie,131300,2360,1439266,860,1120677,2559943,03/11/2020
2017,Dover,132602,1353,1285462,356,719154,2004616,03/11/2020
2017,Hyde Park,133201,4555,4129404,1659,3071779,7201183,03/11/2020
2017,Northeast,133801,754,361716,326,337297,699013,03/11/2020
2017,Pawling,134001,1595,1448220,391,766239,2214459,03/11/2020
2017,Pine Plains,134201,1554,746940,557,578081,1325021,03/11/2020
2017,Arlington,134601,9940,9458038,2151,4316103,13774141,03/11/2020
2017,Spackenkill,134602,1593,1525676,371,722826,2248502,03/11/2020
2017,Red Hook,134801,2025,1626308,671,1176806,2803114,03/11/2020
2017,Rhinebeck,135001,1518,955521,586,793048,1748569,03/11/2020
2017,Wappingers,135601,13948,9142381,3552,4931080,14073461,03/11/2020
2017,Millbrook,135801,1294,741271,335,414920,1156191,03/11/2020
2017,Buffalo,140200,24069,7018304,6891,3453105,10471409,03/11/2020
2017,Lackawanna,140900,2233,761254,1109,711630,1472884,03/11/2020
2017,Tonawanda,141600,2790,1476817,1206,1351739,2828556,03/11/2020
2017,Alden,142001,2427,1274584,924,1028224,2302808,03/11/2020
2017,Amherst,142201,4784,2957909,1263,1676839,4634748,03/11/2020
2017,Williamsville,142203,14381,7760327,3896,4448695,12209022,03/11/2020
2017,Sweet Home,142207,4531,1927465,2010,1846665,3774130,03/11/2020
2017,East Aurora,142401,2673,1210819,876,858105,2068924,03/11/2020
2017,Cheektowaga,143001,3390,1688520,1538,1538764,3227284,03/11/2020
2017,Cheektowaga-Maryvale,143002,3305,1787522,1655,1889027,3676549,03/11/2020
2017,Cleveland Hill,143003,2246,1788048,730,1200988,2989036,03/11/2020
2017,Depew,143007,2782,1760092,1348,1842669,3602761,03/11/2020
2017,Cheektowaga-Sloan,143009,2163,2022957,1044,2071657,4094614,03/11/2020
2017,Clarence,143201,5739,2460342,1591,1369675,3830017,03/11/2020
2017,Springville-Griffith,143801,2598,1340102,971,1035665,2375767,03/11/2020
2017,Eden,144001,2198,1264380,750,933597,2197977,03/11/2020
2017,Iroquois,144201,3826,1820961,1418,1452225,3273186,03/11/2020
2017,Evans-Brant,144401,3297,1673382,1287,1295173,2968555,03/11/2020
2017,Grand Island,144601,4353,2519800,1314,1640136,4159936,03/11/2020
2017,Hamburg,144801,4957,2798485,1648,2019635,4818120,03/11/2020
2017,Frontier,144804,7297,3152038,2600,2375231,5527269,03/11/2020
2017,Holland,145001,1467,595423,481,417319,1012742,03/11/2020
2017,Lancaster,145201,8918,4207530,2948,2889916,7097446,03/11/2020
2017,Akron,145601,1778,847054,752,706099,1553153,03/11/2020
2017,North Collins,145801,863,510235,318,390890,901125,03/11/2020
2017,Orchard Park,146001,6722,3646790,1956,2296454,5943244,03/11/2020
2017,Kenmore,146401,12808,7657174,5437,7068616,14725790,03/11/2020
2017,West Seneca,146801,10294,5342722,4634,5063509,10406231,03/11/2020
2017,Crown Point,152203,342,102428,168,99490,201918,03/11/2020
2017,Elizabethtown-Lewis,152401,412,162554,197,160239,322793,03/11/2020
2017,Keene,153001,212,55481,70,39916,95397,03/11/2020
2017,Minerva,153401,165,52413,113,72808,125221,03/11/2020
2017,Moriah,153601,784,428927,446,454100,883027,03/11/2020
2017,Newcomb,153801,89,6738,65,9743,16481,03/11/2020
2017,Lake Placid,154002,789,167415,361,161286,328701,03/11/2020
2017,Schroon Lake,154601,372,87203,209,100427,187630,03/11/2020
2017,Ticonderoga,154801,842,240166,506,287806,527972,03/11/2020
2017,Westport,155001,242,102337,129,112305,214642,03/11/2020
2017,Willsboro,155201,429,145084,252,166293,311377,03/11/2020
2017,Tupper Lake,162001,1015,380172,421,304873,685045,03/11/2020
2017,Chateaugay,163401,605,254169,276,235867,490036,03/11/2020
2017,Salmon River,164201,672,213456,324,200116,413572,03/11/2020
2017,Saranac Lake,164601,1828,517021,596,350366,867387,03/11/2020
2017,Malone,164801,2648,1262216,1115,1040783,2302999,03/11/2020
2017,Brushton-Moira,165001,870,430660,360,361443,792103,03/11/2020
2017,St. Regis Falls,165401,371,192137,210,207301,399438,03/11/2020
2017,Gloversville,170500,2425,1550428,1222,1427610,2978038,03/11/2020
2017,Johnstown,170800,1832,808183,757,694625,1502808,03/11/2020
2017,Broadalbin-Perth,172201,2032,1077014,850,923768,2000782,03/11/2020
2017,Wheelerville,172401,282,69053,158,81186,150239,03/11/2020
2017,Mayfield,173001,1112,553106,573,575043,1128149,03/11/2020
2017,Northville,173201,520,168392,261,180061,348453,03/11/2020
2017,Batavia,180200,2670,1720936,1018,1324913,3045849,03/11/2020
2017,Alexander,182202,1058,698394,372,516882,1215276,03/11/2020
2017,Byron-Bergen,183001,1332,984596,545,754801,1739397,03/11/2020
2017,Elba,183401,510,325292,209,274745,600037,03/11/2020
2017,Le Roy,183601,1464,1060437,540,806666,1867103,03/11/2020
2017,Oakfield-Alabama,183801,945,633072,368,514079,1147151,03/11/2020
2017,Pavilion,184001,955,592242,337,430647,1022889,03/11/2020
2017,Pembroke,184202,1340,799583,497,616457,1416040,03/11/2020
2017,Cairo-Durham,192401,1426,566432,754,617453,1183885,03/11/2020
2017,Catskill,192601,1760,857744,722,731670,1589414,03/11/2020
2017,Coxsackie-Athens,192801,1632,773535,660,654972,1428507,03/11/2020
2017,Greenville,193201,1618,881966,706,807161,1689127,03/11/2020
2017,Hunter-Tannersville,193601,486,151153,312,200092,351245,03/11/2020
2017,Windham-Ashland-Jewett,194601,410,94510,257,126410,220920,03/11/2020
2017,Piseco,202001,73,4222,35,4405,8627,03/11/2020
2017,Indian Lake,202601,262,53739,160,68886,122625,03/11/2020
2017,Inlet,202801,67,8336,47,12768,21104,03/11/2020
2017,Lake Pleasant,203001,153,35281,107,53251,88532,03/11/2020
2017,Long Lake,203201,120,14346,95,22739,37085,03/11/2020
2017,Raquette Lake,203202,16,181,14,347,528,03/11/2020
2017,Wells,203601,185,54243,117,73448,127691,03/11/2020
2017,Little Falls,210900,1089,886837,497,747327,1634164,03/11/2020
2017,West Canada Valley,212402,934,480700,348,375220,855920,03/11/2020
2017,Frankfort-Schuyler,212602,1210,771767,571,752819,1524586,03/11/2020
2017,Central Valley,212803,2203,1203316,1028,1131037,2334353,03/11/2020
2017,Herkimer,213001,1180,750672,732,916627,1667299,03/11/2020
2017,Dolgeville,213602,877,356683,445,361703,718386,03/11/2020
2017,Poland,213803,849,326982,337,266606,593588,03/11/2020
2017,Van Hornesville-Owen D. Young,215001,270,134820,115,119706,254526,03/11/2020
2017,Town Of Webb,215401,385,33596,270,51063,84659,03/11/2020
2017,Mount Markham,215601,1309,715294,519,566852,1282146,03/11/2020
2017,Watertown,221800,3029,840417,1152,670394,1510811,03/11/2020
2017,South Jefferson,222001,1964,658591,641,438302,1096893,03/11/2020
2017,Alexandria,222202,724,225230,302,196083,421313,03/11/2020
2017,Indian River,222401,1545,194546,513,132863,327409,03/11/2020
2017,General Brown,222601,1714,474565,591,344977,819542,03/11/2020
2017,Thousand Islands,223201,1345,421101,603,397570,818671,03/11/2020
2017,Belleville-Henderson,223402,632,154702,310,159401,314103,03/11/2020
2017,Sackets Harbor,223801,547,197987,167,128703,326690,03/11/2020
2017,Lyme,224401,504,147055,242,149605,296660,03/11/2020
2017,La Fargeville,224601,515,134531,187,103145,237676,03/11/2020
2017,Carthage,226001,2125,495492,737,358243,853735,03/11/2020
2017,Copenhagen,232201,545,147022,172,95714,242736,03/11/2020
2017,Harrisville,232401,430,208699,235,214983,423682,03/11/2020
2017,Lowville,233601,1386,291354,526,229002,520356,03/11/2020
2017,South Lewis,234001,1348,512327,560,425023,937350,03/11/2020
2017,Beaver River,234401,1116,349751,402,265531,615282,03/11/2020
2017,Avon,242001,1144,880191,386,596095,1476286,03/11/2020
2017,Caledonia-Mumford,242201,1140,667768,420,509794,1177562,03/11/2020
2017,Geneseo,242601,1246,624024,368,391958,1015982,03/11/2020
2017,Livonia,243401,2166,1362780,733,948506,2311286,03/11/2020
2017,Mount Morris,243601,516,413079,234,362115,775194,03/11/2020
2017,Dansville,243801,1802,916391,765,770262,1686653,03/11/2020
2017,Dalton-Nunda,244001,935,566753,405,474007,1040760,03/11/2020
2017,York,245201,1013,616882,359,443635,1060517,03/11/2020
2017,Oneida,251200,2324,1476607,1034,1381759,2858366,03/11/2020
2017,Brookfield,252009,262,119038,98,87627,206665,03/11/2020
2017,Cazenovia,252201,1965,987715,572,611700,1599415,03/11/2020
2017,De Ruyter,252401,464,251722,173,192086,443808,03/11/2020
2017,Morrisville-Eaton,252601,875,397556,300,275179,672735,03/11/2020
2017,Hamilton,253201,764,395454,266,289407,684861,03/11/2020
2017,Canastota,253601,1661,1144543,746,1061478,2206021,03/11/2020
2017,Madison,254001,518,290021,227,263596,553617,03/11/2020
2017,Stockbridge Valley,254601,555,321008,178,211232,532240,03/11/2020
2017,Chittenango,254801,2674,1818203,1010,1372385,3190588,03/11/2020
2017,Rochester,261400,19069,7077629,4676,3060481,10138110,03/11/2020
2017,Brighton,262001,4241,3273255,1009,1649573,4922828,03/11/2020
2017,Gates-Chili,262601,6482,5064331,2928,4685614,9749945,03/11/2020
2017,Greece,262801,14967,10756354,5714,8757433,19513787,03/11/2020
2017,East Irondequoit,263401,5449,4841453,2115,3997342,8838795,03/11/2020
2017,West Irondequoit,263403,5242,4389156,1860,3363876,7753032,03/11/2020
2017,Honeoye Falls-Lima,263601,2783,1947288,635,949136,2896424,03/11/2020
2017,Spencerport,263801,4581,3337259,1604,2503779,5841038,03/11/2020
2017,Hilton,264001,5578,3887788,1988,2940556,6828344,03/11/2020
2017,Penfield,264201,6541,5008138,1960,3196515,8204653,03/11/2020
2017,Fairport,264401,8121,5470428,2618,3750088,9220516,03/11/2020
2017,East Rochester,264413,1407,1093967,654,990000,2083967,03/11/2020
2017,Pittsford,264601,6713,5173236,1332,2203909,7377145,03/11/2020
2017,Churchville-Chili,264801,5083,3595428,1715,2552119,6147547,03/11/2020
2017,Rush-Henrietta,265001,7755,4628210,2600,3285174,7913384,03/11/2020
2017,Brockport,265201,4187,3176023,1302,2011181,5187204,03/11/2020
2017,Webster,265401,11245,7168746,3884,5336111,12504857,03/11/2020
2017,Wheatland-Chili,265601,1116,782072,414,593016,1375088,03/11/2020
2017,Amsterdam,270100,3374,1928974,1762,1998214,3927188,03/11/2020
2017,Canajoharie,272201,1098,618685,485,566559,1185244,03/11/2020
2017,Fonda-Fultonville,272801,1730,840064,602,598166,1438230,03/11/2020
2017,Fort Plain,273001,799,577439,411,588373,1165812,03/11/2020
2017,Oppenheim-Ephratah-St.Johnsvil,273803,1019,461059,498,444632,905691,03/11/2020
2017,Glen Cove,280500,3146,3091945,986,2021025,5112970,03/11/2020
2017,Long Beach,281000,6087,4911705,1080,1826400,6738105,03/11/2020
2017,Hempstead,282001,2444,3529982,441,1335211,4865193,03/11/2020
2017,Uniondale,282002,4469,4398797,854,1792441,6191238,03/11/2020
2017,East Meadow,282003,10072,12331892,2735,6164401,18496293,03/11/2020
2017,North Bellmore,282004,5386,7455102,1079,3169356,10624458,03/11/2020
2017,Levittown,282005,9903,16396189,2248,7936715,24332904,03/11/2020
2017,Seaford,282006,3534,4960484,739,2086754,7047238,03/11/2020
2017,Bellmore,282007,2676,3634078,440,1284911,4918989,03/11/2020
2017,Roosevelt,282008,1851,2258472,324,832872,3091344,03/11/2020
2017,Freeport,282009,5100,6959427,1028,2792917,9752344,03/11/2020
2017,Baldwin,282010,6378,9706835,979,3054923,12761758,03/11/2020
2017,Oceanside,282011,7823,9704457,1497,3779227,13483684,03/11/2020
2017,Malverne,282012,2786,4124146,528,1677706,5801852,03/11/2020
2017,Valley Stream 13,282013,5563,7247966,1315,3510243,10758209,03/11/2020
2017,Hewlett-Woodmere,282014,3918,6786550,559,2023473,8810023,03/11/2020
2017,Lawrence,282015,5071,3916933,719,1162235,5079168,03/11/2020
2017,Elmont,282016,7309,9005805,1333,3509648,12515453,03/11/2020
2017,Franklin Square,282017,4618,4887896,1224,2786343,7674239,03/11/2020
2017,Garden City,282018,4502,4008636,534,1005022,5013658,03/11/2020
2017,East Rockaway,282019,1852,2628292,462,1341421,3969713,03/11/2020
2017,Lynbrook,282020,3458,5030170,632,1863306,6893476,03/11/2020
2017,Rockville Centre,282021,4324,5698816,567,1510483,7209299,03/11/2020
2017,Floral Park-Bellerose,282022,3957,4111811,739,1610459,5722270,03/11/2020
2017,Wantagh,282023,4011,5513883,617,1822458,7336341,03/11/2020
2017,Valley Stream 24,282024,2277,2709622,433,1109670,3819292,03/11/2020
2017,Merrick,282025,4006,5813896,565,1763143,7577039,03/11/2020
2017,Island Trees,282026,3038,3601652,746,1891302,5492954,03/11/2020
2017,West Hempstead,282027,3217,4123848,628,1726676,5850524,03/11/2020
2017,North Merrick,282029,3087,4250261,585,1690941,5941202,03/11/2020
2017,Valley Stream 30,282030,2771,3311342,415,1064930,4376272,03/11/2020
2017,Island Park,282031,1340,1148639,275,506812,1655451,03/11/2020
2017,Westbury,282201,2660,4317291,614,2037517,6354808,03/11/2020
2017,East Williston,282202,1556,1910228,190,500226,2410454,03/11/2020
2017,Roslyn,282203,3083,3814557,331,859174,4673731,03/11/2020
2017,Port Washington,282204,4497,4295179,675,1370420,5665599,03/11/2020
2017,New Hyde Park-Garden City,282205,4411,4621447,950,2142862,6764309,03/11/2020
2017,Manhasset,282206,2536,1731891,268,393521,2125412,03/11/2020
2017,Great Neck,282207,7768,5705703,939,1459481,7165184,03/11/2020
2017,Herricks,282209,5284,6085091,875,2168462,8253553,03/11/2020
2017,Mineola,282210,4186,4384034,996,2238342,6622376,03/11/2020
2017,Carle Place,282211,1713,1949272,376,920355,2869627,03/11/2020
2017,North Shore,282401,3052,2982069,479,1005144,3987213,03/11/2020
2017,Syosset,282402,6543,9151343,933,2323650,11474993,03/11/2020
2017,Locust Valley,282403,2575,2277332,423,805626,3082958,03/11/2020
2017,Plainview-Old Bethpage,282404,6456,9073605,1124,3401747,12475352,03/11/2020
2017,Oyster Bay-East Norwich,282406,2038,1487317,321,491671,1978988,03/11/2020
2017,Jericho,282415,2374,2771723,252,634271,3405994,03/11/2020
2017,Hicksville,282417,6909,6520953,1730,3403732,9924685,03/11/2020
2017,Plainedge,282418,4125,6862882,985,3522111,10384993,03/11/2020
2017,Bethpage,282421,3894,4435562,1104,2106708,6542270,03/11/2020
2017,Farmingdale,282422,7746,10710157,1826,5354372,16064529,03/11/2020
2017,Massapequa,282423,10328,12803615,2096,5544156,18347771,03/11/2020
2017,Lockport,290900,5156,4074980,2005,2921991,6996971,03/11/2020
2017,Niagara Falls,291100,6476,3161784,3054,2841149,6002933,03/11/2020
2017,North Tonawanda,291200,5521,3219541,2427,3028714,6248255,03/11/2020
2017,Lewiston-Porter,292401,3437,1834612,1479,1710273,3544885,03/11/2020
2017,Newfane,292801,1986,1586264,883,1386488,2972752,03/11/2020
2017,Niagara-Wheatfield,293001,4675,2431071,2011,2148756,4579827,03/11/2020
2017,Starpoint,293201,3864,2390887,1209,1626660,4017547,03/11/2020
2017,Royalton-Hartland,293601,1765,1178781,692,976750,2155531,03/11/2020
2017,Barker,293801,947,446963,413,413163,860126,03/11/2020
2017,Wilson,294201,1556,1088709,669,999062,2087771,03/11/2020
2017,Rome,301300,5217,3447169,2184,2897286,6344455,03/11/2020
2017,Utica,301600,6430,3634424,2788,3119741,6754165,03/11/2020
2017,Adirondack,302601,1678,702970,747,626196,1329166,03/11/2020
2017,Camden,303001,2439,1010546,993,813237,1823783,03/11/2020
2017,Clinton,304001,1586,1228119,639,1069423,2297542,03/11/2020
2017,New Hartford,304801,3506,2480506,1114,1635682,4116188,03/11/2020
2017,New York Mills,304804,745,491142,393,553189,1044331,03/11/2020
2017,Sauquoit Valley,305002,1261,746609,436,540940,1287549,03/11/2020
2017,Remsen,305201,640,381977,270,338033,720010,03/11/2020
2017,Waterville,305401,1027,536709,375,401133,937842,03/11/2020
2017,Holland Patent,305801,1890,1157666,702,891481,2049147,03/11/2020
2017,Sherrill,306000,2310,1417546,990,1265389,2682935,03/11/2020
2017,Westmoreland,306801,1321,982805,522,799775,1782580,03/11/2020
2017,Oriskany,307001,830,506365,336,428739,935104,03/11/2020
2017,Whitesboro,307002,4550,2906358,1725,2386733,5293091,03/11/2020
2017,Syracuse,311500,12708,5460403,4059,3466419,8926822,03/11/2020
2017,West Genesee,312001,6614,4500867,2642,3745058,8245925,03/11/2020
2017,North Syracuse,312403,12195,8413754,3870,5385899,13799653,03/11/2020
2017,East Syracuse-Minoa,312601,4223,3161669,1808,2675791,5837460,03/11/2020
2017,Jamesville-Dewitt,312611,3552,2444900,787,1141626,3586526,03/11/2020
2017,Jordan-Elbridge,312801,1512,1214030,595,923455,2137485,03/11/2020
2017,Fabius-Pompey,313001,969,757584,325,520956,1278540,03/11/2020
2017,Westhill,313201,2467,2046092,817,1433229,3479321,03/11/2020
2017,Solvay,313202,1501,1215616,839,1326701,2542317,03/11/2020
2017,La Fayette,313407,927,519531,288,330530,850061,03/11/2020
2017,Baldwinsville,313601,7151,5052486,2156,3180669,8233155,03/11/2020
2017,Fayetteville-Manlius,313801,5076,3896053,1235,2016647,5912700,03/11/2020
2017,Marcellus,314001,2380,1662854,754,1120045,2782899,03/11/2020
2017,Onondaga,314201,1361,1142207,435,755030,1897237,03/11/2020
2017,Liverpool,314801,8847,7037267,3257,5311237,12348504,03/11/2020
2017,Lyncourt,314804,656,612078,370,612694,1224772,03/11/2020
2017,Skaneateles,315001,1713,725556,604,549590,1275146,03/11/2020
2017,Tully,315402,1218,717228,339,416608,1133836,03/11/2020
2017,Canandaigua,320200,3989,2266751,1410,1690637,3957388,03/11/2020
2017,Geneva,320500,2258,1430674,1010,1320497,2751171,03/11/2020
2017,East Bloomfield,322601,1181,849067,404,611644,1460711,03/11/2020
2017,Gorham-Middlesex,323201,1869,805146,742,661921,1467067,03/11/2020
2017,Manchester-Shortsville,323601,1003,850824,418,719439,1570263,03/11/2020
2017,Naples,323801,1086,497642,474,457743,955385,03/11/2020
2017,Phelps-Clifton Springs,324001,1972,1469861,692,1066013,2535874,03/11/2020
2017,Honeoye,324201,1212,569709,516,506916,1076625,03/11/2020
2017,Victor,324801,4454,2206806,1172,1225272,3432078,03/11/2020
2017,Middletown,330900,5002,4349933,1286,2349694,6699627,03/11/2020
2017,Newburgh,331100,8068,7483623,2515,4720273,12203896,03/11/2020
2017,Port Jervis,331300,2182,2305769,912,1902369,4208138,03/11/2020
2017,Washingtonville,332002,4646,4292242,885,1759264,6051506,03/11/2020
2017,Chester,332201,1122,940225,285,501771,1441996,03/11/2020
2017,Cornwall,332401,3055,2954411,574,1199461,4153872,03/11/2020
2017,Pine Bush,332601,5145,4060055,1190,1969859,6029914,03/11/2020
2017,Goshen,333001,2769,2324722,613,1107921,3432643,03/11/2020
2017,Highland Falls,333601,732,597731,202,342843,940574,03/11/2020
2017,Minisink Valley,333801,4150,3312345,858,1452508,4764853,03/11/2020
2017,Monroe-Woodbury,334001,7050,6620530,1230,2483177,9103707,03/11/2020
2017,Kiryas Joel Village,334002,803,400538,86,88402,488940,03/11/2020
2017,Valley,334201,4458,3896067,1204,2218537,6114604,03/11/2020
2017,Tuxedo,335003,430,214247,96,104453,318700,03/11/2020
2017,Warwick Valley,335401,4374,3615706,948,1698346,5314052,03/11/2020
2017,Greenwood Lake,335411,1266,1091046,293,545754,1636800,03/11/2020
2017,Florida,335415,990,976446,252,534713,1511159,03/11/2020
2017,Albion,342001,1954,931559,884,851439,1782998,03/11/2020
2017,Kendall,343007,998,493214,413,429579,922793,03/11/2020
2017,Holley,343204,1273,895040,545,774278,1669318,03/11/2020
2017,Medina,343401,1703,1119968,848,1103409,2223377,03/11/2020
2017,Lyndonville,343801,795,383386,361,358180,741566,03/11/2020
2017,Fulton,350400,3065,2424861,1244,1899624,4324485,03/11/2020
2017,Oswego,351200,4387,2655837,1638,1959932,4615769,03/11/2020
2017,Altmar Parish-Williamstown,352002,1361,618020,510,457079,1075099,03/11/2020
2017,Hannibal,353001,1393,977600,510,714443,1692043,03/11/2020
2017,Central Square,353201,4764,2686784,1614,1854379,4541163,03/11/2020
2017,Mexico,353401,2536,1367246,848,935076,2302322,03/11/2020
2017,Pulaski,355001,1004,615452,392,496913,1112365,03/11/2020
2017,Sandy Creek,355201,1016,441264,464,398339,839603,03/11/2020
2017,Phoenix,355401,2219,1899549,828,1439662,3339211,03/11/2020
2017,Oneonta,361200,2154,1220595,850,1002689,2223284,03/11/2020
2017,Gilbertsville-Mt Upton,362202,529,184116,309,215388,399504,03/11/2020
2017,Cherry Valley-Springfield,362401,752,254848,389,274014,528862,03/11/2020
2017,Edmeston,362801,576,206052,211,158902,364954,03/11/2020
2017,Laurens,363401,462,224363,235,242602,466965,03/11/2020
2017,Schenevus,363601,471,234974,244,251267,486241,03/11/2020
2017,Milford,364001,500,216116,321,290810,506926,03/11/2020
2017,Morris,364201,492,240929,231,229048,469977,03/11/2020
2017,Otego-Unadilla,364801,1158,639980,552,634522,1274502,03/11/2020
2017,Cooperstown,365001,1065,342654,436,297734,640388,03/11/2020
2017,Richfield Springs,365601,669,204886,401,254035,458921,03/11/2020
2017,Worcester,366606,428,237712,250,287449,525161,03/11/2020
2017,Mahopac,372001,5325,6088274,1065,2624726,8713000,03/11/2020
2017,Carmel,372002,5664,7366849,1254,3467496,10834345,03/11/2020
2017,Haldane,372601,949,787800,267,446296,1234096,03/11/2020
2017,Garrison,372604,414,193742,75,76632,270374,03/11/2020
2017,Putnam Valley,372803,2302,3271654,430,1284931,4556585,03/11/2020
2017,Brewster,373001,4103,4316877,951,2161423,6478300,03/11/2020
2017,Rensselaer,381400,1100,520238,373,346980,867218,03/11/2020
2017,Troy,381700,3502,2105829,1109,1390500,3496329,03/11/2020
2017,Lansingburgh,381701,2132,1104357,879,938960,2043317,03/11/2020
2017,Berlin,382001,1324,605617,492,461612,1067229,03/11/2020
2017,Brunswick,382202,1628,887293,527,592331,1479624,03/11/2020
2017,East Greenbush,382401,5986,3196841,1658,1867914,5064755,03/11/2020
2017,Hoosick Falls,382801,1401,774948,538,590774,1365722,03/11/2020
2017,North Greenbush,383201,337,58021,131,48902,106923,03/11/2020
2017,Wynantskill,383204,783,493943,283,381166,875109,03/11/2020
2017,Averill Park,384001,4135,2198636,1046,1175151,3373787,03/11/2020
2017,Hoosic Valley,384201,1364,704643,426,463012,1167655,03/11/2020
2017,Schodack,384401,1322,840082,351,475735,1315817,03/11/2020
2017,Clarkstown,392001,10139,10084445,1976,4267458,14351903,03/11/2020
2017,Nanuet,392008,2188,2441680,550,1305621,3747301,03/11/2020
2017,Haverstraw-Stony Point,392201,6951,12556253,1951,6975370,19531623,03/11/2020
2017,South Orangetown,392401,3998,4501329,844,2067046,6568375,03/11/2020
2017,Nyack,392404,3584,5000489,769,2394353,7394842,03/11/2020
2017,Pearl River,392408,2995,3606894,696,1816871,5423765,03/11/2020
2017,Ramapo,392601,4611,7721694,1174,4020362,11742056,03/11/2020
2017,East Ramapo,392602,9422,9869166,1888,3907491,13776657,03/11/2020
2017,Ogdensburg,401200,1724,1325621,706,956190,2281811,03/11/2020
2017,Brasher Falls,402001,1107,726296,473,603040,1329336,03/11/2020
2017,Canton,402201,1545,924361,525,629070,1553431,03/11/2020
2017,Clifton-Fine,402601,400,130637,228,133148,263785,03/11/2020
2017,Colton-Pierrepont,402801,550,237961,262,239816,477777,03/11/2020
2017,Edwards-Knox,403401,627,185983,274,159634,345617,03/11/2020
2017,Gouverneur,404001,1546,586134,659,471711,1057845,03/11/2020
2017,Hammond,404201,353,141041,152,123409,264450,03/11/2020
2017,Hermon-Dekalb,404401,455,233214,215,216986,450200,03/11/2020
2017,Lisbon,405002,746,407338,265,294266,701604,03/11/2020
2017,Madrid-Waddington,405601,818,416328,394,406734,823062,03/11/2020
2017,Massena,405801,2839,1534998,1348,1411823,2946821,03/11/2020
2017,Morristown,406001,524,232530,244,222432,454962,03/11/2020
2017,Norwood-Norfolk,406201,1198,883513,584,848538,1732051,03/11/2020
2017,Heuvelton,406404,750,452487,288,349989,802476,03/11/2020
2017,Parishville-Hopkinton,406601,515,205675,260,204869,410544,03/11/2020
2017,Potsdam,407402,1621,1124597,536,753815,1878412,03/11/2020
2017,Mechanicville,411000,1498,892674,514,664398,1557072,03/11/2020
2017,Saratoga Springs,411500,8080,3791791,1816,1792360,5584151,03/11/2020
2017,Burnt Hills-Ballston Lake,412001,4458,3066024,1211,1802186,4868210,03/11/2020
2017,Shenendehowa,412402,12771,8766755,2511,3682615,12449370,03/11/2020
2017,Corinth,412601,1309,587795,548,486409,1074204,03/11/2020
2017,Edinburg,413001,283,51894,157,57049,108943,03/11/2020
2017,Galway,413201,1464,752809,490,506191,1259000,03/11/2020
2017,Ballston Spa,414201,4757,3626897,1218,1831444,5458341,03/11/2020
2017,South Glens Falls,414401,3532,2230495,1176,1550525,3781020,03/11/2020
2017,Schuylerville,415001,2027,1518985,556,841044,2360029,03/11/2020
2017,Stillwater,415201,1527,748161,448,453728,1201889,03/11/2020
2017,Waterford-Halfmoon,415401,878,762750,357,621882,1384632,03/11/2020
2017,Schenectady,421500,6488,4518490,2342,3043096,7561586,03/11/2020
2017,Duanesburg,422001,1137,578338,330,352451,930789,03/11/2020
2017,Scotia-Glenville,422202,3666,2154054,1098,1382677,3536731,03/11/2020
2017,Niskayuna,422401,5283,2989373,994,1225300,4214673,03/11/2020
2017,Schalmont,422801,2862,1614981,1015,1235738,2850719,03/11/2020
2017,Rotterdam-Mohonasen,422803,4146,2033643,1714,1815483,3849126,03/11/2020
2017,Cobleskill-Richmondville,432602,1945,1103007,944,1062327,2165334,03/11/2020
2017,Gilboa-Conesville,433401,444,144980,297,193699,338679,03/11/2020
2017,Jefferson,433601,344,145956,180,154864,300820,03/11/2020
2017,Middleburgh,433801,1020,637884,521,626760,1264644,03/11/2020
2017,Schoharie,434201,1254,807520,509,667332,1474852,03/11/2020
2017,Sharon Springs,434601,338,195189,169,201468,396657,03/11/2020
2017,Odessa-Montour,442001,1032,449517,432,398387,847904,03/11/2020
2017,Watkins Glen,442401,1489,518982,674,497736,1016718,03/11/2020
2017,South Seneca,452801,1038,441126,531,469470,910596,03/11/2020
2017,Romulus,453003,565,282731,252,266447,549178,03/11/2020
2017,Seneca Falls,453201,1637,1151974,703,1006627,2158601,03/11/2020
2017,Waterloo,453801,1866,1121341,821,1039719,2161060,03/11/2020
2017,Corning,460300,5906,4281273,2217,3249161,7530434,03/11/2020
2017,Hornell,460600,1505,776403,644,627132,1403535,03/11/2020
2017,Addison,462001,1284,688875,518,534832,1223707,03/11/2020
2017,Avoca,462201,665,243618,305,216290,459908,03/11/2020
2017,Bath,462402,1568,821194,627,670502,1491696,03/11/2020
2017,Bradford,462601,371,177370,161,160149,337519,03/11/2020
2017,Campbell-Savona,463002,1013,551023,416,461324,1012347,03/11/2020
2017,Canisteo-Greenwood,463202,1005,493911,582,549963,1043874,03/11/2020
2017,Arkport,465201,559,357498,287,342287,699785,03/11/2020
2017,Jasper-Troupsburg,465601,539,218826,229,193221,412047,03/11/2020
2017,Prattsburgh,466001,565,233916,227,183660,417576,03/11/2020
2017,Hammondsport,467201,847,252245,398,247087,499332,03/11/2020
2017,Wayland-Cohocton,467401,1727,827634,713,677451,1505085,03/11/2020
2017,Babylon,472001,2255,3039056,381,1091352,4130408,03/11/2020
2017,West Babylon,472002,4629,5847187,1045,2821950,8669137,03/11/2020
2017,North Babylon,472003,5496,6647736,1399,3653470,10301206,03/11/2020
2017,Lindenhurst,472004,7093,9491504,1752,5039002,14530506,03/11/2020
2017,Copiague,472005,4046,4916922,1147,2873977,7790899,03/11/2020
2017,Amityville,472006,3552,4250384,1068,2206649,6457033,03/11/2020
2017,Deer Park,472007,4394,5466856,1300,3447411,8914267,03/11/2020
2017,Wyandanch,472009,881,1173594,208,586948,1760542,03/11/2020
2017,Three Village,472201,7787,9124323,1538,3847939,12972262,03/11/2020
2017,Brookhaven-Comsewogue,472203,3762,4292438,930,2188283,6480721,03/11/2020
2017,South Country,472204,4191,4433612,818,1849007,6282619,03/11/2020
2017,Sachem,472205,14820,13972098,3129,6261886,20233984,03/11/2020
2017,Port Jefferson,472206,1305,866117,247,354296,1220413,03/11/2020
2017,Mount Sinai,472207,2697,3248670,644,1675490,4924160,03/11/2020
2017,Miller Place,472208,3210,3894736,478,1242474,5137210,03/11/2020
2017,Rocky Point,472209,3436,4551438,535,1499775,6051213,03/11/2020
2017,Middle Country,472211,10310,11911226,2545,6236321,18147547,03/11/2020
2017,Longwood,472212,10184,12327874,3358,7832124,20159998,03/11/2020
2017,Patchogue-Medford,472224,7984,9415015,1802,4410181,13825196,03/11/2020
2017,William Floyd,472232,7543,9640265,1617,4244466,13884731,03/11/2020
2017,Center Moriches,472233,1525,1948462,277,755050,2703512,03/11/2020
2017,East Moriches,472234,1216,1514978,182,490829,2005807,03/11/2020
2017,Eastport- South Manor,472235,3599,4310029,867,1981899,6291928,03/11/2020
2017,East Hampton,472401,841,141207,285,101492,242699,03/11/2020
2017,Wainscott,472402,59,2619,19,1847,4466,03/11/2020
2017,Amagansett,472403,133,6250,66,19609,25859,03/11/2020
2017,Springs,472404,700,219917,294,202414,422331,03/11/2020
2017,Sag Harbor,472405,911,230187,395,218215,448402,03/11/2020
2017,Montauk,472406,397,65491,189,68391,133882,03/11/2020
2017,Elwood,472601,2753,3179661,549,1379778,4559439,03/11/2020
2017,Cold Spring Harbor,472602,1104,1082830,86,183798,1266628,03/11/2020
2017,Huntington,472603,5863,6129897,1100,2455080,8584977,03/11/2020
2017,Northport-East Northport,472604,7466,6012531,1393,2435668,8448199,03/11/2020
2017,Half Hollow Hills,472605,8263,7838046,1852,3619652,11457698,03/11/2020
2017,Harborfields,472606,3761,4233981,630,1540001,5773982,03/11/2020
2017,Commack,472610,8027,9581675,1674,4342412,13924087,03/11/2020
2017,South Huntington,472613,6891,8022949,1563,3947117,11970066,03/11/2020
2017,Bay Shore,472801,4884,6116876,1041,2749380,8866256,03/11/2020
2017,Islip,472802,3346,4431064,720,1937925,6368989,03/11/2020
2017,East Islip,472803,4819,5801651,1079,3011207,8812858,03/11/2020
2017,Sayville,472804,3623,4374929,823,2162038,6536967,03/11/2020
2017,Bayport-Blue Point,472805,2672,3668413,494,1472434,5140847,03/11/2020
2017,Hauppauge,472806,4568,3301964,1019,1576788,4878752,03/11/2020
2017,Connetquot,472807,7423,8552229,1871,4518869,13071098,03/11/2020
2017,West Islip,472809,6035,6866250,1274,3151385,10017635,03/11/2020
2017,Brentwood,472812,7875,6381726,2016,3550743,9932469,03/11/2020
2017,Central Islip,472813,4489,6299745,1128,3353211,9652956,03/11/2020
2017,Fire Island,472814,83,9384,20,4931,14315,03/11/2020
2017,Shoreham-Wading River,473001,2748,2957657,686,1520016,4477673,03/11/2020
2017,Riverhead,473002,5479,4389554,2473,3763251,8152805,03/11/2020
2017,Shelter Island,473201,435,65196,157,51142,116338,03/11/2020
2017,Smithtown,473401,12025,13034218,2444,5541820,18576038,03/11/2020
2017,Kings Park,473405,4758,4666148,934,1977900,6644048,03/11/2020
2017,Remsenburg-Speonk,473601,307,90083,84,53761,143844,03/11/2020
2017,Westhampton Beach,473602,762,249102,218,152089,401191,03/11/2020
2017,Quogue,473603,157,15899,40,8897,24796,03/11/2020
2017,Hampton Bays,473605,1786,1235352,692,1038210,2273562,03/11/2020
2017,Southhampton,473606,1131,131676,394,99506,231182,03/11/2020
2017,Bridgehampton,473609,160,14054,52,9972,24026,03/11/2020
2017,Sagaponack,473610,25,410,4,143,553,03/11/2020
2017,Tuckahoe Common,473613,364,138521,151,123762,262283,03/11/2020
2017,East Quogue,473617,890,534660,271,347045,881705,03/11/2020
2017,Oysterponds,473802,312,66273,128,59147,125420,03/11/2020
2017,Fishers Island,473804,29,6249,3,1406,7655,03/11/2020
2017,Southold,473805,1237,606708,453,487588,1094296,03/11/2020
2017,Greenport,473810,494,274468,228,284891,559359,03/11/2020
2017,Mattituck-Cutchogue,473812,1760,892313,565,622570,1514883,03/11/2020
2017,New Suffolk,473815,70,13520,25,10505,24025,03/11/2020
2017,Fallsburg,482801,901,625375,353,490297,1115672,03/11/2020
2017,Eldred,483401,867,350367,343,293322,643689,03/11/2020
2017,Liberty,483601,1062,751070,531,784941,1536011,03/11/2020
2017,Tri-Valley,484201,1048,560810,386,412826,973636,03/11/2020
2017,Roscoe,484401,286,122261,163,148670,270931,03/11/2020
2017,Livingston Manor,484402,491,207653,243,207311,414964,03/11/2020
2017,Monticello,484601,2459,1203730,1040,1035700,2239430,03/11/2020
2017,Sullivan West,484802,1670,656504,917,752496,1409000,03/11/2020
2017,Waverly,492001,1600,711795,649,592736,1304531,03/11/2020
2017,Candor,492401,876,483885,390,429024,912909,03/11/2020
2017,Newark Valley,492602,1501,865057,558,668052,1533109,03/11/2020
2017,Owego-Apalachin,493001,2462,1467013,998,1221328,2688341,03/11/2020
2017,Spencer-Van Etten,493401,1080,502302,500,481254,983556,03/11/2020
2017,Tioga,493603,961,284863,409,254710,539573,03/11/2020
2017,Ithaca,500700,6817,3641212,1747,1853734,5494946,03/11/2020
2017,Dryden,502401,2060,1412978,722,939708,2352686,03/11/2020
2017,Groton,502801,1107,671196,391,481675,1152871,03/11/2020
2017,Lansing,503201,1463,894776,396,510430,1405206,03/11/2020
2017,Newfield,503401,968,493424,389,361328,854752,03/11/2020
2017,Trumansburg,503601,1454,797062,484,547653,1344715,03/11/2020
2017,Kingston,510800,7178,4841564,2912,4109168,8950732,03/11/2020
2017,Highland,513203,1989,1403262,592,877962,2281224,03/11/2020
2017,Rondout Valley,513401,2974,1628136,1121,1294541,2922677,03/11/2020
2017,Marlboro,513601,2018,1654312,567,947630,2601942,03/11/2020
2017,New Paltz,513801,2717,1768334,687,960757,2729091,03/11/2020
2017,Onteora,514001,2552,917280,1401,1071361,1988641,03/11/2020
2017,Saugerties,514801,3550,2196921,1447,1908315,4105236,03/11/2020
2017,Wallkill,515201,3487,3014250,993,1565075,4579325,03/11/2020
2017,Ellenville,515602,1344,969338,561,757603,1726941,03/11/2020
2017,Glens Falls,520500,2202,1144846,930,1039044,2183890,03/11/2020
2017,Bolton,522001,296,43223,172,54504,97727,03/11/2020
2017,Lake George,522201,1180,223266,536,219352,442618,03/11/2020
2017,North Warren,522402,833,164201,494,206463,370664,03/11/2020
2017,Johnsburg,523001,423,136041,252,173481,309522,03/11/2020
2017,Hadley-Luzerne,523201,1133,379801,568,384069,763870,03/11/2020
2017,Queensbury,523402,3735,1701258,1338,1267517,2968775,03/11/2020
2017,Glens Falls Common,523418,203,78462,80,64412,142874,03/11/2020
2017,Warrensburg,524001,954,399827,518,454266,854093,03/11/2020
2017,Argyle,532001,754,359957,323,316070,676027,03/11/2020
2017,Fort Ann,532802,689,271328,250,211739,483067,03/11/2020
2017,Fort Edward,533001,432,217891,202,220497,438388,03/11/2020
2017,Granville,533201,1208,574797,582,563613,1138410,03/11/2020
2017,Greenwich,533401,1269,625211,499,527634,1152845,03/11/2020
2017,Hartford,533801,570,293281,271,294788,588069,03/11/2020
2017,Hudson Falls,534401,2216,881625,977,828638,1710263,03/11/2020
2017,Putnam,534601,141,22657,65,21378,44035,03/11/2020
2017,Salem,534801,727,306682,335,292418,599100,03/11/2020
2017,Cambridge,535010,1153,498350,549,488096,986446,03/11/2020
2017,Whitehall,535201,728,226878,385,232138,459016,03/11/2020
2017,Newark,542001,2291,1440739,989,1298406,2739145,03/11/2020
2017,Clyde-Savannah,542401,918,565376,451,554068,1119444,03/11/2020
2017,Lyons,542801,1038,630455,428,497066,1127521,03/11/2020
2017,Gananda,543002,1250,1155254,214,424196,1579450,03/11/2020
2017,Marion,543201,1143,816890,405,614271,1431161,03/11/2020
2017,Wayne,543401,3088,1922940,1073,1425186,3348126,03/11/2020
2017,Palmyra-Macedon,543601,2118,1648751,907,1473555,3122306,03/11/2020
2017,Sodus,544201,1207,751350,616,763928,1515278,03/11/2020
2017,Williamson,544602,1268,937336,496,783818,1721154,03/11/2020
2017,North Rose-Wolcott,544801,1443,645927,745,687712,1333639,03/11/2020
2017,Red Creek,544803,973,400168,440,374574,774742,03/11/2020
2017,Mount Vernon,550800,4331,12845733,1170,5886636,18732369,03/11/2020
2017,New Rochelle,551000,6997,14508806,1338,5432922,19941728,03/11/2020
2017,Peekskill,551200,2629,5790934,604,2308946,8099880,03/11/2020
2017,Rye,551400,1276,1253142,252,521958,1775100,03/11/2020
2017,White Plains,551700,6038,5466657,1059,11953501,17420158,03/11/2020
2017,Yonkers,551800,14468,29910982,3989,5722663,35633645,03/11/2020
2017,Katonah-Lewisboro,552001,3615,6178945,503,1764068,7943013,03/11/2020
2017,Bedford,552002,3423,4454725,675,1727867,6182592,03/11/2020
2017,Croton-Harmon,552202,1830,3442869,300,1144281,4587150,03/11/2020
2017,Hendrick Hudson,552203,2857,4742937,476,1516899,6259836,03/11/2020
2017,Eastchester,552401,2537,6085115,585,2790539,8875654,03/11/2020
2017,Tuckahoe,552402,1041,1938172,157,611644,2549816,03/11/2020
2017,Bronxville,552403,377,882202,36,247568,1129770,03/11/2020
2017,Tarrytowns,552601,1892,4100250,442,1871923,5972173,03/11/2020
2017,Irvington,552602,1222,2745569,200,922995,3668564,03/11/2020
2017,Dobbs Ferry,552603,1013,2539821,195,991526,3531347,03/11/2020
2017,Hastings On Hudson,552604,1334,3024335,231,1068940,4093275,03/11/2020
2017,Ardsley,552605,1949,3954395,295,1305746,5260141,03/11/2020
2017,Edgemont,552606,958,2375363,93,530523,2905886,03/11/2020
2017,Greenburgh,552607,3280,5979671,846,2719166,8698837,03/11/2020
2017,Elmsford,552609,1060,1735259,293,1018592,2753851,03/11/2020
2017,Harrison,552801,2311,2730542,587,1408179,4138721,03/11/2020
2017,Mamaroneck,553201,3075,4491312,490,1442110,5933422,03/11/2020
2017,Mount Pleasant,553401,2402,3605226,661,2141706,5746932,03/11/2020
2017,Pocantico Hills,553402,357,293623,73,124020,417643,03/11/2020
2017,Valhalla,553405,1537,2706783,349,1293208,3999991,03/11/2020
2017,Pleasantville,553409,1613,3237766,314,1182320,4420086,03/11/2020
2017,Chappaqua,553604,2485,4403121,239,903603,5306724,03/11/2020
2017,Byram Hills,553801,1674,2105076,208,562696,2667772,03/11/2020
2017,North Salem,554001,1397,1935946,267,739843,2675789,03/11/2020
2017,Ossining,554201,4625,10532633,853,3850418,14383051,03/11/2020
2017,Briarcliff Manor,554202,1168,2379484,102,452177,2831661,03/11/2020
2017,Pelham,554401,1679,3052204,285,1044856,4097060,03/11/2020
2017,Rye Neck,554801,1064,1498347,257,930458,2428805,03/11/2020
2017,Port Chester-Rye,554804,2267,3625129,836,3062601,6687730,03/11/2020
2017,Blind Brook-Rye,554805,1106,1591112,168,526733,2117845,03/11/2020
2017,Scarsdale,555001,2135,2878366,202,592144,3470510,03/11/2020
2017,Somers,555201,4036,6686160,1255,3951348,10637508,03/11/2020
2017,Lakeland,555401,7129,15021284,1831,6638384,21659668,03/11/2020
2017,Yorktown,555402,4320,8950318,704,3042820,11993138,03/11/2020
2017,Attica,562201,2000,979652,720,750946,1730598,03/11/2020
2017,Letchworth,562601,1155,476624,438,364361,840985,03/11/2020
2017,Wyoming,563802,343,163121,136,134825,297946,03/11/2020
2017,Perry,564201,987,492346,472,478663,971009,03/11/2020
2017,Warsaw,564801,1162,708425,401,517029,1225454,03/11/2020
2017,Penn Yan,573001,2476,775376,1062,706212,1481588,03/11/2020
2017,Dundee,573401,971,311355,467,299547,610902,03/11/2020
2017,New York City School,650000,445003,127344772,105917,61399504,188744276,03/11/2020
2016,Albany,010100,8946,5580987,2904,3664827,9245814,03/11/2020
2016,Cohoes,010300,1974,1125084,694,831978,1957062,03/11/2020
2016,Watervliet,011800,1128,485604,431,386065,871669,03/11/2020
2016,Berne-Knox-Westerlo,012001,1549,856998,452,518038,1375036,03/11/2020
2016,Bethlehem,012206,6368,3927917,1108,1477210,5405127,03/11/2020
2016,Ravena-Coeymans-Selkirk,012402,2662,1564100,785,966178,2530278,03/11/2020
2016,South Colonie,012601,8477,4538225,2680,3038214,7576439,03/11/2020
2016,North Colonie,012605,7543,3693283,1671,1751362,5444645,03/11/2020
2016,Menands,012615,361,187646,87,97837,285483,03/11/2020
2016,Green Island,012801,227,126987,119,144902,271889,03/11/2020
2016,Guilderland,013002,7031,3786062,1595,1852071,5638133,03/11/2020
2016,Voorheesville,013403,1879,1049584,409,494216,1543800,03/11/2020
2016,Alfred-Almond,022001,780,543072,301,413286,956358,03/11/2020
2016,Andover,023001,404,292618,177,238697,531315,03/11/2020
2016,Genesee Valley,023202,701,312510,358,304965,617475,03/11/2020
2016,Belfast,023401,430,210727,215,196948,407675,03/11/2020
2016,Canaseraga,024002,329,184167,171,175174,359341,03/11/2020
2016,Cuba-Rushford,024801,1235,513102,590,461964,975066,03/11/2020
2016,Friendship,025001,356,231319,165,177416,408735,03/11/2020
2016,Fillmore,025801,721,272693,294,216512,489205,03/11/2020
2016,Whitesville,026001,219,113593,95,88341,201934,03/11/2020
2016,Scio,026601,432,282166,201,235790,517956,03/11/2020
2016,Wellsville,027001,1490,980879,755,906194,1887073,03/11/2020
2016,Bolivar-Richburg,027602,848,412952,384,318954,731906,03/11/2020
2016,Binghamton,030200,5078,3260393,2196,2763999,6024392,03/11/2020
2016,Chenango Forks,032001,1943,1291289,685,941381,2232670,03/11/2020
2016,South Mountain-Hickory,032201,124,17935,16,5037,22972,03/11/2020
2016,Harpursville,032601,1039,445726,381,317224,762950,03/11/2020
2016,Susquehanna Valley,032801,2237,1795404,881,1486854,3282258,03/11/2020
2016,Chenango Valley,033001,2439,1917040,1040,1739623,3656663,03/11/2020
2016,Maine-Endwell,033801,3284,2531850,1166,1867468,4399318,03/11/2020
2016,Deposit,034201,555,206373,320,250349,456722,03/11/2020
2016,Whitney Point,034401,1647,909728,557,637938,1547666,03/11/2020
2016,Union-Endicott,034601,5083,3545773,2206,3283923,6829696,03/11/2020
2016,Johnson City,034602,2817,1876683,1323,1814695,3691378,03/11/2020
2016,Vestal,034801,5095,3307872,1749,2410904,5718776,03/11/2020
2016,Windsor,035001,1958,1152960,726,880401,2033361,03/11/2020
2016,Olean,041200,2439,1656515,1020,1218716,2875231,03/11/2020
2016,Salamanca,041600,810,128484,477,135379,263863,03/11/2020
2016,Allegany-Limestone,042001,1429,795612,635,603862,1399474,03/11/2020
2016,West Valley,042204,455,289933,197,255613,545546,03/11/2020
2016,Ellicottville,043601,602,144832,274,146662,291494,03/11/2020
2016,Franklinville,044001,899,491981,369,381649,873630,03/11/2020
2016,Hinsdale,044601,567,160610,250,137677,298287,03/11/2020
2016,Cattaraugus - Little Valley,046402,1351,595681,516,425549,1021230,03/11/2020
2016,Gowanda,047201,1348,625662,581,506933,1132595,03/11/2020
2016,Portville,047401,970,639200,442,549389,1188589,03/11/2020
2016,Randolph,047601,1103,334625,461,269564,604189,03/11/2020
2016,Yorkshire-Pioneer,048401,3162,1235066,1115,885279,2120345,03/11/2020
2016,Auburn,050100,4915,2607910,1854,2068261,4676171,03/11/2020
2016,Weedsport,052201,1081,670433,388,506393,1176826,03/11/2020
2016,Cato-Meridian,052401,1267,658804,423,477344,1136148,03/11/2020
2016,Southern Cayuga,053001,1158,501726,365,320493,822219,03/11/2020
2016,Port Byron,053801,1191,735364,494,603092,1338456,03/11/2020
2016,Moravia,054201,1255,529880,451,389385,919265,03/11/2020
2016,Union Springs,055401,1143,514490,430,401886,916376,03/11/2020
2016,Dunkirk,060300,1985,1063977,1141,1112377,2176354,03/11/2020
2016,Jamestown,060800,4086,2338911,1835,1807122,4146033,03/11/2020
2016,Southwestern,062201,1944,1163660,878,1058133,2221793,03/11/2020
2016,Frewsburg,062401,983,719385,408,603805,1323190,03/11/2020
2016,Cassadaga Valley,062601,1277,609554,592,541427,1150981,03/11/2020
2016,Chautauqua Lake,062803,1044,268061,500,257815,525876,03/11/2020
2016,Pine Valley,063001,762,399320,330,331104,730424,03/11/2020
2016,Clymer,063201,539,215799,254,216774,432573,03/11/2020
2016,Bemus Point,063601,1013,434771,448,386743,821514,03/11/2020
2016,Falconer,063801,1344,784088,679,765096,1549184,03/11/2020
2016,Silver Creek,064601,1128,580656,539,556921,1137577,03/11/2020
2016,Forestville,064603,816,427705,369,393808,821513,03/11/2020
2016,Panama,064801,751,416740,280,315610,732350,03/11/2020
2016,Fredonia,065801,1967,1391988,809,1211146,2603134,03/11/2020
2016,Brocton,066001,683,531586,341,527611,1059197,03/11/2020
2016,Ripley,066201,395,268168,199,258662,526830,03/11/2020
2016,Sherman,066601,510,253074,197,194272,447346,03/11/2020
2016,Westfield,067201,886,521562,464,539415,1060977,03/11/2020
2016,Elmira,070400,6955,4138367,2809,3314030,7452397,03/11/2020
2016,Horseheads,073401,5307,2861250,1995,2316955,5178205,03/11/2020
2016,Elmira Heights,073402,1161,750940,491,653692,1404632,03/11/2020
2016,Norwich,081100,2025,1095993,795,834664,1930657,03/11/2020
2016,Afton,082001,702,385293,369,412212,797505,03/11/2020
2016,Bainbridge-Guilford,082201,1053,580619,449,503365,1083984,03/11/2020
2016,Greene,083001,1273,639527,573,598608,1238135,03/11/2020
2016,Unadilla Valley,083803,909,369021,435,356140,725161,03/11/2020
2016,Georgetown-So Otselic Valley,084401,477,243040,183,181092,424132,03/11/2020
2016,Oxford Academy,084601,922,499781,409,427195,926976,03/11/2020
2016,Sherburne-Earlville,085601,1497,708018,650,614098,1322116,03/11/2020
2016,Plattsburgh,091300,1849,1221103,808,1095368,2316471,03/11/2020
2016,Ausable Valley,092201,1718,848142,752,703563,1551705,03/11/2020
2016,Beekmantown,092401,2518,1271602,928,906027,2177629,03/11/2020
2016,Northeastern Clinton,092801,1794,1061358,684,820109,1881467,03/11/2020
2016,Chazy,093001,632,368159,228,275768,643927,03/11/2020
2016,Northern Adirondack,093601,1203,400313,461,288145,688458,03/11/2020
2016,Peru,094001,2451,1429680,721,841300,2270980,03/11/2020
2016,Saranac,094401,2220,1315999,730,875041,2191040,03/11/2020
2016,Hudson,100600,1844,903921,802,817098,1721019,03/11/2020
2016,Taconic Hills,102801,1846,643775,742,537389,1181164,03/11/2020
2016,Germantown,103602,804,346007,373,335374,681381,03/11/2020
2016,Chatham,103801,1662,781951,552,541074,1323025,03/11/2020
2016,Kinderhook,104401,2694,1400602,848,914322,2314924,03/11/2020
2016,New Lebanon,104801,785,321906,273,236039,557945,03/11/2020
2016,Cortland,110200,2729,1430156,1090,1222642,2652798,03/11/2020
2016,Cincinnatus,112001,631,316551,306,304429,620980,03/11/2020
2016,Mc Graw,112204,680,365479,246,265995,631474,03/11/2020
2016,Homer,113001,2421,1404544,876,1075327,2479871,03/11/2020
2016,Marathon,113401,835,364716,333,278993,643709,03/11/2020
2016,Andes,122002,200,43096,172,77558,120654,03/11/2020
2016,Downsville,122401,361,99825,226,132132,231957,03/11/2020
2016,Charlotte Valley,122601,490,180323,278,205609,385932,03/11/2020
2016,Delhi,122801,1156,460274,558,481165,941439,03/11/2020
2016,Franklin,123201,394,153248,195,162416,315664,03/11/2020
2016,Hancock,123606,397,151160,239,187984,339144,03/11/2020
2016,Margaretville,124601,544,134181,382,200903,335084,03/11/2020
2016,Roxbury,124802,423,160691,270,217014,377705,03/11/2020
2016,Sidney,125001,1158,552124,652,640970,1193094,03/11/2020
2016,Stamford,125201,464,222414,254,254952,477366,03/11/2020
2016,South Kortright,125202,476,205701,275,244469,450170,03/11/2020
2016,Walton,125601,1075,378188,607,445420,823608,03/11/2020
2016,Beacon,130200,3286,2206121,591,1281983,3488104,03/11/2020
2016,Poughkeepsie,131300,2521,1516086,869,1117264,2633350,03/11/2020
2016,Dover,132602,1415,1351905,359,737594,2089499,03/11/2020
2016,Hyde Park,133201,4841,4356533,1679,3044923,7401456,03/11/2020
2016,Northeast,133801,812,400980,323,342499,743479,03/11/2020
2016,Pawling,134001,1666,1488307,394,756644,2244951,03/11/2020
2016,Pine Plains,134201,1614,781142,581,600877,1382019,03/11/2020
2016,Arlington,134601,10427,9792674,2116,4191360,13984034,03/11/2020
2016,Spackenkill,134602,1653,1569122,396,758241,2327363,03/11/2020
2016,Red Hook,134801,2127,1694261,685,1186678,2880939,03/11/2020
2016,Rhinebeck,135001,1608,993325,596,789903,1783228,03/11/2020
2016,Wappingers,135601,14622,9606271,3601,4983476,14589747,03/11/2020
2016,Millbrook,135801,1332,750958,338,411710,1162668,03/11/2020
2016,Buffalo,140200,25377,8012722,7097,3708466,11721188,03/11/2020
2016,Lackawanna,140900,2384,800471,1143,695812,1496283,03/11/2020
2016,Tonawanda,141600,3003,1568924,1189,1304613,2873537,03/11/2020
2016,Alden,142001,2542,1360633,922,1043662,2404295,03/11/2020
2016,Amherst,142201,5090,3267177,1315,1794688,5061865,03/11/2020
2016,Williamsville,142203,15259,8428316,3930,4525359,12953675,03/11/2020
2016,Sweet Home,142207,4837,2100619,2067,1927236,4027855,03/11/2020
2016,East Aurora,142401,2834,1272479,892,859466,2131945,03/11/2020
2016,Cheektowaga,143001,3674,1816004,1544,1488171,3304175,03/11/2020
2016,Cheektowaga-Maryvale,143002,3543,1918099,1688,1907409,3825508,03/11/2020
2016,Cleveland Hill,143003,2425,1978977,742,1265701,3244678,03/11/2020
2016,Depew,143007,2978,1874629,1343,1815605,3690234,03/11/2020
2016,Cheektowaga-Sloan,143009,2295,2125493,1092,2133718,4259211,03/11/2020
2016,Clarence,143201,6085,2604665,1589,1350095,3954760,03/11/2020
2016,Springville-Griffith,143801,2729,1390270,976,1022337,2412607,03/11/2020
2016,Eden,144001,2302,1298756,766,934071,2232827,03/11/2020
2016,Iroquois,144201,4029,1974863,1404,1474855,3449718,03/11/2020
2016,Evans-Brant,144401,3527,1774862,1241,1236648,3011510,03/11/2020
2016,Grand Island,144601,4641,3413223,1271,788915,4202138,03/11/2020
2016,Hamburg,144801,5305,3035658,1639,2024560,5060218,03/11/2020
2016,Frontier,144804,7583,3394490,2460,2286834,5681324,03/11/2020
2016,Holland,145001,1529,627768,481,422031,1049799,03/11/2020
2016,Lancaster,145201,9459,4507000,2987,2927430,7434430,03/11/2020
2016,Akron,145601,1895,900686,745,686946,1587632,03/11/2020
2016,North Collins,145801,893,543310,317,397201,940511,03/11/2020
2016,Orchard Park,146001,7190,3910489,1944,2277125,6187614,03/11/2020
2016,Kenmore,146401,13693,8335202,5514,7268216,15603418,03/11/2020
2016,West Seneca,146801,10905,5722848,4687,5119514,10842362,03/11/2020
2016,Crown Point,152203,347,104128,175,104031,208159,03/11/2020
2016,Elizabethtown-Lewis,152401,440,172843,194,155865,328708,03/11/2020
2016,Keene,153001,227,58497,70,39228,97725,03/11/2020
2016,Minerva,153401,177,55242,106,68211,123453,03/11/2020
2016,Moriah,153601,834,456531,436,437420,893951,03/11/2020
2016,Newcomb,153801,98,7214,63,9378,16592,03/11/2020
2016,Lake Placid,154002,820,173219,361,161053,334272,03/11/2020
2016,Schroon Lake,154601,380,89300,217,104014,193314,03/11/2020
2016,Ticonderoga,154801,891,249866,509,283756,533622,03/11/2020
2016,Westport,155001,253,106386,137,116548,222934,03/11/2020
2016,Willsboro,155201,454,153291,262,170403,323694,03/11/2020
2016,Tupper Lake,162001,1063,391951,433,305125,697076,03/11/2020
2016,Chateaugay,163401,633,268691,274,232556,501247,03/11/2020
2016,Salmon River,164201,684,222645,331,205856,428501,03/11/2020
2016,Saranac Lake,164601,1889,524345,621,359317,883662,03/11/2020
2016,Malone,164801,2765,1294336,1127,1024309,2318645,03/11/2020
2016,Brushton-Moira,165001,894,441503,383,379956,821459,03/11/2020
2016,St. Regis Falls,165401,392,200359,212,205326,405685,03/11/2020
2016,Gloversville,170500,2588,1652969,1272,1473469,3126438,03/11/2020
2016,Johnstown,170800,1936,857858,767,697812,1555670,03/11/2020
2016,Broadalbin-Perth,172201,2111,1103405,866,924899,2028304,03/11/2020
2016,Wheelerville,172401,294,70303,169,85228,155531,03/11/2020
2016,Mayfield,173001,1181,575341,590,580333,1155674,03/11/2020
2016,Northville,173201,541,172002,273,184976,356978,03/11/2020
2016,Batavia,180200,2838,1900393,1042,1397779,3298172,03/11/2020
2016,Alexander,182202,1101,726792,373,516066,1242858,03/11/2020
2016,Byron-Bergen,183001,1398,1056209,535,745919,1802128,03/11/2020
2016,Elba,183401,536,336166,206,267047,603213,03/11/2020
2016,Le Roy,183601,1544,1126929,565,840982,1967911,03/11/2020
2016,Oakfield-Alabama,183801,990,665862,369,514460,1180322,03/11/2020
2016,Pavilion,184001,995,634219,336,433529,1067748,03/11/2020
2016,Pembroke,184202,1409,828836,503,610164,1439000,03/11/2020
2016,Cairo-Durham,192401,1496,584751,772,620902,1205653,03/11/2020
2016,Catskill,192601,1849,886097,729,730632,1616729,03/11/2020
2016,Coxsackie-Athens,192801,1741,813447,655,640086,1453533,03/11/2020
2016,Greenville,193201,1695,906774,723,811741,1718515,03/11/2020
2016,Hunter-Tannersville,193601,506,154980,326,204122,359102,03/11/2020
2016,Windham-Ashland-Jewett,194601,418,95067,267,128593,223660,03/11/2020
2016,Piseco,202001,76,4889,38,5319,10208,03/11/2020
2016,Indian Lake,202601,271,54654,170,71387,126041,03/11/2020
2016,Inlet,202801,68,8318,48,12689,21007,03/11/2020
2016,Lake Pleasant,203001,160,36268,110,53560,89828,03/11/2020
2016,Long Lake,203201,128,15056,95,22227,37283,03/11/2020
2016,Raquette Lake,203202,16,181,16,395,576,03/11/2020
2016,Wells,203601,187,53771,123,75644,129415,03/11/2020
2016,Little Falls,210900,1168,937264,494,731934,1669198,03/11/2020
2016,West Canada Valley,212402,960,489804,350,373170,862974,03/11/2020
2016,Frankfort-Schuyler,212602,1266,792742,575,746877,1539619,03/11/2020
2016,Central Valley,212803,2330,1239763,1028,1094352,2334115,03/11/2020
2016,Herkimer,213001,1253,782173,733,900879,1683052,03/11/2020
2016,Dolgeville,213602,924,369201,444,353378,722579,03/11/2020
2016,Poland,213803,873,334096,350,275906,610002,03/11/2020
2016,Van Hornesville-Owen D. Young,215001,284,142704,117,120529,263233,03/11/2020
2016,Town Of Webb,215401,407,34809,286,52823,87632,03/11/2020
2016,Mount Markham,215601,1362,739378,503,548943,1288321,03/11/2020
2016,Watertown,221800,3270,893247,1179,674959,1568206,03/11/2020
2016,South Jefferson,222001,2060,691191,636,430024,1121215,03/11/2020
2016,Alexandria,222202,764,233449,307,195290,428739,03/11/2020
2016,Indian River,222401,1641,206890,506,130318,337208,03/11/2020
2016,General Brown,222601,1775,482692,573,327112,809804,03/11/2020
2016,Thousand Islands,223201,1413,436318,601,389826,826144,03/11/2020
2016,Belleville-Henderson,223402,652,157393,310,155607,313000,03/11/2020
2016,Sackets Harbor,223801,554,198586,189,143251,341837,03/11/2020
2016,Lyme,224401,526,152188,254,154893,307081,03/11/2020
2016,La Fargeville,224601,551,141946,184,99385,241331,03/11/2020
2016,Carthage,226001,2244,553050,748,381500,934550,03/11/2020
2016,Copenhagen,232201,559,151239,172,95535,246774,03/11/2020
2016,Harrisville,232401,447,214035,242,217192,431227,03/11/2020
2016,Lowville,233601,1444,311783,534,238179,549962,03/11/2020
2016,South Lewis,234001,1380,528500,601,455286,983786,03/11/2020
2016,Beaver River,234401,1163,366812,409,268925,635737,03/11/2020
2016,Avon,242001,1200,913399,376,572419,1485818,03/11/2020
2016,Caledonia-Mumford,242201,1198,704165,430,516790,1220955,03/11/2020
2016,Geneseo,242601,1286,635952,384,402937,1038889,03/11/2020
2016,Livonia,243401,2307,1438406,715,922607,2361013,03/11/2020
2016,Mount Morris,243601,544,429693,238,369271,798964,03/11/2020
2016,Dansville,243801,1923,973862,759,758292,1732154,03/11/2020
2016,Dalton-Nunda,244001,976,584957,421,482873,1067830,03/11/2020
2016,York,245201,1048,657366,364,453845,1111211,03/11/2020
2016,Oneida,251200,2480,1528271,1058,1380404,2908675,03/11/2020
2016,Brookfield,252009,271,120941,98,85788,206729,03/11/2020
2016,Cazenovia,252201,2053,1013189,595,622734,1635923,03/11/2020
2016,De Ruyter,252401,485,258117,184,200228,458345,03/11/2020
2016,Morrisville-Eaton,252601,918,417534,290,266795,684329,03/11/2020
2016,Hamilton,253201,810,414119,271,291403,705522,03/11/2020
2016,Canastota,253601,1748,1183353,756,1055179,2238532,03/11/2020
2016,Madison,254001,540,302875,230,265110,567985,03/11/2020
2016,Stockbridge Valley,254601,573,327962,186,216612,544574,03/11/2020
2016,Chittenango,254801,2873,1939555,1005,1352442,3291997,03/11/2020
2016,Rochester,261400,20428,7933993,4783,3279112,11213105,03/11/2020
2016,Brighton,262001,4599,3490586,991,1587338,5077924,03/11/2020
2016,Gates-Chili,262601,6972,5363735,2956,4640037,10003772,03/11/2020
2016,Greece,262801,16226,11477929,5744,8627334,20105263,03/11/2020
2016,East Irondequoit,263401,5861,5119625,2191,4034898,9154523,03/11/2020
2016,West Irondequoit,263403,5570,4584589,1899,3378369,7962958,03/11/2020
2016,Honeoye Falls-Lima,263601,2958,2085463,631,942915,3028378,03/11/2020
2016,Spencerport,263801,4877,3510031,1571,2411482,5921513,03/11/2020
2016,Hilton,264001,5916,4101115,1940,2846163,6947278,03/11/2020
2016,Penfield,264201,7050,5362184,1925,3104516,8466700,03/11/2020
2016,Fairport,264401,8768,5824739,2669,3744659,9569398,03/11/2020
2016,East Rochester,264413,1530,1171564,669,999228,2170792,03/11/2020
2016,Pittsford,264601,7267,5510693,1304,2118634,7629327,03/11/2020
2016,Churchville-Chili,264801,5383,3773559,1679,2461674,6235233,03/11/2020
2016,Rush-Henrietta,265001,8272,4850842,2620,3244561,8095403,03/11/2020
2016,Brockport,265201,4496,3381289,1238,1884022,5265311,03/11/2020
2016,Webster,265401,12074,7709777,3829,5239428,12949205,03/11/2020
2016,Wheatland-Chili,265601,1191,856973,405,546168,1403141,03/11/2020
2016,Amsterdam,270100,3581,2017100,1803,2059727,4076827,03/11/2020
2016,Canajoharie,272201,1165,654086,473,543664,1197750,03/11/2020
2016,Fonda-Fultonville,272801,1788,864994,615,607768,1472762,03/11/2020
2016,Fort Plain,273001,849,622867,420,606951,1229818,03/11/2020
2016,Oppenheim-Ephratah-St.Johnsvil,273803,1068,501570,505,464439,966009,03/11/2020
2016,Glen Cove,280500,3270,3097381,1098,2154701,5252082,03/11/2020
2016,Long Beach,281000,6417,5060656,1126,1881413,6942069,03/11/2020
2016,Hempstead,282001,2509,3553067,457,1357027,4910094,03/11/2020
2016,Uniondale,282002,4597,4434711,875,1800041,6234752,03/11/2020
2016,East Meadow,282003,10478,12573789,2801,6142250,18716039,03/11/2020
2016,North Bellmore,282004,5615,7619228,1109,3190407,10809635,03/11/2020
2016,Levittown,282005,10359,16803704,2278,7883286,24686990,03/11/2020
2016,Seaford,282006,3676,5054647,770,2136354,7191001,03/11/2020
2016,Bellmore,282007,2830,3766930,452,1293588,5060518,03/11/2020
2016,Roosevelt,282008,1897,2268608,339,855330,3123938,03/11/2020
2016,Freeport,282009,5285,7063789,1071,2870538,9934327,03/11/2020
2016,Baldwin,282010,6625,9876626,1007,3076526,12953152,03/11/2020
2016,Oceanside,282011,8219,9988782,1540,3809386,13798168,03/11/2020
2016,Malverne,282012,2876,4172530,548,1708789,5881319,03/11/2020
2016,Valley Stream 13,282013,5774,7374593,1373,3589136,10963729,03/11/2020
2016,Hewlett-Woodmere,282014,4075,6913358,596,2120295,9033653,03/11/2020
2016,Lawrence,282015,5268,3986022,774,1224389,5210411,03/11/2020
2016,Elmont,282016,7533,9103201,1375,3545703,12648904,03/11/2020
2016,Franklin Square,282017,4798,4977243,1233,2751051,7728294,03/11/2020
2016,Garden City,282018,4729,4125291,560,1030891,5156182,03/11/2020
2016,East Rockaway,282019,1940,2688166,467,1339560,4027726,03/11/2020
2016,Lynbrook,282020,3623,5150169,670,1957954,7108123,03/11/2020
2016,Rockville Centre,282021,4498,5798705,608,1589291,7387996,03/11/2020
2016,Floral Park-Bellerose,282022,4072,4151495,781,1660846,5812341,03/11/2020
2016,Wantagh,282023,4181,5634803,638,1847898,7482701,03/11/2020
2016,Valley Stream 24,282024,2394,2791153,439,1102249,3893402,03/11/2020
2016,Merrick,282025,4256,6053806,593,1814544,7868350,03/11/2020
2016,Island Trees,282026,3156,3668571,756,1879961,5548532,03/11/2020
2016,West Hempstead,282027,3351,4214028,622,1680139,5894167,03/11/2020
2016,North Merrick,282029,3195,4311304,610,1727946,6039250,03/11/2020
2016,Valley Stream 30,282030,2865,3358646,439,1105297,4463943,03/11/2020
2016,Island Park,282031,1404,1197501,284,521017,1718518,03/11/2020
2016,Westbury,282201,2774,4404945,637,2091148,6496093,03/11/2020
2016,East Williston,282202,1692,2036219,191,493065,2529284,03/11/2020
2016,Roslyn,282203,3360,4073460,341,873080,4946540,03/11/2020
2016,Port Washington,282204,4882,4572304,701,1395812,5968116,03/11/2020
2016,New Hyde Park-Garden City,282205,4564,4686107,991,2191032,6877139,03/11/2020
2016,Manhasset,282206,2809,1880241,272,391750,2271991,03/11/2020
2016,Great Neck,282207,8351,6025827,995,1498400,7524227,03/11/2020
2016,Herricks,282209,5583,6300951,932,2264304,8565255,03/11/2020
2016,Mineola,282210,4358,4473706,1030,2272298,6746004,03/11/2020
2016,Carle Place,282211,1804,2012284,389,933947,2946231,03/11/2020
2016,North Shore,282401,3254,3115541,499,1028569,4144110,03/11/2020
2016,Syosset,282402,7014,9628271,986,2385760,12014031,03/11/2020
2016,Locust Valley,282403,2745,2353011,426,821799,3174810,03/11/2020
2016,Plainview-Old Bethpage,282404,6777,9337734,1151,3415957,12753691,03/11/2020
2016,Oyster Bay-East Norwich,282406,2173,1527583,337,534783,2062366,03/11/2020
2016,Jericho,282415,2608,2985268,264,651399,3636667,03/11/2020
2016,Hicksville,282417,7161,6627805,1819,3501759,10129564,03/11/2020
2016,Plainedge,282418,4292,6999089,1023,3588478,10587567,03/11/2020
2016,Bethpage,282421,3989,4469885,1199,2223869,6693754,03/11/2020
2016,Farmingdale,282422,8066,10948967,1874,5403420,16352387,03/11/2020
2016,Massapequa,282423,10856,13190481,2178,5649966,18840447,03/11/2020
2016,Lockport,290900,5516,4415366,2004,2982616,7397982,03/11/2020
2016,Niagara Falls,291100,6898,3336044,3104,2847734,6183778,03/11/2020
2016,North Tonawanda,291200,5871,3560785,2463,3171511,6732296,03/11/2020
2016,Lewiston-Porter,292401,3645,1997251,1527,1805032,3802283,03/11/2020
2016,Newfane,292801,2086,1682685,873,1368175,3050860,03/11/2020
2016,Niagara-Wheatfield,293001,4908,2573641,2032,2176672,4750313,03/11/2020
2016,Starpoint,293201,4046,2555674,1199,1632556,4188230,03/11/2020
2016,Royalton-Hartland,293601,1897,1270361,676,955577,2225938,03/11/2020
2016,Barker,293801,997,473283,417,416207,889490,03/11/2020
2016,Wilson,294201,1648,1139913,655,963797,2103710,03/11/2020
2016,Rome,301300,5538,3621421,2293,2980610,6602031,03/11/2020
2016,Utica,301600,6809,4015259,2934,3332099,7347358,03/11/2020
2016,Adirondack,302601,1725,733233,765,646898,1380131,03/11/2020
2016,Camden,303001,2528,1064155,1007,819886,1884041,03/11/2020
2016,Clinton,304001,1646,1263185,654,1062595,2325780,03/11/2020
2016,New Hartford,304801,3556,2472349,1183,1691122,4163471,03/11/2020
2016,New York Mills,304804,777,510216,396,553208,1063424,03/11/2020
2016,Sauquoit Valley,305002,1318,766314,454,552075,1318389,03/11/2020
2016,Remsen,305201,666,411507,270,341670,753177,03/11/2020
2016,Waterville,305401,1076,569194,372,396796,965990,03/11/2020
2016,Holland Patent,305801,1995,1209664,725,902091,2111755,03/11/2020
2016,Sherrill,306000,2419,1456194,1010,1265637,2721831,03/11/2020
2016,Westmoreland,306801,1361,991122,528,786318,1777440,03/11/2020
2016,Oriskany,307001,865,524582,334,422200,946782,03/11/2020
2016,Whitesboro,307002,4786,1989026,1736,3367070,5356096,03/11/2020
2016,Syracuse,311500,13519,5874557,4178,3584831,9459388,03/11/2020
2016,West Genesee,312001,7000,4716436,2671,3726685,8443121,03/11/2020
2016,North Syracuse,312403,13022,8859101,3842,5221775,14080876,03/11/2020
2016,East Syracuse-Minoa,312601,4534,3400175,1819,2671168,6071343,03/11/2020
2016,Jamesville-Dewitt,312611,3761,2566638,819,1172193,3738831,03/11/2020
2016,Jordan-Elbridge,312801,1596,1291234,602,931726,2222960,03/11/2020
2016,Fabius-Pompey,313001,1033,798966,325,506884,1305850,03/11/2020
2016,Westhill,313201,2600,2142649,832,1436392,3579041,03/11/2020
2016,Solvay,313202,1609,1284529,849,1315729,2600258,03/11/2020
2016,La Fayette,313407,978,546652,291,327316,873968,03/11/2020
2016,Baldwinsville,313601,7630,5338763,2133,3105262,8444025,03/11/2020
2016,Fayetteville-Manlius,313801,5505,4216537,1243,2014993,6231530,03/11/2020
2016,Marcellus,314001,2479,1721608,756,1113471,2835079,03/11/2020
2016,Onondaga,314201,1419,1203542,436,762639,1966181,03/11/2020
2016,Liverpool,314801,9518,7442799,3289,5227285,12670084,03/11/2020
2016,Lyncourt,314804,714,664765,383,636515,1301280,03/11/2020
2016,Skaneateles,315001,1819,764156,612,550958,1315114,03/11/2020
2016,Tully,315402,1265,730761,350,419861,1150622,03/11/2020
2016,Canandaigua,320200,4329,2448618,1363,1614740,4063358,03/11/2020
2016,Geneva,320500,2435,1546450,987,1285484,2831934,03/11/2020
2016,East Bloomfield,322601,1246,893466,393,592262,1485728,03/11/2020
2016,Gorham-Middlesex,323201,2001,866958,731,654058,1521016,03/11/2020
2016,Manchester-Shortsville,323601,1059,904094,426,738214,1642308,03/11/2020
2016,Naples,323801,1167,525771,465,439587,965358,03/11/2020
2016,Phelps-Clifton Springs,324001,2128,1590662,646,998118,2588780,03/11/2020
2016,Honeoye,324201,1289,616862,518,515401,1132263,03/11/2020
2016,Victor,324801,4758,2404015,1176,1246524,3650539,03/11/2020
2016,Middletown,330900,5270,4511603,1303,2315236,6826839,03/11/2020
2016,Newburgh,331100,8535,7871554,2563,4745609,12617163,03/11/2020
2016,Port Jervis,331300,2334,2435543,932,1908701,4344244,03/11/2020
2016,Washingtonville,332002,4975,4672289,900,1827526,6499815,03/11/2020
2016,Chester,332201,1165,989372,292,515500,1504872,03/11/2020
2016,Cornwall,332401,3206,3066951,586,1196478,4263429,03/11/2020
2016,Pine Bush,332601,5376,4165059,1210,1963149,6128208,03/11/2020
2016,Goshen,333001,2915,2412707,620,1100313,3513020,03/11/2020
2016,Highland Falls,333601,759,612195,208,350443,962638,03/11/2020
2016,Minisink Valley,333801,4347,3423367,873,1457351,4880718,03/11/2020
2016,Monroe-Woodbury,334001,7468,6985416,1263,2534462,9519878,03/11/2020
2016,Kiryas Joel Village,334002,823,402302,80,81139,483441,03/11/2020
2016,Valley,334201,4658,4006093,1226,2211602,6217695,03/11/2020
2016,Tuxedo,335003,447,219357,103,110073,329430,03/11/2020
2016,Warwick Valley,335401,4631,3772808,963,1693743,5466551,03/11/2020
2016,Greenwood Lake,335411,1334,1148253,298,553096,1701349,03/11/2020
2016,Florida,335415,1035,1001638,257,533469,1535107,03/11/2020
2016,Albion,342001,2063,1023767,883,873612,1897379,03/11/2020
2016,Kendall,343007,1051,534520,422,449467,983987,03/11/2020
2016,Holley,343204,1344,954567,538,761789,1716356,03/11/2020
2016,Medina,343401,1804,1230233,850,1122274,2352507,03/11/2020
2016,Lyndonville,343801,842,420104,366,378198,798302,03/11/2020
2016,Fulton,350400,3241,2637251,1276,1975315,4612566,03/11/2020
2016,Oswego,351200,4659,2793399,1661,1929152,4722551,03/11/2020
2016,Altmar Parish-Williamstown,352002,1429,678538,504,471541,1150079,03/11/2020
2016,Hannibal,353001,1480,1050669,524,730446,1781115,03/11/2020
2016,Central Square,353201,5070,2876812,1608,1837244,4714056,03/11/2020
2016,Mexico,353401,2524,1392275,827,927965,2320240,03/11/2020
2016,Pulaski,355001,1068,649231,389,482976,1132207,03/11/2020
2016,Sandy Creek,355201,1074,466114,479,408374,874488,03/11/2020
2016,Phoenix,355401,2389,2039113,799,1380555,3419668,03/11/2020
2016,Oneonta,361200,2267,1265049,892,1029216,2294265,03/11/2020
2016,Gilbertsville-Mt Upton,362202,566,194563,309,211053,405616,03/11/2020
2016,Cherry Valley-Springfield,362401,775,258967,397,273982,532949,03/11/2020
2016,Edmeston,362801,591,207715,219,160732,368447,03/11/2020
2016,Laurens,363401,486,232764,230,233968,466732,03/11/2020
2016,Schenevus,363601,479,234973,249,251321,486294,03/11/2020
2016,Milford,364001,512,240152,328,317997,558149,03/11/2020
2016,Morris,364201,501,240182,239,234836,475018,03/11/2020
2016,Otego-Unadilla,364801,1211,660713,542,622169,1282882,03/11/2020
2016,Cooperstown,365001,1103,348311,458,305818,654129,03/11/2020
2016,Richfield Springs,365601,710,214769,399,248100,462869,03/11/2020
2016,Worcester,366606,439,239080,260,292191,531271,03/11/2020
2016,Mahopac,372001,5573,6688051,1054,2712942,9400993,03/11/2020
2016,Carmel,372002,5999,7765816,1241,3394623,11160439,03/11/2020
2016,Haldane,372601,1038,844317,262,425575,1269892,03/11/2020
2016,Garrison,372604,443,203542,85,85002,288544,03/11/2020
2016,Putnam Valley,372803,2440,3461883,419,1250303,4712186,03/11/2020
2016,Brewster,373001,4336,4542849,960,2172098,6714947,03/11/2020
2016,Rensselaer,381400,1172,585266,375,366554,951820,03/11/2020
2016,Troy,381700,3772,2230788,1144,1400463,3631251,03/11/2020
2016,Lansingburgh,381701,2311,1178882,864,900373,2079255,03/11/2020
2016,Berlin,382001,1393,626414,473,440275,1066689,03/11/2020
2016,Brunswick,382202,1718,931109,531,587007,1518116,03/11/2020
2016,East Greenbush,382401,6342,3322757,1686,1863290,5186047,03/11/2020
2016,Hoosick Falls,382801,1456,793935,544,580991,1374926,03/11/2020
2016,North Greenbush,383201,361,64481,130,50337,114818,03/11/2020
2016,Wynantskill,383204,827,511791,277,367448,879239,03/11/2020
2016,Averill Park,384001,4337,2258542,1023,1125047,3383589,03/11/2020
2016,Hoosic Valley,384201,1427,740769,419,457951,1198720,03/11/2020
2016,Schodack,384401,1396,869874,354,470167,1340041,03/11/2020
2016,Clarkstown,392001,10408,10158337,2022,4275264,14433601,03/11/2020
2016,Nanuet,392008,2251,2464853,567,1315413,3780266,03/11/2020
2016,Haverstraw-Stony Point,392201,7286,12963930,1990,6967479,19931409,03/11/2020
2016,South Orangetown,392401,4026,4477860,904,2180555,6658415,03/11/2020
2016,Nyack,392404,3694,5052760,787,2392983,7445743,03/11/2020
2016,Pearl River,392408,3038,3590544,716,1829557,5420101,03/11/2020
2016,Ramapo,392601,4997,8464613,1180,4033584,12498197,03/11/2020
2016,East Ramapo,392602,10094,10874373,1902,4026536,14900909,03/11/2020
2016,Ogdensburg,401200,1821,1395497,714,950152,2345649,03/11/2020
2016,Brasher Falls,402001,1162,755903,495,619887,1375790,03/11/2020
2016,Canton,402201,1621,953201,531,620687,1573888,03/11/2020
2016,Clifton-Fine,402601,415,134994,241,139376,274370,03/11/2020
2016,Colton-Pierrepont,402801,576,244827,273,242902,487729,03/11/2020
2016,Edwards-Knox,403401,646,197745,275,162666,360411,03/11/2020
2016,Gouverneur,404001,1664,618276,664,462707,1080983,03/11/2020
2016,Hammond,404201,367,145065,161,128291,273356,03/11/2020
2016,Hermon-Dekalb,404401,464,240809,225,227315,468124,03/11/2020
2016,Lisbon,405002,787,426949,260,284165,711114,03/11/2020
2016,Madrid-Waddington,405601,859,435216,410,415289,850505,03/11/2020
2016,Massena,405801,2973,1585143,1356,1401700,2986843,03/11/2020
2016,Morristown,406001,551,239865,250,221215,461080,03/11/2020
2016,Norwood-Norfolk,406201,1253,907433,581,822415,1729848,03/11/2020
2016,Heuvelton,406404,786,473834,292,346989,820823,03/11/2020
2016,Parishville-Hopkinton,406601,530,207365,260,199567,406932,03/11/2020
2016,Potsdam,407402,1693,1173761,550,763947,1937708,03/11/2020
2016,Mechanicville,411000,1590,922886,530,664009,1586895,03/11/2020
2016,Saratoga Springs,411500,8612,4065646,1834,1821374,5887020,03/11/2020
2016,Burnt Hills-Ballston Lake,412001,4701,3171665,1259,1832229,5003894,03/11/2020
2016,Shenendehowa,412402,13511,9262924,2541,3713033,12975957,03/11/2020
2016,Corinth,412601,1366,604975,565,488003,1092978,03/11/2020
2016,Edinburg,413001,302,54493,167,58633,113126,03/11/2020
2016,Galway,413201,1528,766308,493,505321,1271629,03/11/2020
2016,Ballston Spa,414201,5070,3877477,1239,1862383,5739860,03/11/2020
2016,South Glens Falls,414401,3734,2351165,1182,1544513,3895678,03/11/2020
2016,Schuylerville,415001,2130,1621007,545,832913,2453920,03/11/2020
2016,Stillwater,415201,1621,780257,445,441338,1221595,03/11/2020
2016,Waterford-Halfmoon,415401,931,819239,361,615184,1434423,03/11/2020
2016,Schenectady,421500,6864,4721838,2436,3142404,7864242,03/11/2020
2016,Duanesburg,422001,1207,602895,310,324044,926939,03/11/2020
2016,Scotia-Glenville,422202,3886,2241282,1143,1407315,3648597,03/11/2020
2016,Niskayuna,422401,5606,3134700,1032,1253853,4388553,03/11/2020
2016,Schalmont,422801,3020,1680015,1016,1216010,2896025,03/11/2020
2016,Rotterdam-Mohonasen,422803,4438,2122798,1788,1840299,3963097,03/11/2020
2016,Cobleskill-Richmondville,432602,2108,1177268,926,1023264,2200532,03/11/2020
2016,Gilboa-Conesville,433401,444,142060,318,201170,343230,03/11/2020
2016,Jefferson,433601,365,153319,180,151098,304417,03/11/2020
2016,Middleburgh,433801,1072,657876,522,610819,1268695,03/11/2020
2016,Schoharie,434201,1326,839164,506,651097,1490261,03/11/2020
2016,Sharon Springs,434601,371,212899,180,208347,421246,03/11/2020
2016,Odessa-Montour,442001,1095,494152,443,418067,912219,03/11/2020
2016,Watkins Glen,442401,1568,566904,691,521097,1088001,03/11/2020
2016,South Seneca,452801,1115,525858,512,487220,1013078,03/11/2020
2016,Romulus,453003,612,328538,237,267092,595630,03/11/2020
2016,Seneca Falls,453201,1751,1211397,705,995855,2207252,03/11/2020
2016,Waterloo,453801,2000,1286228,803,1082667,2368895,03/11/2020
2016,Corning,460300,6313,4581187,2209,3210115,7791302,03/11/2020
2016,Hornell,460600,1588,860166,672,681297,1541463,03/11/2020
2016,Addison,462001,1323,726628,521,541891,1268519,03/11/2020
2016,Avoca,462201,684,255809,304,219998,475807,03/11/2020
2016,Bath,462402,1655,860871,649,691291,1552162,03/11/2020
2016,Bradford,462601,388,193209,166,172026,365235,03/11/2020
2016,Campbell-Savona,463002,1060,599403,422,482063,1081466,03/11/2020
2016,Canisteo-Greenwood,463202,1069,524249,578,544323,1068572,03/11/2020
2016,Arkport,465201,580,370676,293,344948,715624,03/11/2020
2016,Jasper-Troupsburg,465601,561,225839,225,187422,413261,03/11/2020
2016,Prattsburgh,466001,594,252679,230,192281,444960,03/11/2020
2016,Hammondsport,467201,875,258634,432,264704,523338,03/11/2020
2016,Wayland-Cohocton,467401,1802,856696,717,668908,1525604,03/11/2020
2016,Babylon,472001,2369,3150761,394,1095194,4245955,03/11/2020
2016,West Babylon,472002,4822,6006991,1063,2782959,8789950,03/11/2020
2016,North Babylon,472003,5723,6854032,1460,3710868,10564900,03/11/2020
2016,Lindenhurst,472004,7360,9713287,1774,4952900,14666187,03/11/2020
2016,Copiague,472005,4206,5064168,1177,2870050,7934218,03/11/2020
2016,Amityville,472006,3697,4440777,1089,2208307,6649084,03/11/2020
2016,Deer Park,472007,4551,5666456,1334,3479543,9145999,03/11/2020
2016,Wyandanch,472009,912,1198056,206,563159,1761215,03/11/2020
2016,Three Village,472201,8127,9350631,1594,3895527,13246158,03/11/2020
2016,Brookhaven-Comsewogue,472203,3891,4399140,969,2350469,6749609,03/11/2020
2016,South Country,472204,4373,4567626,830,1838456,6406082,03/11/2020
2016,Sachem,472205,15454,14318032,3116,6083147,20401179,03/11/2020
2016,Port Jefferson,472206,1352,881440,252,353052,1234492,03/11/2020
2016,Mount Sinai,472207,2833,3376197,652,1659011,5035208,03/11/2020
2016,Miller Place,472208,3362,4007120,491,1247176,5254296,03/11/2020
2016,Rocky Point,472209,3611,4706961,518,1420137,6127098,03/11/2020
2016,Middle Country,472211,10710,12185850,2594,6201419,18387269,03/11/2020
2016,Longwood,472212,10685,12782083,3416,7749328,20531411,03/11/2020
2016,Patchogue-Medford,472224,8364,9723783,1839,4387926,14111709,03/11/2020
2016,William Floyd,472232,7845,9870993,1601,4081423,13952416,03/11/2020
2016,Center Moriches,472233,1581,1995848,283,754254,2750102,03/11/2020
2016,East Moriches,472234,1261,1555502,180,478313,2033815,03/11/2020
2016,Eastport- South Manor,472235,3757,4430991,886,1954994,6385985,03/11/2020
2016,East Hampton,472401,863,162160,326,127750,289910,03/11/2020
2016,Wainscott,472402,65,3412,22,2494,5906,03/11/2020
2016,Amagansett,472403,134,13866,81,18082,31948,03/11/2020
2016,Springs,472404,726,251640,316,237161,488801,03/11/2020
2016,Sag Harbor,472405,958,251007,415,237581,488588,03/11/2020
2016,Montauk,472406,408,77970,213,88326,166296,03/11/2020
2016,Elwood,472601,2753,3235002,549,1403793,4638795,03/11/2020
2016,Cold Spring Harbor,472602,1202,1161512,93,196007,1357519,03/11/2020
2016,Huntington,472603,6202,6405364,1150,2533702,8939066,03/11/2020
2016,Northport-East Northport,472604,7751,6143446,1436,2470351,8613797,03/11/2020
2016,Half Hollow Hills,472605,8762,8154079,1895,3618493,11772572,03/11/2020
2016,Harborfields,472606,3929,4342691,657,1577153,5919844,03/11/2020
2016,Commack,472610,8179,9547317,1735,4422817,13970134,03/11/2020
2016,South Huntington,472613,7215,8237125,1624,4018885,12256010,03/11/2020
2016,Bay Shore,472801,5146,6322673,1090,2803617,9126290,03/11/2020
2016,Islip,472802,3528,4610411,746,1967140,6577551,03/11/2020
2016,East Islip,472803,5038,5958808,1132,3109802,9068610,03/11/2020
2016,Sayville,472804,3822,4526380,849,2165893,6692273,03/11/2020
2016,Bayport-Blue Point,472805,2818,3804630,501,1464089,5268719,03/11/2020
2016,Hauppauge,472806,4673,3301584,1039,1579131,4880715,03/11/2020
2016,Connetquot,472807,7828,8875470,1894,4469717,13345187,03/11/2020
2016,West Islip,472809,6035,6707375,1274,3078466,9785841,03/11/2020
2016,Brentwood,472812,8186,6514656,2074,3575286,10089942,03/11/2020
2016,Central Islip,472813,4747,6600031,1159,3400988,10001019,03/11/2020
2016,Fire Island,472814,83,9426,20,4946,14372,03/11/2020
2016,Shoreham-Wading River,473001,2878,3039181,702,1522539,4561720,03/11/2020
2016,Riverhead,473002,5759,4554110,2596,3836234,8390344,03/11/2020
2016,Shelter Island,473201,451,72213,185,64441,136654,03/11/2020
2016,Smithtown,473401,12126,12836575,2510,5547158,18383733,03/11/2020
2016,Kings Park,473405,4780,4575789,957,1997298,6573087,03/11/2020
2016,Remsenburg-Speonk,473601,333,96906,86,54433,151339,03/11/2020
2016,Westhampton Beach,473602,800,262476,230,158430,420906,03/11/2020
2016,Quogue,473603,164,16416,41,8931,25347,03/11/2020
2016,Hampton Bays,473605,1872,1309495,713,1072743,2382238,03/11/2020
2016,Southhampton,473606,1182,140254,423,108697,248951,03/11/2020
2016,Bridgehampton,473609,165,14637,60,11586,26223,03/11/2020
2016,Sagaponack,473610,29,541,6,243,784,03/11/2020
2016,Tuckahoe Common,473613,388,147548,164,134083,281631,03/11/2020
2016,East Quogue,473617,929,551610,284,356737,908347,03/11/2020
2016,Oysterponds,473802,324,70638,143,67728,138366,03/11/2020
2016,Fishers Island,473804,30,6559,3,1425,7984,03/11/2020
2016,Southold,473805,1308,645757,480,517351,1163108,03/11/2020
2016,Greenport,473810,527,290907,246,304724,595631,03/11/2020
2016,Mattituck-Cutchogue,473812,1841,954074,606,681524,1635598,03/11/2020
2016,New Suffolk,473815,70,13260,33,13580,26840,03/11/2020
2016,Fallsburg,482801,939,637726,375,509594,1147320,03/11/2020
2016,Eldred,483401,903,358220,365,305558,663778,03/11/2020
2016,Liberty,483601,1121,785975,541,780003,1565978,03/11/2020
2016,Tri-Valley,484201,1088,576127,388,409110,985237,03/11/2020
2016,Roscoe,484401,299,126253,169,151057,277310,03/11/2020
2016,Livingston Manor,484402,519,216286,243,202818,419104,03/11/2020
2016,Monticello,484601,2583,1241899,1081,1056863,2298762,03/11/2020
2016,Sullivan West,484802,1763,682520,935,749055,1431575,03/11/2020
2016,Waverly,492001,1671,741576,653,586440,1328016,03/11/2020
2016,Candor,492401,919,523087,406,443010,966097,03/11/2020
2016,Newark Valley,492602,1539,870901,574,677374,1548275,03/11/2020
2016,Owego-Apalachin,493001,2582,1514461,1016,1214744,2729205,03/11/2020
2016,Spencer-Van Etten,493401,1141,521825,495,468190,990015,03/11/2020
2016,Tioga,493603,995,289372,411,251441,540813,03/11/2020
2016,Ithaca,500700,7232,3860137,1777,1860351,5720488,03/11/2020
2016,Dryden,502401,2187,1488834,704,900310,2389144,03/11/2020
2016,Groton,502801,1173,717620,399,493874,1211494,03/11/2020
2016,Lansing,503201,1588,957516,375,475476,1432992,03/11/2020
2016,Newfield,503401,932,510623,360,350610,861233,03/11/2020
2016,Trumansburg,503601,1534,841352,492,551112,1392464,03/11/2020
2016,Kingston,510800,7600,5073272,2922,4049556,9122828,03/11/2020
2016,Highland,513203,2098,1452830,594,860352,2313182,03/11/2020
2016,Rondout Valley,513401,3146,1769571,1100,1302200,3071771,03/11/2020
2016,Marlboro,513601,2148,1734202,583,954180,2688382,03/11/2020
2016,New Paltz,513801,2850,1850854,745,1034594,2885448,03/11/2020
2016,Onteora,514001,2721,977737,1400,1065407,2043144,03/11/2020
2016,Saugerties,514801,3764,2328214,1441,1892867,4221081,03/11/2020
2016,Wallkill,515201,3652,3111559,1004,1536794,4648353,03/11/2020
2016,Ellenville,515602,1399,996771,579,774416,1771187,03/11/2020
2016,Glens Falls,520500,2371,1214220,923,1012693,2226913,03/11/2020
2016,Bolton,522001,319,47546,177,57276,104822,03/11/2020
2016,Lake George,522201,1252,234275,531,215631,449906,03/11/2020
2016,North Warren,522402,873,169457,503,206245,375702,03/11/2020
2016,Johnsburg,523001,446,140752,246,166500,307252,03/11/2020
2016,Hadley-Luzerne,523201,1189,390867,581,385815,776682,03/11/2020
2016,Queensbury,523402,4015,1803215,1318,1224711,3027926,03/11/2020
2016,Glens Falls Common,523418,211,80113,83,65277,145390,03/11/2020
2016,Warrensburg,524001,1013,435622,521,466518,902140,03/11/2020
2016,Argyle,532001,804,377511,323,312422,689933,03/11/2020
2016,Fort Ann,532802,737,288301,246,206516,494817,03/11/2020
2016,Fort Edward,533001,469,232761,197,210780,443541,03/11/2020
2016,Granville,533201,1279,598766,588,555362,1154128,03/11/2020
2016,Greenwich,533401,1332,645710,502,519635,1165345,03/11/2020
2016,Hartford,533801,601,306431,265,282691,589122,03/11/2020
2016,Hudson Falls,534401,2378,954283,970,825240,1779523,03/11/2020
2016,Putnam,534601,149,23856,62,20609,44465,03/11/2020
2016,Salem,534801,769,318846,347,296228,615074,03/11/2020
2016,Cambridge,535010,1199,509904,556,480467,990371,03/11/2020
2016,Whitehall,535201,769,235471,383,224817,460288,03/11/2020
2016,Newark,542001,2451,1543203,974,1275461,2818664,03/11/2020
2016,Clyde-Savannah,542401,998,623232,428,529608,1152840,03/11/2020
2016,Lyons,542801,1092,688647,414,483307,1171954,03/11/2020
2016,Gananda,543002,1331,1213787,194,378968,1592755,03/11/2020
2016,Marion,543201,1214,874134,388,583856,1457990,03/11/2020
2016,Wayne,543401,3315,2033566,1019,1333763,3367329,03/11/2020
2016,Palmyra-Macedon,543601,2325,1781212,878,1388589,3169801,03/11/2020
2016,Sodus,544201,1315,810448,595,723629,1534077,03/11/2020
2016,Williamson,544602,1387,1025818,482,779135,1804953,03/11/2020
2016,North Rose-Wolcott,544801,1563,703538,725,665975,1369513,03/11/2020
2016,Red Creek,544803,1052,442613,423,364586,807199,03/11/2020
2016,Mount Vernon,550800,4443,13205442,1184,5812778,19018220,03/11/2020
2016,New Rochelle,551000,7522,15461552,1403,5589663,21051215,03/11/2020
2016,Peekskill,551200,2802,5847088,629,2204830,8051918,03/11/2020
2016,Rye,551400,1555,1794631,275,703631,2498262,03/11/2020
2016,White Plains,551700,6338,13602902,1081,4176002,17778904,03/11/2020
2016,Yonkers,551800,15278,25268580,4076,11471032,36739612,03/11/2020
2016,Katonah-Lewisboro,552001,3829,7203752,510,1061200,8264952,03/11/2020
2016,Bedford,552002,3686,4698075,725,1817809,6515884,03/11/2020
2016,Croton-Harmon,552202,1932,3577911,314,1163761,4741672,03/11/2020
2016,Hendrick Hudson,552203,3007,4913061,501,1541909,6454970,03/11/2020
2016,Eastchester,552401,2673,6324564,608,2786326,9110890,03/11/2020
2016,Tuckahoe,552402,1084,2099932,175,688822,2788754,03/11/2020
2016,Bronxville,552403,423,962963,40,254380,1217343,03/11/2020
2016,Tarrytowns,552601,2045,4517296,468,2010545,6527841,03/11/2020
2016,Irvington,552602,1388,3123252,211,980731,4103983,03/11/2020
2016,Dobbs Ferry,552603,1169,2998745,203,1059880,4058625,03/11/2020
2016,Hastings On Hudson,552604,1481,3923765,252,1334619,5258384,03/11/2020
2016,Ardsley,552605,2136,4255574,327,1410107,5665681,03/11/2020
2016,Edgemont,552606,1097,2806215,104,583915,3390130,03/11/2020
2016,Greenburgh,552607,3557,6339551,898,2852220,9191771,03/11/2020
2016,Elmsford,552609,1145,1834887,303,1039452,2874339,03/11/2020
2016,Harrison,552801,2345,2732206,600,1398495,4130701,03/11/2020
2016,Mamaroneck,553201,3286,5129792,532,1643139,6772931,03/11/2020
2016,Mount Pleasant,553401,2462,3624276,676,2137891,5762167,03/11/2020
2016,Pocantico Hills,553402,380,313548,87,147710,461258,03/11/2020
2016,Valhalla,553405,1620,2791779,363,1310126,4101905,03/11/2020
2016,Pleasantville,553409,1670,3321421,324,1178992,4500413,03/11/2020
2016,Chappaqua,553604,2672,4647868,266,982245,5630113,03/11/2020
2016,Byram Hills,553801,1827,2258005,203,538406,2796411,03/11/2020
2016,North Salem,554001,1476,2017348,278,764134,2781482,03/11/2020
2016,Ossining,554201,4923,11089992,869,3833447,14923439,03/11/2020
2016,Briarcliff Manor,554202,1244,2555319,107,465991,3021310,03/11/2020
2016,Pelham,554401,1830,3342378,305,1122193,4464571,03/11/2020
2016,Rye Neck,554801,1141,1643613,267,988733,2632346,03/11/2020
2016,Port Chester-Rye,554804,2435,3436721,862,3470288,6907009,03/11/2020
2016,Blind Brook-Rye,554805,1256,1881924,175,568722,2450646,03/11/2020
2016,Scarsdale,555001,2232,2995472,218,635000,3630472,03/11/2020
2016,Somers,555201,4303,7039117,1296,3957269,10996386,03/11/2020
2016,Lakeland,555401,7514,15643206,1890,6782650,22425856,03/11/2020
2016,Yorktown,555402,4559,9278182,698,2951881,12230063,03/11/2020
2016,Attica,562201,2093,1046489,707,750878,1797367,03/11/2020
2016,Letchworth,562601,1220,518667,426,355077,873744,03/11/2020
2016,Wyoming,563802,368,180325,128,130868,311193,03/11/2020
2016,Perry,564201,1057,549166,472,486628,1035794,03/11/2020
2016,Warsaw,564801,1216,775281,409,543252,1318533,03/11/2020
2016,Penn Yan,573001,2606,813905,1087,718569,1532474,03/11/2020
2016,Dundee,573401,1021,325236,465,298690,623926,03/11/2020
2016,New York City School,650000,457203,134925029,115894,69493520,204418549,03/11/2020
2015,Albany,010100,9536,6053689,2975,3805284,9858973,03/11/2020
2015,Cohoes,010300,2073,1210026,712,873079,2083105,03/11/2020
2015,Watervliet,011800,1188,501811,452,397692,899503,03/11/2020
2015,Berne-Knox-Westerlo,012001,1598,872776,447,498968,1371744,03/11/2020
2015,Bethlehem,012206,6733,4129544,1140,1508950,5638494,03/11/2020
2015,Ravena-Coeymans-Selkirk,012402,2787,1629922,799,982509,2612431,03/11/2020
2015,South Colonie,012601,8931,4694913,2728,3040008,7734921,03/11/2020
2015,North Colonie,012605,7949,3814517,1723,1768202,5582719,03/11/2020
2015,Menands,012615,375,192806,93,102467,295273,03/11/2020
2015,Green Island,012801,244,146281,120,153919,300200,03/11/2020
2015,Guilderland,013002,7356,3898916,1620,1850626,5749542,03/11/2020
2015,Voorheesville,013403,1957,1074407,412,489061,1563468,03/11/2020
2015,Alfred-Almond,022001,828,578192,294,401475,979667,03/11/2020
2015,Andover,023001,423,326326,180,249677,576003,03/11/2020
2015,Genesee Valley,023202,734,336659,364,310652,647311,03/11/2020
2015,Belfast,023401,458,227639,215,194045,421684,03/11/2020
2015,Canaseraga,024002,349,198078,167,170976,369054,03/11/2020
2015,Cuba-Rushford,024801,1298,556368,609,490786,1047154,03/11/2020
2015,Friendship,025001,378,247771,160,173338,421109,03/11/2020
2015,Fillmore,025801,758,299170,284,212735,511905,03/11/2020
2015,Whitesville,026001,221,120360,98,94166,214526,03/11/2020
2015,Scio,026601,455,309458,205,240547,550005,03/11/2020
2015,Wellsville,027001,1568,1035485,762,909907,1945392,03/11/2020
2015,Bolivar-Richburg,027602,898,459402,392,330756,790158,03/11/2020
2015,Binghamton,030200,5402,3403820,2274,2792924,6196744,03/11/2020
2015,Chenango Forks,032001,2021,1327291,696,942129,2269420,03/11/2020
2015,South Mountain-Hickory,032201,130,20090,15,5045,25135,03/11/2020
2015,Harpursville,032601,1093,460836,372,302995,763831,03/11/2020
2015,Susquehanna Valley,032801,2318,1836413,881,1456544,3292957,03/11/2020
2015,Chenango Valley,033001,2552,1973548,1063,1742402,3715950,03/11/2020
2015,Maine-Endwell,033801,3427,2599768,1196,1869989,4469757,03/11/2020
2015,Deposit,034201,591,222317,315,247546,469863,03/11/2020
2015,Whitney Point,034401,1700,922402,569,637859,1560261,03/11/2020
2015,Union-Endicott,034601,5344,3674962,2257,3275267,6950229,03/11/2020
2015,Johnson City,034602,2955,1950451,1334,1778507,3728958,03/11/2020
2015,Vestal,034801,5367,3439471,1784,2431635,5871106,03/11/2020
2015,Windsor,035001,2045,1180105,728,867894,2047999,03/11/2020
2015,Olean,041200,2584,1785085,1024,1248881,3033966,03/11/2020
2015,Salamanca,041600,854,145473,503,148132,293605,03/11/2020
2015,Allegany-Limestone,042001,1489,848933,633,630669,1479602,03/11/2020
2015,West Valley,042204,478,336296,192,274657,610953,03/11/2020
2015,Ellicottville,043601,638,150745,285,147361,298106,03/11/2020
2015,Franklinville,044001,920,506542,378,393321,899863,03/11/2020
2015,Hinsdale,044601,596,282530,256,229029,511559,03/11/2020
2015,Cattaraugus - Little Valley,046402,1422,652070,503,433504,1085574,03/11/2020
2015,Gowanda,047201,1414,648127,585,498543,1146670,03/11/2020
2015,Portville,047401,1003,650287,453,551514,1201801,03/11/2020
2015,Randolph,047601,1143,381593,453,288233,669826,03/11/2020
2015,Yorkshire-Pioneer,048401,3282,1283367,1132,886727,2170094,03/11/2020
2015,Auburn,050100,5175,2737772,1905,2097128,4834900,03/11/2020
2015,Weedsport,052201,1118,695808,397,516479,1212287,03/11/2020
2015,Cato-Meridian,052401,1318,721115,414,439839,1160954,03/11/2020
2015,Southern Cayuga,053001,1210,492482,383,319882,812364,03/11/2020
2015,Port Byron,053801,1256,788131,495,610799,1398930,03/11/2020
2015,Moravia,054201,1305,556287,451,367306,923593,03/11/2020
2015,Union Springs,055401,1193,548544,436,416374,964918,03/11/2020
2015,Dunkirk,060300,2137,1137846,1142,1103915,2241761,03/11/2020
2015,Jamestown,060800,4364,2536276,1838,1830306,4366582,03/11/2020
2015,Southwestern,062201,2049,1226346,879,1055972,2282318,03/11/2020
2015,Frewsburg,062401,1029,744743,407,605503,1350246,03/11/2020
2015,Cassadaga Valley,062601,1339,646345,603,551965,1198310,03/11/2020
2015,Chautauqua Lake,062803,1081,272613,514,256871,529484,03/11/2020
2015,Pine Valley,063001,795,424387,330,335674,760061,03/11/2020
2015,Clymer,063201,554,222989,259,220326,443315,03/11/2020
2015,Bemus Point,063601,1056,445113,459,386564,831677,03/11/2020
2015,Falconer,063801,1434,831595,655,731175,1562770,03/11/2020
2015,Silver Creek,064601,1190,632331,530,556047,1188378,03/11/2020
2015,Forestville,064603,844,452877,364,393971,846848,03/11/2020
2015,Panama,064801,761,437863,294,334442,772305,03/11/2020
2015,Fredonia,065801,2074,1447205,791,1164934,2612139,03/11/2020
2015,Brocton,066001,706,543153,351,537481,1080634,03/11/2020
2015,Ripley,066201,417,285099,190,245694,530793,03/11/2020
2015,Sherman,066601,528,285517,196,208118,493635,03/11/2020
2015,Westfield,067201,948,550841,459,530197,1081038,03/11/2020
2015,Elmira,070400,7334,4321482,2895,3365427,7686909,03/11/2020
2015,Horseheads,073401,5545,3044640,2056,2418459,5463099,03/11/2020
2015,Elmira Heights,073402,1231,793230,494,655692,1448922,03/11/2020
2015,Norwich,081100,2135,1142175,814,837350,1979525,03/11/2020
2015,Afton,082001,735,395371,377,415897,811268,03/11/2020
2015,Bainbridge-Guilford,082201,1097,591645,461,511361,1103006,03/11/2020
2015,Greene,083001,1313,648474,591,606417,1254891,03/11/2020
2015,Unadilla Valley,083803,955,386152,435,352633,738785,03/11/2020
2015,Georgetown-So Otselic Valley,084401,504,254200,186,181794,435994,03/11/2020
2015,Oxford Academy,084601,966,515410,428,442220,957630,03/11/2020
2015,Sherburne-Earlville,085601,1582,734514,639,593547,1328061,03/11/2020
2015,Plattsburgh,091300,1999,1293070,810,1072699,2365769,03/11/2020
2015,Ausable Valley,092201,1814,879116,751,687383,1566499,03/11/2020
2015,Beekmantown,092401,2643,1323489,938,907643,2231132,03/11/2020
2015,Northeastern Clinton,092801,1854,1081256,695,816528,1897784,03/11/2020
2015,Chazy,093001,660,377101,236,280149,657250,03/11/2020
2015,Northern Adirondack,093601,1257,410598,454,272991,683589,03/11/2020
2015,Peru,094001,2581,1493910,711,816088,2309998,03/11/2020
2015,Saranac,094401,2320,1364432,739,875065,2239497,03/11/2020
2015,Hudson,100600,1907,920895,851,847632,1768527,03/11/2020
2015,Taconic Hills,102801,1900,661933,769,557834,1219767,03/11/2020
2015,Germantown,103602,840,356481,377,334866,691347,03/11/2020
2015,Chatham,103801,1731,800130,573,553731,1353861,03/11/2020
2015,Kinderhook,104401,2822,1424663,868,926221,2350884,03/11/2020
2015,New Lebanon,104801,814,335948,279,241290,577238,03/11/2020
2015,Cortland,110200,2869,1474149,1099,1207081,2681230,03/11/2020
2015,Cincinnatus,112001,663,329631,308,302162,631793,03/11/2020
2015,Mc Graw,112204,726,389558,243,260364,649922,03/11/2020
2015,Homer,113001,2570,1475878,860,1040507,2516385,03/11/2020
2015,Marathon,113401,883,407540,330,287417,694957,03/11/2020
2015,Andes,122002,207,45075,171,78100,123175,03/11/2020
2015,Downsville,122401,365,101270,237,138134,239404,03/11/2020
2015,Charlotte Valley,122601,516,187518,278,202236,389754,03/11/2020
2015,Delhi,122801,1186,467966,561,476961,944927,03/11/2020
2015,Franklin,123201,409,156055,195,159186,315241,03/11/2020
2015,Hancock,123606,412,171670,232,196649,368319,03/11/2020
2015,Margaretville,124601,569,138178,390,202115,340293,03/11/2020
2015,Roxbury,124802,454,174302,265,215404,389706,03/11/2020
2015,Sidney,125001,1225,575193,672,651666,1226859,03/11/2020
2015,Stamford,125201,486,228321,251,247326,475647,03/11/2020
2015,South Kortright,125202,495,210264,273,237772,448036,03/11/2020
2015,Walton,125601,1121,405164,585,439028,844192,03/11/2020
2015,Beacon,130200,3488,2428523,850,1300486,3729009,03/11/2020
2015,Poughkeepsie,131300,2641,1614259,913,1181272,2795531,03/11/2020
2015,Dover,132602,1484,1402208,349,717345,2119553,03/11/2020
2015,Hyde Park,133201,5091,4616643,1659,3012436,7629079,03/11/2020
2015,Northeast,133801,867,445428,321,353541,798969,03/11/2020
2015,Pawling,134001,1727,1511656,390,736283,2247939,03/11/2020
2015,Pine Plains,134201,1668,824275,590,617276,1441551,03/11/2020
2015,Arlington,134601,10909,10607609,2113,4311373,14918982,03/11/2020
2015,Spackenkill,134602,1752,1670061,399,766386,2436447,03/11/2020
2015,Red Hook,134801,2241,1857079,675,1210501,3067580,03/11/2020
2015,Rhinebeck,135001,1668,1072445,629,865136,1937581,03/11/2020
2015,Wappingers,135601,15325,10187621,3627,5058275,15245896,03/11/2020
2015,Millbrook,135801,1376,792649,364,452477,1245126,03/11/2020
2015,Buffalo,140200,25782,8922892,7623,4127723,13050615,03/11/2020
2015,Lackawanna,140900,2488,864662,1205,703559,1568221,03/11/2020
2015,Tonawanda,141600,3194,1660750,1199,1327194,2987944,03/11/2020
2015,Alden,142001,2643,1463920,943,1111966,2575886,03/11/2020
2015,Amherst,142201,5364,3414364,1380,1864610,5278974,03/11/2020
2015,Williamsville,142203,16088,9046315,4086,4759795,13806110,03/11/2020
2015,Sweet Home,142207,5088,2195212,2125,1984796,4180008,03/11/2020
2015,East Aurora,142401,3001,1331211,885,844555,2175766,03/11/2020
2015,Cheektowaga,143001,3882,1932575,1615,1549385,3481960,03/11/2020
2015,Cheektowaga-Maryvale,143002,3737,1982543,1757,1982826,3965369,03/11/2020
2015,Cleveland Hill,143003,2544,2080014,791,1354807,3434821,03/11/2020
2015,Depew,143007,3130,1958487,1350,1834291,3792778,03/11/2020
2015,Cheektowaga-Sloan,143009,2437,2221140,1138,2175682,4396822,03/11/2020
2015,Clarence,143201,6422,2802166,1664,1431147,4233313,03/11/2020
2015,Springville-Griffith,143801,2838,1442014,983,1011187,2453201,03/11/2020
2015,Eden,144001,2391,1340586,774,935796,2276382,03/11/2020
2015,Iroquois,144201,4187,2056215,1433,1512331,3568546,03/11/2020
2015,Evans-Brant,144401,3717,1947756,1271,1300249,3248005,03/11/2020
2015,Grand Island,144601,4881,2793163,1268,1557300,4350463,03/11/2020
2015,Hamburg,144801,5577,3180937,1672,2057572,5238509,03/11/2020
2015,Frontier,144804,7989,3609754,2569,2402736,6012490,03/11/2020
2015,Holland,145001,1600,667863,471,418969,1086832,03/11/2020
2015,Lancaster,145201,9915,4656531,3041,2922025,7578556,03/11/2020
2015,Akron,145601,1974,939482,775,705054,1644536,03/11/2020
2015,North Collins,145801,929,582341,306,387331,969672,03/11/2020
2015,Orchard Park,146001,7542,4074574,1983,2312788,6387362,03/11/2020
2015,Kenmore,146401,14569,8706575,5646,7296904,16003479,03/11/2020
2015,West Seneca,146801,11385,5911072,4795,5221190,11132262,03/11/2020
2015,Crown Point,152203,354,114512,184,117685,232197,03/11/2020
2015,Elizabethtown-Lewis,152401,461,179265,206,163743,343008,03/11/2020
2015,Keene,153001,236,59784,81,44454,104238,03/11/2020
2015,Minerva,153401,179,54824,114,69912,124736,03/11/2020
2015,Moriah,153601,867,467932,449,439289,907221,03/11/2020
2015,Newcomb,153801,100,7259,65,9479,16738,03/11/2020
2015,Lake Placid,154002,860,178337,370,162506,340843,03/11/2020
2015,Schroon Lake,154601,414,95812,212,100191,196003,03/11/2020
2015,Ticonderoga,154801,947,260309,516,284513,544822,03/11/2020
2015,Westport,155001,262,108009,146,121050,229059,03/11/2020
2015,Willsboro,155201,477,158619,275,175532,334151,03/11/2020
2015,Tupper Lake,162001,1111,404878,443,308014,712892,03/11/2020
2015,Chateaugay,163401,647,275690,287,241890,517580,03/11/2020
2015,Salmon River,164201,705,239662,336,218879,458541,03/11/2020
2015,Saranac Lake,164601,1971,539095,628,354867,893962,03/11/2020
2015,Malone,164801,2894,1335230,1138,1009122,2344352,03/11/2020
2015,Brushton-Moira,165001,939,468630,381,378473,847103,03/11/2020
2015,St. Regis Falls,165401,417,211892,220,209433,421325,03/11/2020
2015,Gloversville,170500,2747,1744999,1310,1499030,3244029,03/11/2020
2015,Johnstown,170800,2000,921455,787,733281,1654736,03/11/2020
2015,Broadalbin-Perth,172201,2189,1123097,886,907459,2030556,03/11/2020
2015,Wheelerville,172401,308,72731,163,81493,154224,03/11/2020
2015,Mayfield,173001,1242,595909,576,556643,1152552,03/11/2020
2015,Northville,173201,552,171951,287,191103,363054,03/11/2020
2015,Batavia,180200,2968,2034130,1091,1491076,3525206,03/11/2020
2015,Alexander,182202,1140,754199,375,522697,1276896,03/11/2020
2015,Byron-Bergen,183001,1465,1096111,519,721474,1817585,03/11/2020
2015,Elba,183401,557,350183,209,271417,621600,03/11/2020
2015,Le Roy,183601,1622,1158885,578,842462,2001347,03/11/2020
2015,Oakfield-Alabama,183801,1040,713887,377,531497,1245384,03/11/2020
2015,Pavilion,184001,1031,668332,351,460566,1128898,03/11/2020
2015,Pembroke,184202,1452,864014,522,639101,1503115,03/11/2020
2015,Cairo-Durham,192401,1570,604194,798,628871,1233065,03/11/2020
2015,Catskill,192601,1940,923737,760,757136,1680873,03/11/2020
2015,Coxsackie-Athens,192801,1844,843357,658,632447,1475804,03/11/2020
2015,Greenville,193201,1781,937128,721,792524,1729652,03/11/2020
2015,Hunter-Tannersville,193601,521,156520,340,209406,365926,03/11/2020
2015,Windham-Ashland-Jewett,194601,434,96670,278,131287,227957,03/11/2020
2015,Piseco,202001,75,4836,41,5751,10587,03/11/2020
2015,Indian Lake,202601,284,56203,177,73457,129660,03/11/2020
2015,Inlet,202801,71,8503,50,12942,21445,03/11/2020
2015,Lake Pleasant,203001,163,35942,112,53061,89003,03/11/2020
2015,Long Lake,203201,133,15377,97,22669,38046,03/11/2020
2015,Raquette Lake,203202,17,193,16,395,588,03/11/2020
2015,Wells,203601,196,55330,120,72434,127764,03/11/2020
2015,Little Falls,210900,1213,958977,518,744121,1703098,03/11/2020
2015,West Canada Valley,212402,1003,506549,345,365044,871593,03/11/2020
2015,Frankfort-Schuyler,212602,1319,812198,581,741411,1553609,03/11/2020
2015,Central Valley,212803,2471,1356018,1034,1130334,2486352,03/11/2020
2015,Herkimer,213001,1345,824825,722,869828,1694653,03/11/2020
2015,Dolgeville,213602,974,382171,448,348068,730239,03/11/2020
2015,Poland,213803,908,343111,349,270407,613518,03/11/2020
2015,Van Hornesville-Owen D. Young,215001,289,144054,124,126368,270422,03/11/2020
2015,Town Of Webb,215401,445,37439,305,54849,92288,03/11/2020
2015,Mount Markham,215601,1407,766949,510,556210,1323159,03/11/2020
2015,Watertown,221800,3534,982099,1206,701132,1683231,03/11/2020
2015,South Jefferson,222001,2169,720247,633,426357,1146604,03/11/2020
2015,Alexandria,222202,793,237374,303,188573,425947,03/11/2020
2015,Indian River,222401,1714,217261,500,129123,346384,03/11/2020
2015,General Brown,222601,1844,493123,566,316592,809715,03/11/2020
2015,Thousand Islands,223201,1462,446781,623,400626,847407,03/11/2020
2015,Belleville-Henderson,223402,681,161458,315,156023,317481,03/11/2020
2015,Sackets Harbor,223801,590,207379,184,137268,344647,03/11/2020
2015,Lyme,224401,555,160334,254,153987,314321,03/11/2020
2015,La Fargeville,224601,570,144137,192,102467,246604,03/11/2020
2015,Carthage,226001,2360,662913,730,423964,1086877,03/11/2020
2015,Copenhagen,232201,574,154176,171,94311,248487,03/11/2020
2015,Harrisville,232401,481,235291,235,216644,451935,03/11/2020
2015,Lowville,233601,1552,342978,540,245568,588546,03/11/2020
2015,South Lewis,234001,1458,565927,578,441486,1007413,03/11/2020
2015,Beaver River,234401,1214,392819,405,272407,665226,03/11/2020
2015,Avon,242001,1262,942810,386,582111,1524921,03/11/2020
2015,Caledonia-Mumford,242201,1252,729999,434,518149,1248148,03/11/2020
2015,Geneseo,242601,1327,646376,391,404100,1050476,03/11/2020
2015,Livonia,243401,2460,1512217,710,896326,2408543,03/11/2020
2015,Mount Morris,243601,578,451028,235,355807,806835,03/11/2020
2015,Dansville,243801,1993,1001354,773,762245,1763599,03/11/2020
2015,Dalton-Nunda,244001,1031,619094,419,473844,1092938,03/11/2020
2015,York,245201,1082,681702,369,462568,1144270,03/11/2020
2015,Oneida,251200,2643,1631690,1046,1350092,2981782,03/11/2020
2015,Brookfield,252009,277,121256,101,86589,207845,03/11/2020
2015,Cazenovia,252201,2138,1047142,603,628334,1675476,03/11/2020
2015,De Ruyter,252401,506,268870,185,199385,468255,03/11/2020
2015,Morrisville-Eaton,252601,946,442583,301,277967,720550,03/11/2020
2015,Hamilton,253201,870,436669,264,279222,715891,03/11/2020
2015,Canastota,253601,1815,1215508,769,1058352,2273860,03/11/2020
2015,Madison,254001,567,330456,224,262478,592934,03/11/2020
2015,Stockbridge Valley,254601,589,334414,184,212458,546872,03/11/2020
2015,Chittenango,254801,2991,2027175,1023,1378692,3405867,03/11/2020
2015,Rochester,261400,21644,8781239,4695,3325546,12106785,03/11/2020
2015,Brighton,262001,4884,3795690,1011,1646941,5442631,03/11/2020
2015,Gates-Chili,262601,7446,5715460,2983,4657394,10372854,03/11/2020
2015,Greece,262801,17050,11924705,5845,8674449,20599154,03/11/2020
2015,East Irondequoit,263401,6252,5360431,2280,4110583,9471014,03/11/2020
2015,West Irondequoit,263403,5927,4833718,1944,3426974,8260692,03/11/2020
2015,Honeoye Falls-Lima,263601,3102,2168136,664,982832,3150968,03/11/2020
2015,Spencerport,263801,5151,3683599,1567,2387466,6071065,03/11/2020
2015,Hilton,264001,6217,4295822,1950,2847967,7143789,03/11/2020
2015,Penfield,264201,7510,5695601,1976,3167829,8863430,03/11/2020
2015,Fairport,264401,9204,6039927,2713,3756517,9796444,03/11/2020
2015,East Rochester,264413,1634,1243671,679,993236,2236907,03/11/2020
2015,Pittsford,264601,7727,5839955,1341,2172716,8012671,03/11/2020
2015,Churchville-Chili,264801,5681,3977004,1694,2481280,6458284,03/11/2020
2015,Rush-Henrietta,265001,8754,5110143,2692,3312747,8422890,03/11/2020
2015,Brockport,265201,4644,3535329,1205,1841807,5377136,03/11/2020
2015,Webster,265401,12806,8086954,3888,5255565,13342519,03/11/2020
2015,Wheatland-Chili,265601,1260,876713,410,578425,1455138,03/11/2020
2015,Amsterdam,270100,3791,2107893,1776,1988513,4096406,03/11/2020
2015,Canajoharie,272201,1197,659810,494,562120,1221930,03/11/2020
2015,Fonda-Fultonville,272801,1868,887031,626,604840,1491871,03/11/2020
2015,Fort Plain,273001,905,673215,418,610978,1284193,03/11/2020
2015,Oppenheim-Ephratah-St.Johnsvil,273803,1109,527648,505,463397,991045,03/11/2020
2015,Glen Cove,280500,3439,3132780,1208,2289828,5422608,03/11/2020
2015,Long Beach,281000,6655,5107514,1203,2031981,7139495,03/11/2020
2015,Hempstead,282001,2568,3548136,467,1376714,4924850,03/11/2020
2015,Uniondale,282002,4692,4415181,895,1828973,6244154,03/11/2020
2015,East Meadow,282003,10742,13498405,2923,6794545,20292950,03/11/2020
2015,North Bellmore,282004,5713,7919277,1167,3517877,11437154,03/11/2020
2015,Levittown,282005,10617,17644786,2341,8495924,26140710,03/11/2020
2015,Seaford,282006,3764,5083476,795,2222661,7306137,03/11/2020
2015,Bellmore,282007,2907,3929783,470,1404089,5333872,03/11/2020
2015,Roosevelt,282008,1922,2321590,346,895324,3216914,03/11/2020
2015,Freeport,282009,5437,7103485,1073,2843721,9947206,03/11/2020
2015,Baldwin,282010,6783,10247369,1067,3359553,13606922,03/11/2020
2015,Oceanside,282011,8396,10235339,1630,4136157,14371496,03/11/2020
2015,Malverne,282012,2928,4361536,578,1897500,6259036,03/11/2020
2015,Valley Stream 13,282013,5931,7553049,1397,3735735,11288784,03/11/2020
2015,Hewlett-Woodmere,282014,4210,6970377,633,2241613,9211990,03/11/2020
2015,Lawrence,282015,5405,4158473,822,1344448,5502921,03/11/2020
2015,Elmont,282016,7644,9153694,1431,3748141,12901835,03/11/2020
2015,Franklin Square,282017,4896,5227047,1272,2998950,8225997,03/11/2020
2015,Garden City,282018,4862,4219572,609,1146836,5366408,03/11/2020
2015,East Rockaway,282019,1973,2754713,504,1481837,4236550,03/11/2020
2015,Lynbrook,282020,3687,5157440,718,2123745,7281185,03/11/2020
2015,Rockville Centre,282021,4626,5825346,649,1689488,7514834,03/11/2020
2015,Floral Park-Bellerose,282022,4144,4363929,810,1818498,6182427,03/11/2020
2015,Wantagh,282023,4246,5898257,659,2020989,7919246,03/11/2020
2015,Valley Stream 24,282024,2451,2826034,474,1207565,4033599,03/11/2020
2015,Merrick,282025,4387,6290939,595,1885457,8176396,03/11/2020
2015,Island Trees,282026,3230,3907079,756,2004209,5911288,03/11/2020
2015,West Hempstead,282027,3418,4286114,647,1793055,6079169,03/11/2020
2015,North Merrick,282029,3260,4454701,626,1837632,6292333,03/11/2020
2015,Valley Stream 30,282030,2925,3338399,456,1148296,4486695,03/11/2020
2015,Island Park,282031,1436,1203478,307,567930,1771408,03/11/2020
2015,Westbury,282201,2840,4391422,660,2170484,6561906,03/11/2020
2015,East Williston,282202,1743,2080993,200,526223,2607216,03/11/2020
2015,Roslyn,282203,3483,4330485,363,977533,5308018,03/11/2020
2015,Port Washington,282204,5045,4748227,750,1545139,6293366,03/11/2020
2015,New Hyde Park-Garden City,282205,4599,4825158,1074,2494321,7319479,03/11/2020
2015,Manhasset,282206,2885,1978345,299,453289,2431634,03/11/2020
2015,Great Neck,282207,8623,6059364,1074,1620689,7680053,03/11/2020
2015,Herricks,282209,5674,6621303,976,2522534,9143837,03/11/2020
2015,Mineola,282210,4484,4674322,1080,2484373,7158695,03/11/2020
2015,Carle Place,282211,1841,2097553,410,1031402,3128955,03/11/2020
2015,North Shore,282401,3325,3131429,526,1098934,4230363,03/11/2020
2015,Syosset,282402,7202,9946654,1064,2628678,12575332,03/11/2020
2015,Locust Valley,282403,2802,2497509,448,855998,3353507,03/11/2020
2015,Plainview-Old Bethpage,282404,6952,9710561,1193,3689296,13399857,03/11/2020
2015,Oyster Bay-East Norwich,282406,2247,1698148,357,575807,2273955,03/11/2020
2015,Jericho,282415,2714,3062576,286,715132,3777708,03/11/2020
2015,Hicksville,282417,7311,6854362,1882,3765061,10619423,03/11/2020
2015,Plainedge,282418,4381,7129224,1042,3745680,10874904,03/11/2020
2015,Bethpage,282421,4026,4538691,1279,2408940,6947631,03/11/2020
2015,Farmingdale,282422,8277,11460148,1931,5822412,17282560,03/11/2020
2015,Massapequa,282423,11093,13880385,2270,6228171,20108556,03/11/2020
2015,Lockport,290900,5959,4838176,2003,3026226,7864402,03/11/2020
2015,Niagara Falls,291100,7294,3778214,3172,3027065,6805279,03/11/2020
2015,North Tonawanda,291200,6198,3723351,2547,3253301,6976652,03/11/2020
2015,Lewiston-Porter,292401,3838,2130178,1569,1875347,4005525,03/11/2020
2015,Newfane,292801,2210,1876932,867,1424378,3301310,03/11/2020
2015,Niagara-Wheatfield,293001,5151,2717671,2023,2160507,4878178,03/11/2020
2015,Starpoint,293201,4245,2823164,1184,1686774,4509938,03/11/2020
2015,Royalton-Hartland,293601,1982,1317309,690,964270,2281579,03/11/2020
2015,Barker,293801,1033,486012,418,410735,896747,03/11/2020
2015,Wilson,294201,1728,1246339,661,1009159,2255498,03/11/2020
2015,Rome,301300,5823,3724132,2362,2996146,6720278,03/11/2020
2015,Utica,301600,7004,4049689,3078,3424221,7473910,03/11/2020
2015,Adirondack,302601,1814,768231,748,626376,1394607,03/11/2020
2015,Camden,303001,2631,1129958,1000,825086,1955044,03/11/2020
2015,Clinton,304001,1763,1327260,659,1050621,2377881,03/11/2020
2015,New Hartford,304801,3739,2555805,1161,1628043,4183848,03/11/2020
2015,New York Mills,304804,812,527026,404,556667,1083693,03/11/2020
2015,Sauquoit Valley,305002,1375,784521,447,531498,1316019,03/11/2020
2015,Remsen,305201,702,436163,260,331073,767236,03/11/2020
2015,Waterville,305401,1101,577489,383,398972,976461,03/11/2020
2015,Holland Patent,305801,2076,1235732,719,872955,2108687,03/11/2020
2015,Sherrill,306000,2555,1541452,1015,1274036,2815488,03/11/2020
2015,Westmoreland,306801,1429,1079574,533,825685,1905259,03/11/2020
2015,Oriskany,307001,898,533351,339,421133,954484,03/11/2020
2015,Whitesboro,307002,5027,3100191,1741,2309850,5410041,03/11/2020
2015,Syracuse,311500,14341,6231147,4075,3485762,9716909,03/11/2020
2015,West Genesee,312001,7417,4920133,2737,3750349,8670482,03/11/2020
2015,North Syracuse,312403,13785,9219219,3895,5173364,14392583,03/11/2020
2015,East Syracuse-Minoa,312601,4759,3582977,1853,2711654,6294631,03/11/2020
2015,Jamesville-Dewitt,312611,3961,2679094,833,1175476,3854570,03/11/2020
2015,Jordan-Elbridge,312801,1672,1357913,611,940577,2298490,03/11/2020
2015,Fabius-Pompey,313001,1088,852365,327,518002,1370367,03/11/2020
2015,Westhill,313201,2728,2227451,855,1458483,3685934,03/11/2020
2015,Solvay,313202,1718,1351524,857,1297649,2649173,03/11/2020
2015,La Fayette,313407,1020,568238,301,333005,901243,03/11/2020
2015,Baldwinsville,313601,8112,5681431,2137,3087529,8768960,03/11/2020
2015,Fayetteville-Manlius,313801,5876,4491971,1272,2065449,6557420,03/11/2020
2015,Marcellus,314001,2581,1768123,768,1113658,2881781,03/11/2020
2015,Onondaga,314201,1559,1329456,408,690922,2020378,03/11/2020
2015,Liverpool,314801,10113,7759890,3376,5238618,12998508,03/11/2020
2015,Lyncourt,314804,776,714627,387,635072,1349699,03/11/2020
2015,Skaneateles,315001,1913,802348,624,559926,1362274,03/11/2020
2015,Tully,315402,1327,753552,339,397132,1150684,03/11/2020
2015,Canandaigua,320200,4609,2592071,1402,1653124,4245195,03/11/2020
2015,Geneva,320500,2592,1677453,1013,1325439,3002892,03/11/2020
2015,East Bloomfield,322601,1289,918062,406,609120,1527182,03/11/2020
2015,Gorham-Middlesex,323201,2107,907609,728,643738,1551347,03/11/2020
2015,Manchester-Shortsville,323601,1113,959087,430,750256,1709343,03/11/2020
2015,Naples,323801,1238,547880,470,436410,984290,03/11/2020
2015,Phelps-Clifton Springs,324001,2232,1655353,673,1036567,2691920,03/11/2020
2015,Honeoye,324201,1361,649810,520,516220,1166030,03/11/2020
2015,Victor,324801,5115,2575108,1189,1245125,3820233,03/11/2020
2015,Middletown,330900,5507,4627648,1368,2371920,6999568,03/11/2020
2015,Newburgh,331100,8914,8146002,2625,4782505,12928507,03/11/2020
2015,Port Jervis,331300,2443,2527030,954,1950164,4477194,03/11/2020
2015,Washingtonville,332002,5252,4958384,894,1823160,6781544,03/11/2020
2015,Chester,332201,1218,1048254,305,543836,1592090,03/11/2020
2015,Cornwall,332401,3370,3167392,608,1216003,4383395,03/11/2020
2015,Pine Bush,332601,5642,4306693,1236,1977721,6284414,03/11/2020
2015,Goshen,333001,3010,2507818,666,1186474,3694292,03/11/2020
2015,Highland Falls,333601,787,625095,216,360088,985183,03/11/2020
2015,Minisink Valley,333801,4527,3551451,880,1451497,5002948,03/11/2020
2015,Monroe-Woodbury,334001,7867,7894475,1285,2771960,10666435,03/11/2020
2015,Kiryas Joel Village,334002,844,460827,84,91362,552189,03/11/2020
2015,Valley,334201,4842,4090253,1262,2229936,6320189,03/11/2020
2015,Tuxedo,335003,470,226294,102,106991,333285,03/11/2020
2015,Warwick Valley,335401,4856,4041708,988,1769580,5811288,03/11/2020
2015,Greenwood Lake,335411,1402,1237265,301,569225,1806490,03/11/2020
2015,Florida,335415,1086,1078758,255,541853,1620611,03/11/2020
2015,Albion,342001,2177,1086966,898,903796,1990762,03/11/2020
2015,Kendall,343007,1110,561934,425,452656,1014590,03/11/2020
2015,Holley,343204,1423,1013760,531,755644,1769404,03/11/2020
2015,Medina,343401,1903,1316932,854,1144003,2460935,03/11/2020
2015,Lyndonville,343801,886,456359,373,395936,852295,03/11/2020
2015,Fulton,350400,3441,2766142,1275,1931519,4697661,03/11/2020
2015,Oswego,351200,4900,2878011,1675,1920337,4798348,03/11/2020
2015,Altmar Parish-Williamstown,352002,1528,758762,498,479667,1238429,03/11/2020
2015,Hannibal,353001,1562,1108810,512,708354,1817164,03/11/2020
2015,Central Square,353201,5323,3020947,1600,1806836,4827783,03/11/2020
2015,Mexico,353401,2650,1436565,825,905934,2342499,03/11/2020
2015,Pulaski,355001,1118,675199,390,475541,1150740,03/11/2020
2015,Sandy Creek,355201,1125,496863,494,426741,923604,03/11/2020
2015,Phoenix,355401,2505,2125534,806,1362561,3488095,03/11/2020
2015,Oneonta,361200,2355,1292828,877,1008176,2301004,03/11/2020
2015,Gilbertsville-Mt Upton,362202,586,197733,315,212374,410107,03/11/2020
2015,Cherry Valley-Springfield,362401,810,266172,397,268048,534220,03/11/2020
2015,Edmeston,362801,612,211358,223,159077,370435,03/11/2020
2015,Laurens,363401,515,242817,221,221641,464458,03/11/2020
2015,Schenevus,363601,505,243663,255,252428,496091,03/11/2020
2015,Milford,364001,542,249784,327,311534,561318,03/11/2020
2015,Morris,364201,514,241711,240,229901,471612,03/11/2020
2015,Otego-Unadilla,364801,1281,688111,552,603301,1291412,03/11/2020
2015,Cooperstown,365001,1147,355503,471,308116,663619,03/11/2020
2015,Richfield Springs,365601,738,222030,404,246365,468395,03/11/2020
2015,Worcester,366606,450,239691,268,293659,533350,03/11/2020
2015,Mahopac,372001,5795,7337743,1053,2850086,10187829,03/11/2020
2015,Carmel,372002,6258,8067902,1245,3372154,11440056,03/11/2020
2015,Haldane,372601,1073,888984,273,453521,1342505,03/11/2020
2015,Garrison,372604,459,216661,87,89404,306065,03/11/2020
2015,Putnam Valley,372803,2560,3757499,419,1292178,5049677,03/11/2020
2015,Brewster,373001,4558,4889907,961,2207065,7096972,03/11/2020
2015,Rensselaer,381400,1214,594630,395,378757,973387,03/11/2020
2015,Troy,381700,3975,2307781,1201,1441897,3749678,03/11/2020
2015,Lansingburgh,381701,2464,1235229,895,914737,2149966,03/11/2020
2015,Berlin,382001,1449,636809,466,419507,1056316,03/11/2020
2015,Brunswick,382202,1777,943408,553,600351,1543759,03/11/2020
2015,East Greenbush,382401,6717,3460077,1669,1815209,5275286,03/11/2020
2015,Hoosick Falls,382801,1531,820600,551,579027,1399627,03/11/2020
2015,North Greenbush,383201,383,69502,131,51514,121016,03/11/2020
2015,Wynantskill,383204,853,521655,294,383768,905423,03/11/2020
2015,Averill Park,384001,4540,2325396,1027,1108832,3434228,03/11/2020
2015,Hoosic Valley,384201,1481,769866,427,465930,1235796,03/11/2020
2015,Schodack,384401,1460,891236,361,474215,1365451,03/11/2020
2015,Clarkstown,392001,10872,10853294,2089,4513584,15366878,03/11/2020
2015,Nanuet,392008,2338,2513173,592,1342473,3855646,03/11/2020
2015,Haverstraw-Stony Point,392201,7498,13084391,2061,7054932,20139323,03/11/2020
2015,South Orangetown,392401,4137,4556249,973,2327325,6883574,03/11/2020
2015,Nyack,392404,3888,5323217,798,2446378,7769595,03/11/2020
2015,Pearl River,392408,3122,3653803,748,1892669,5546472,03/11/2020
2015,Ramapo,392601,5317,9252113,1242,4310603,13562716,03/11/2020
2015,East Ramapo,392602,10714,12079374,2007,4447746,16527120,03/11/2020
2015,Ogdensburg,401200,1947,1467150,717,931459,2398609,03/11/2020
2015,Brasher Falls,402001,1217,784753,498,616084,1400837,03/11/2020
2015,Canton,402201,1702,983618,522,597927,1581545,03/11/2020
2015,Clifton-Fine,402601,436,142952,244,139747,282699,03/11/2020
2015,Colton-Pierrepont,402801,591,247535,283,244469,492004,03/11/2020
2015,Edwards-Knox,403401,684,209532,262,155032,364564,03/11/2020
2015,Gouverneur,404001,1785,660397,656,450051,1110448,03/11/2020
2015,Hammond,404201,386,151311,166,132202,283513,03/11/2020
2015,Hermon-Dekalb,404401,489,254841,218,218614,473455,03/11/2020
2015,Lisbon,405002,821,441617,257,279567,721184,03/11/2020
2015,Madrid-Waddington,405601,916,467891,398,402837,870728,03/11/2020
2015,Massena,405801,3151,1668455,1340,1367017,3035472,03/11/2020
2015,Morristown,406001,580,252941,247,220321,473262,03/11/2020
2015,Norwood-Norfolk,406201,1334,972367,573,809887,1782254,03/11/2020
2015,Heuvelton,406404,822,496785,304,363630,860415,03/11/2020
2015,Parishville-Hopkinton,406601,561,214833,254,191009,405842,03/11/2020
2015,Potsdam,407402,1794,1230891,537,735845,1966736,03/11/2020
2015,Mechanicville,411000,1695,1008440,538,690456,1698896,03/11/2020
2015,Saratoga Springs,411500,9078,4313930,1880,1884742,6198672,03/11/2020
2015,Burnt Hills-Ballston Lake,412001,4906,3247336,1309,1866461,5113797,03/11/2020
2015,Shenendehowa,412402,14351,9934302,2550,3754637,13688939,03/11/2020
2015,Corinth,412601,1440,646917,552,480332,1127249,03/11/2020
2015,Edinburg,413001,329,58640,168,58711,117351,03/11/2020
2015,Galway,413201,1572,777419,518,517261,1294680,03/11/2020
2015,Ballston Spa,414201,5392,4136608,1282,1921924,6058532,03/11/2020
2015,South Glens Falls,414401,3920,2481595,1186,1547713,4029308,03/11/2020
2015,Schuylerville,415001,2254,1728810,543,830064,2558874,03/11/2020
2015,Stillwater,415201,1703,826780,462,458451,1285231,03/11/2020
2015,Waterford-Halfmoon,415401,977,854132,361,599291,1453423,03/11/2020
2015,Schenectady,421500,7224,4893366,2524,3172897,8066263,03/11/2020
2015,Duanesburg,422001,1258,615494,305,313194,928688,03/11/2020
2015,Scotia-Glenville,422202,4045,2286056,1195,1442188,3728244,03/11/2020
2015,Niskayuna,422401,5931,3255082,1070,1273820,4528902,03/11/2020
2015,Schalmont,422801,3196,1743970,1028,1207009,2950979,03/11/2020
2015,Rotterdam-Mohonasen,422803,4648,2196459,1860,1892123,4088582,03/11/2020
2015,Cobleskill-Richmondville,432602,2222,1220330,939,1014316,2234646,03/11/2020
2015,Gilboa-Conesville,433401,464,145016,323,200682,345698,03/11/2020
2015,Jefferson,433601,380,156557,193,159739,316296,03/11/2020
2015,Middleburgh,433801,1139,686719,526,602852,1289571,03/11/2020
2015,Schoharie,434201,1395,867417,512,647425,1514842,03/11/2020
2015,Sharon Springs,434601,386,223341,179,206164,429505,03/11/2020
2015,Odessa-Montour,442001,1162,530134,429,408163,938297,03/11/2020
2015,Watkins Glen,442401,1672,600252,682,505550,1105802,03/11/2020
2015,South Seneca,452801,1199,566241,510,481180,1047421,03/11/2020
2015,Romulus,453003,647,356921,243,281009,637930,03/11/2020
2015,Seneca Falls,453201,1827,1306766,718,1056908,2363674,03/11/2020
2015,Waterloo,453801,2134,1365500,808,1073126,2438626,03/11/2020
2015,Corning,460300,6670,4866763,2222,3236006,8102769,03/11/2020
2015,Hornell,460600,1690,911854,661,666073,1577927,03/11/2020
2015,Addison,462001,1401,785792,509,532842,1318634,03/11/2020
2015,Avoca,462201,717,273696,296,216656,490352,03/11/2020
2015,Bath,462402,1739,930242,650,709541,1639783,03/11/2020
2015,Bradford,462601,416,212799,156,162213,375012,03/11/2020
2015,Campbell-Savona,463002,1098,641116,438,510511,1151627,03/11/2020
2015,Canisteo-Greenwood,463202,1132,555229,560,526088,1081317,03/11/2020
2015,Arkport,465201,597,376336,302,345468,721804,03/11/2020
2015,Jasper-Troupsburg,465601,571,229229,237,193395,422624,03/11/2020
2015,Prattsburgh,466001,620,269395,230,193270,462665,03/11/2020
2015,Hammondsport,467201,930,272779,428,260772,533551,03/11/2020
2015,Wayland-Cohocton,467401,1887,897662,715,663413,1561075,03/11/2020
2015,Babylon,472001,2461,3289983,407,1134178,4424161,03/11/2020
2015,West Babylon,472002,4979,6070436,1095,2825251,8895687,03/11/2020
2015,North Babylon,472003,5921,6945637,1465,3666010,10611647,03/11/2020
2015,Lindenhurst,472004,7806,9841252,1820,4983492,14824744,03/11/2020
2015,Copiague,472005,4385,5277287,1192,2892527,8169814,03/11/2020
2015,Amityville,472006,3829,4535804,1129,2212597,6748401,03/11/2020
2015,Deer Park,472007,4731,5783166,1365,3513050,9296216,03/11/2020
2015,Wyandanch,472009,939,1212878,196,523720,1736598,03/11/2020
2015,Three Village,472201,8567,9683259,1552,3702955,13386214,03/11/2020
2015,Brookhaven-Comsewogue,472203,4114,4555930,948,2138779,6694709,03/11/2020
2015,South Country,472204,4583,4699913,820,1782863,6482776,03/11/2020
2015,Sachem,472205,16054,14620346,3116,5969216,20589562,03/11/2020
2015,Port Jefferson,472206,1420,908980,249,342952,1251932,03/11/2020
2015,Mount Sinai,472207,2984,3493779,652,1625529,5119308,03/11/2020
2015,Miller Place,472208,3508,4104220,481,1196381,5300601,03/11/2020
2015,Rocky Point,472209,3773,4829306,513,1383770,6213076,03/11/2020
2015,Middle Country,472211,11232,12574068,2515,5900875,18474943,03/11/2020
2015,Longwood,472212,11297,13319889,3390,7485647,20805536,03/11/2020
2015,Patchogue-Medford,472224,8751,10003372,1844,4286363,14289735,03/11/2020
2015,William Floyd,472232,8180,10107042,1576,3925204,14032246,03/11/2020
2015,Center Moriches,472233,1668,2069027,274,715914,2784941,03/11/2020
2015,East Moriches,472234,1314,1587585,181,466129,2053714,03/11/2020
2015,Eastport- South Manor,472235,3957,4607326,879,1889959,6497285,03/11/2020
2015,East Hampton,472401,898,187137,343,149072,336209,03/11/2020
2015,Wainscott,472402,70,4153,21,2700,6853,03/11/2020
2015,Amagansett,472403,135,15153,87,21069,36222,03/11/2020
2015,Springs,472404,748,285537,320,264503,550040,03/11/2020
2015,Sag Harbor,472405,995,272529,429,256171,528700,03/11/2020
2015,Montauk,472406,422,90416,222,103627,194043,03/11/2020
2015,Elwood,472601,2893,3417699,585,1493003,4910702,03/11/2020
2015,Cold Spring Harbor,472602,1314,1309783,112,243407,1553190,03/11/2020
2015,Huntington,472603,6648,7166746,1179,2690121,9856867,03/11/2020
2015,Northport-East Northport,472604,8181,6842177,1484,2677757,9519934,03/11/2020
2015,Half Hollow Hills,472605,9359,8817497,1995,3821104,12638601,03/11/2020
2015,Harborfields,472606,4173,4782127,690,1705631,6487758,03/11/2020
2015,Commack,472610,8517,10474669,1823,4850703,15325372,03/11/2020
2015,South Huntington,472613,7640,8966043,1684,4256078,13222121,03/11/2020
2015,Bay Shore,472801,5359,6484590,1119,2832670,9317260,03/11/2020
2015,Islip,472802,3650,4718670,754,1935736,6654406,03/11/2020
2015,East Islip,472803,5191,6035537,1169,3191058,9226595,03/11/2020
2015,Sayville,472804,3936,4596088,880,2209425,6805513,03/11/2020
2015,Bayport-Blue Point,472805,2903,3857308,524,1502840,5360148,03/11/2020
2015,Hauppauge,472806,4822,3376279,1076,1599172,4975451,03/11/2020
2015,Connetquot,472807,8130,9089742,1904,4397088,13486830,03/11/2020
2015,West Islip,472809,6229,6814427,1297,3084979,9899406,03/11/2020
2015,Brentwood,472812,8412,6569350,2123,3585146,10154496,03/11/2020
2015,Central Islip,472813,4904,6707087,1176,3368650,10075737,03/11/2020
2015,Fire Island,472814,81,9014,23,5379,14393,03/11/2020
2015,Shoreham-Wading River,473001,3028,3143423,730,1541516,4684939,03/11/2020
2015,Riverhead,473002,6034,4743278,2705,3882103,8625381,03/11/2020
2015,Shelter Island,473201,487,76201,191,65011,141212,03/11/2020
2015,Smithtown,473401,12606,14142283,2634,6042037,20184320,03/11/2020
2015,Kings Park,473405,4917,5021621,1011,2212789,7234410,03/11/2020
2015,Remsenburg-Speonk,473601,348,104204,90,58627,162831,03/11/2020
2015,Westhampton Beach,473602,846,285293,243,172825,458118,03/11/2020
2015,Quogue,473603,174,18219,43,9854,28073,03/11/2020
2015,Hampton Bays,473605,1940,1356560,724,1089645,2446205,03/11/2020
2015,Southhampton,473606,1225,156360,446,123301,279661,03/11/2020
2015,Bridgehampton,473609,166,14703,67,12918,27621,03/11/2020
2015,Sagaponack,473610,30,605,6,263,868,03/11/2020
2015,Tuckahoe Common,473613,416,168121,171,149061,317182,03/11/2020
2015,East Quogue,473617,968,566542,289,352570,919112,03/11/2020
2015,Oysterponds,473802,332,78017,161,82272,160289,03/11/2020
2015,Fishers Island,473804,29,6886,4,2066,8952,03/11/2020
2015,Southold,473805,1350,698493,535,608574,1307067,03/11/2020
2015,Greenport,473810,553,301681,261,332027,633708,03/11/2020
2015,Mattituck-Cutchogue,473812,1928,1060925,656,783310,1844235,03/11/2020
2015,New Suffolk,473815,75,14334,34,14064,28398,03/11/2020
2015,Fallsburg,482801,987,660783,374,495912,1156695,03/11/2020
2015,Eldred,483401,939,365471,376,309200,674671,03/11/2020
2015,Liberty,483601,1190,817907,551,782215,1600122,03/11/2020
2015,Tri-Valley,484201,1134,593449,393,407237,1000686,03/11/2020
2015,Roscoe,484401,319,132323,178,155174,287497,03/11/2020
2015,Livingston Manor,484402,536,217779,258,212529,430308,03/11/2020
2015,Monticello,484601,2725,1288502,1117,1069384,2357886,03/11/2020
2015,Sullivan West,484802,1858,706766,936,739634,1446400,03/11/2020
2015,Waverly,492001,1730,755851,683,605002,1360853,03/11/2020
2015,Candor,492401,961,538997,413,445319,984316,03/11/2020
2015,Newark Valley,492602,1596,899364,580,682796,1582160,03/11/2020
2015,Owego-Apalachin,493001,2704,1559094,1034,1211052,2770146,03/11/2020
2015,Spencer-Van Etten,493401,1202,541260,492,451848,993108,03/11/2020
2015,Tioga,493603,1047,298748,403,240506,539254,03/11/2020
2015,Ithaca,500700,7703,4135009,1813,1898899,6033908,03/11/2020
2015,Dryden,502401,2333,1596750,718,917677,2514427,03/11/2020
2015,Groton,502801,1244,768765,399,491816,1260581,03/11/2020
2015,Lansing,503201,1671,999575,378,472633,1472208,03/11/2020
2015,Newfield,503401,986,536524,360,343925,880449,03/11/2020
2015,Trumansburg,503601,1613,915028,496,573699,1488727,03/11/2020
2015,Kingston,510800,7959,5276156,2966,4076299,9352455,03/11/2020
2015,Highland,513203,2192,1542788,591,865164,2407952,03/11/2020
2015,Rondout Valley,513401,3258,1885922,1132,1377886,3263808,03/11/2020
2015,Marlboro,513601,2216,1758938,598,957107,2716045,03/11/2020
2015,New Paltz,513801,2957,1893394,737,1012532,2905926,03/11/2020
2015,Onteora,514001,2846,1058998,1431,1125479,2184477,03/11/2020
2015,Saugerties,514801,3955,2493664,1433,1909710,4403374,03/11/2020
2015,Wallkill,515201,3821,3202682,943,1424389,4627071,03/11/2020
2015,Ellenville,515602,1454,1026522,605,790220,1816742,03/11/2020
2015,Glens Falls,520500,2572,1300322,935,1008204,2308526,03/11/2020
2015,Bolton,522001,350,51614,170,54639,106253,03/11/2020
2015,Lake George,522201,1329,244615,536,213573,458188,03/11/2020
2015,North Warren,522402,916,175963,499,201789,377752,03/11/2020
2015,Johnsburg,523001,470,145776,249,165220,310996,03/11/2020
2015,Hadley-Luzerne,523201,1241,401671,593,388622,790293,03/11/2020
2015,Queensbury,523402,4227,1858766,1377,1251876,3110642,03/11/2020
2015,Glens Falls Common,523418,241,90041,87,67503,157544,03/11/2020
2015,Warrensburg,524001,1070,452621,525,461734,914355,03/11/2020
2015,Argyle,532001,837,385573,330,313572,699145,03/11/2020
2015,Fort Ann,532802,771,301340,257,214670,516010,03/11/2020
2015,Fort Edward,533001,493,240322,197,206123,446445,03/11/2020
2015,Granville,533201,1353,622521,588,546180,1168701,03/11/2020
2015,Greenwich,533401,1388,658880,514,522060,1180940,03/11/2020
2015,Hartford,533801,646,323712,262,276740,600452,03/11/2020
2015,Hudson Falls,534401,2503,987220,988,824471,1811691,03/11/2020
2015,Putnam,534601,161,26476,60,20607,47083,03/11/2020
2015,Salem,534801,803,327414,361,301758,629172,03/11/2020
2015,Cambridge,535010,1229,511866,575,485955,997821,03/11/2020
2015,Whitehall,535201,811,244279,379,219551,463830,03/11/2020
2015,Newark,542001,2579,1623141,999,1305946,2929087,03/11/2020
2015,Clyde-Savannah,542401,1045,697779,422,545068,1242847,03/11/2020
2015,Lyons,542801,1140,706560,422,491979,1198539,03/11/2020
2015,Gananda,543002,1412,1314766,187,371206,1685972,03/11/2020
2015,Marion,543201,1264,895339,399,591777,1487116,03/11/2020
2015,Wayne,543401,3483,2191379,1016,1359736,3551115,03/11/2020
2015,Palmyra-Macedon,543601,2476,1902909,877,1387585,3290494,03/11/2020
2015,Sodus,544201,1381,850600,597,715635,1566235,03/11/2020
2015,Williamson,544602,1459,1085239,497,806329,1891568,03/11/2020
2015,North Rose-Wolcott,544801,1621,722454,751,683936,1406390,03/11/2020
2015,Red Creek,544803,1098,462699,442,379855,842554,03/11/2020
2015,Mount Vernon,550800,4526,13310376,1271,6065206,19375582,03/11/2020
2015,New Rochelle,551000,7824,15688514,1599,6106164,21794678,03/11/2020
2015,Peekskill,551200,2966,6444463,630,2195447,8639910,03/11/2020
2015,Rye,551400,1552,1954394,283,775868,2730262,03/11/2020
2015,White Plains,551700,6667,14133938,1136,4293097,18427035,03/11/2020
2015,Yonkers,551800,15942,21203199,4184,16005437,37208636,03/11/2020
2015,Katonah-Lewisboro,552001,4047,7549301,563,1176880,8726181,03/11/2020
2015,Bedford,552002,3947,4926389,738,1788795,6715184,03/11/2020
2015,Croton-Harmon,552202,2051,3743995,321,1156744,4900739,03/11/2020
2015,Hendrick Hudson,552203,3158,5095513,518,1550072,6645585,03/11/2020
2015,Eastchester,552401,2844,6607137,620,2744120,9351257,03/11/2020
2015,Tuckahoe,552402,1142,2185493,186,707880,2893373,03/11/2020
2015,Bronxville,552403,418,1072407,42,295396,1367803,03/11/2020
2015,Tarrytowns,552601,2189,4760453,482,2020145,6780598,03/11/2020
2015,Irvington,552602,1452,3211869,221,999263,4211132,03/11/2020
2015,Dobbs Ferry,552603,1253,3137697,224,1134551,4272248,03/11/2020
2015,Hastings On Hudson,552604,1566,4073397,274,1405145,5478542,03/11/2020
2015,Ardsley,552605,2259,4411722,347,1463019,5874741,03/11/2020
2015,Edgemont,552606,1168,2904708,123,643377,3548085,03/11/2020
2015,Greenburgh,552607,3730,6515246,981,2991624,9506870,03/11/2020
2015,Elmsford,552609,1186,1867098,329,1100155,2967253,03/11/2020
2015,Harrison,552801,2446,2785804,632,1441534,4227338,03/11/2020
2015,Mamaroneck,553201,3648,5687333,549,1754778,7442111,03/11/2020
2015,Mount Pleasant,553401,2568,3710917,712,2206884,5917801,03/11/2020
2015,Pocantico Hills,553402,400,324918,89,147207,472125,03/11/2020
2015,Valhalla,553405,1708,2879188,385,1371077,4250265,03/11/2020
2015,Pleasantville,553409,1777,3467338,339,1208959,4676297,03/11/2020
2015,Chappaqua,553604,2916,4979221,280,1006826,5986047,03/11/2020
2015,Byram Hills,553801,1975,2395656,219,566845,2962501,03/11/2020
2015,North Salem,554001,1555,2084223,298,809351,2893574,03/11/2020
2015,Ossining,554201,5240,11572202,883,3750049,15322251,03/11/2020
2015,Briarcliff Manor,554202,1370,2758140,109,466003,3224143,03/11/2020
2015,Pelham,554401,2007,3603265,326,1167730,4770995,03/11/2020
2015,Rye Neck,554801,1227,1979890,283,798751,2778641,03/11/2020
2015,Port Chester-Rye,554804,2612,4467885,930,2771036,7238921,03/11/2020
2015,Blind Brook-Rye,554805,1333,1956396,200,636846,2593242,03/11/2020
2015,Scarsdale,555001,2486,3369912,240,706098,4076010,03/11/2020
2015,Somers,555201,4572,7448323,1358,3953841,11402164,03/11/2020
2015,Lakeland,555401,7905,16411910,1948,6672149,23084059,03/11/2020
2015,Yorktown,555402,4763,9537325,744,3055206,12592531,03/11/2020
2015,Attica,562201,2187,1110653,719,771786,1882439,03/11/2020
2015,Letchworth,562601,1261,549981,440,372335,922316,03/11/2020
2015,Wyoming,563802,390,205140,126,136698,341838,03/11/2020
2015,Perry,564201,1117,584539,479,477544,1062083,03/11/2020
2015,Warsaw,564801,1278,834554,400,547706,1382260,03/11/2020
2015,Penn Yan,573001,2725,849251,1122,743521,1592772,03/11/2020
2015,Dundee,573401,1044,338014,485,311706,649720,03/11/2020
2015,New York City School,650000,457744,136296637,114003,68721509,205018146,03/11/2020
2014,Albany,010100,9434,5917610,3038,3788372,9705982,03/14/2019
2014,Cohoes,010300,2085,1233769,718,870295,2104064,03/14/2019
2014,Watervliet,011800,1198,500382,447,380245,880627,03/14/2019
2014,Berne-Knox-Westerlo,012001,1593,855946,444,473195,1329141,03/14/2019
2014,Bethlehem,012206,6624,4003036,1215,1558640,5561676,03/14/2019
2014,Ravena-Coeymans-Selkirk,012402,2765,1605007,813,977411,2582418,03/14/2019
2014,South Colonie,012601,8834,4588389,2776,2992300,7580689,03/14/2019
2014,North Colonie,012605,7797,3687427,1775,1759662,5447089,03/14/2019
2014,Menands,012615,375,190176,99,105569,295745,03/14/2019
2014,Green Island,012801,249,146927,123,154156,301083,03/14/2019
2014,Guilderland,013002,7277,3801422,1634,1803969,5605391,03/14/2019
2014,Voorheesville,013403,1941,1049861,409,470794,1520655,03/14/2019
2014,Alfred-Almond,022001,843,583305,302,400828,984133,03/14/2019
2014,Andover,023001,424,327339,182,246353,573692,03/14/2019
2014,Genesee Valley,023202,726,332475,371,306498,638973,03/14/2019
2014,Belfast,023401,457,228550,207,182038,410588,03/14/2019
2014,Canaseraga,024002,352,200142,157,163520,363662,03/14/2019
2014,Cuba-Rushford,024801,1291,571899,600,490918,1062817,03/14/2019
2014,Friendship,025001,362,233205,164,169557,402762,03/14/2019
2014,Fillmore,025801,766,300981,277,203754,504735,03/14/2019
2014,Whitesville,026001,228,126816,97,92227,219043,03/14/2019
2014,Scio,026601,459,313050,201,233708,546758,03/14/2019
2014,Wellsville,027001,1644,1106744,756,909929,2016673,03/14/2019
2014,Bolivar-Richburg,027602,930,487074,390,326997,814071,03/14/2019
2014,Binghamton,030200,5357,3337038,2350,2796032,6133070,03/14/2019
2014,Chenango Forks,032001,2015,1302896,709,930822,2233718,03/14/2019
2014,South Mountain-Hickory,032201,126,19158,15,4881,24039,03/14/2019
2014,Harpursville,032601,1093,454136,367,290701,744837,03/14/2019
2014,Susquehanna Valley,032801,2342,1821354,862,1380918,3202272,03/14/2019
2014,Chenango Valley,033001,2530,1929323,1090,1737206,3666529,03/14/2019
2014,Maine-Endwell,033801,3378,2534569,1237,1865618,4400187,03/14/2019
2014,Deposit,034201,587,233312,330,271668,504980,03/14/2019
2014,Whitney Point,034401,1684,902047,571,620400,1522447,03/14/2019
2014,Union-Endicott,034601,5323,3627646,2292,3222307,6849953,03/14/2019
2014,Johnson City,034602,2925,1916765,1353,1739690,3656455,03/14/2019
2014,Vestal,034801,5313,3359891,1828,2420323,5780214,03/14/2019
2014,Windsor,035001,2031,1156228,736,853564,2009792,03/14/2019
2014,Olean,041200,2610,1784225,1004,1197970,2982195,03/14/2019
2014,Salamanca,041600,878,326223,497,307436,633659,03/14/2019
2014,Allegany-Limestone,042001,1462,836033,649,643408,1479441,03/14/2019
2014,West Valley,042204,481,335323,192,269664,604987,03/14/2019
2014,Ellicottville,043601,650,151696,281,134337,286033,03/14/2019
2014,Franklinville,044001,906,503226,388,392212,895438,03/14/2019
2014,Hinsdale,044601,598,286125,239,210562,496687,03/14/2019
2014,Cattaraugus - Little Valley,046402,1406,655442,507,428113,1083555,03/14/2019
2014,Gowanda,047201,1408,638608,589,503415,1142023,03/14/2019
2014,Portville,047401,1007,644901,426,515058,1159959,03/14/2019
2014,Randolph,047601,1131,382853,446,279025,661878,03/14/2019
2014,Yorkshire-Pioneer,048401,3268,1289568,1115,866847,2156415,03/14/2019
2014,Auburn,050100,5155,2699428,1999,2160368,4859796,03/14/2019
2014,Weedsport,052201,1111,710867,386,505100,1215967,03/14/2019
2014,Cato-Meridian,052401,1328,722921,398,414433,1137354,03/14/2019
2014,Southern Cayuga,053001,1192,499673,392,333183,832856,03/14/2019
2014,Port Byron,053801,1245,790007,506,627123,1417130,03/14/2019
2014,Moravia,054201,1311,531928,449,369993,901921,03/14/2019
2014,Union Springs,055401,1188,544076,452,422951,967027,03/14/2019
2014,Dunkirk,060300,2165,1180632,1111,1081680,2262312,03/14/2019
2014,Jamestown,060800,4420,2540928,1822,1768815,4309743,03/14/2019
2014,Southwestern,062201,2074,1245080,872,1034560,2279640,03/14/2019
2014,Frewsburg,062401,1044,758847,398,583142,1341989,03/14/2019
2014,Cassadaga Valley,062601,1360,662680,564,510038,1172718,03/14/2019
2014,Chautauqua Lake,062803,1070,267219,522,254072,521291,03/14/2019
2014,Pine Valley,063001,784,419783,334,334221,754004,03/14/2019
2014,Clymer,063201,564,234642,253,214834,449476,03/14/2019
2014,Bemus Point,063601,1073,447580,450,373249,820829,03/14/2019
2014,Falconer,063801,1470,855952,642,706985,1562937,03/14/2019
2014,Silver Creek,064601,1196,631525,520,531736,1163261,03/14/2019
2014,Forestville,064603,866,463958,338,356283,820241,03/14/2019
2014,Panama,064801,761,432322,288,319405,751727,03/14/2019
2014,Fredonia,065801,2081,1440339,780,1117647,2557986,03/14/2019
2014,Brocton,066001,705,533164,343,520650,1053814,03/14/2019
2014,Ripley,066201,427,346191,185,269617,615808,03/14/2019
2014,Sherman,066601,527,282592,191,194842,477434,03/14/2019
2014,Westfield,067201,936,534258,468,523558,1057816,03/14/2019
2014,Elmira,070400,7308,4410589,2955,3422348,7832937,03/14/2019
2014,Horseheads,073401,5460,2992591,2116,2433180,5425771,03/14/2019
2014,Elmira Heights,073402,1196,792523,516,693233,1485756,03/14/2019
2014,Norwich,081100,2117,1135684,831,830859,1966543,03/14/2019
2014,Afton,082001,742,392549,374,401812,794361,03/14/2019
2014,Bainbridge-Guilford,082201,1080,581149,485,527247,1108396,03/14/2019
2014,Greene,083001,1301,634509,592,588340,1222849,03/14/2019
2014,Unadilla Valley,083803,956,383891,434,344413,728304,03/14/2019
2014,Georgetown-So Otselic Valley,084401,504,262644,186,179441,442085,03/14/2019
2014,Oxford Academy,084601,946,511451,454,468385,979836,03/14/2019
2014,Sherburne-Earlville,085601,1580,728666,642,578273,1306939,03/14/2019
2014,Plattsburgh,091300,1960,1251052,810,1050243,2301295,03/14/2019
2014,Ausable Valley,092201,1791,856655,751,665444,1522099,03/14/2019
2014,Beekmantown,092401,2625,1304119,926,874125,2178244,03/14/2019
2014,Northeastern Clinton,092801,1843,1075130,693,792609,1867739,03/14/2019
2014,Chazy,093001,653,367980,236,271178,639158,03/14/2019
2014,Northern Adirondack,093601,1251,402059,442,265783,667842,03/14/2019
2014,Peru,094001,2577,1469964,725,805094,2275058,03/14/2019
2014,Saranac,094401,2305,1336304,709,818006,2154310,03/14/2019
2014,Hudson,100600,1887,895779,890,874186,1769965,03/14/2019
2014,Taconic Hills,102801,1885,647919,785,558003,1205922,03/14/2019
2014,Germantown,103602,832,344437,387,329299,673736,03/14/2019
2014,Chatham,103801,1691,767784,593,554976,1322760,03/14/2019
2014,Kinderhook,104401,2799,1393851,869,901685,2295536,03/14/2019
2014,New Lebanon,104801,787,314758,282,234304,549062,03/14/2019
2014,Cortland,110200,2863,1452638,1105,1178650,2631288,03/14/2019
2014,Cincinnatus,112001,678,333091,293,276829,609920,03/14/2019
2014,Mc Graw,112204,720,386493,245,258814,645307,03/14/2019
2014,Homer,113001,2589,1469239,842,992840,2462079,03/14/2019
2014,Marathon,113401,899,433934,329,285501,719435,03/14/2019
2014,Andes,122002,213,46225,160,72117,118342,03/14/2019
2014,Downsville,122401,363,99388,234,132847,232235,03/14/2019
2014,Charlotte Valley,122601,516,184299,282,200438,384737,03/14/2019
2014,Delhi,122801,1194,466683,553,457178,923861,03/14/2019
2014,Franklin,123201,416,157001,192,152416,309417,03/14/2019
2014,Hancock,123606,406,168032,233,194662,362694,03/14/2019
2014,Margaretville,124601,572,137812,392,197762,335574,03/14/2019
2014,Roxbury,124802,453,175712,276,219702,395414,03/14/2019
2014,Sidney,125001,1228,571541,689,649521,1221062,03/14/2019
2014,Stamford,125201,482,225726,251,240807,466533,03/14/2019
2014,South Kortright,125202,490,206166,271,228931,435097,03/14/2019
2014,Walton,125601,1102,404506,597,446631,851137,03/14/2019
2014,Beacon,130200,3414,2386933,855,1287866,3674799,03/14/2019
2014,Poughkeepsie,131300,2628,1578296,890,1115985,2694281,03/14/2019
2014,Dover,132602,1487,1387799,349,703375,2091174,03/14/2019
2014,Hyde Park,133201,5086,4569035,1668,2974718,7543753,03/14/2019
2014,Northeast,133801,881,462585,325,359783,822368,03/14/2019
2014,Pawling,134001,1699,1471608,391,716688,2188296,03/14/2019
2014,Pine Plains,134201,1652,814779,610,623940,1438719,03/14/2019
2014,Arlington,134601,10825,10690006,2136,4355477,15045483,03/14/2019
2014,Spackenkill,134602,1716,1627766,425,795102,2422868,03/14/2019
2014,Red Hook,134801,2233,1896141,684,1235431,3131572,03/14/2019
2014,Rhinebeck,135001,1663,1102525,601,839928,1942453,03/14/2019
2014,Wappingers,135601,15136,10028948,3633,4946260,14975208,03/14/2019
2014,Millbrook,135801,1371,792338,360,440503,1232841,03/14/2019
2014,Buffalo,140200,25383,8944423,7928,4280919,13225342,03/14/2019
2014,Lackawanna,140900,2303,785397,1214,684068,1469465,03/14/2019
2014,Tonawanda,141600,3181,1674687,1248,1364133,3038820,03/14/2019
2014,Alden,142001,2645,1538407,945,1128398,2666805,03/14/2019
2014,Amherst,142201,5307,3325739,1456,1905997,5231736,03/14/2019
2014,Williamsville,142203,15913,8874789,4215,4803715,13678504,03/14/2019
2014,Sweet Home,142207,5037,2144672,2184,1979818,4124490,03/14/2019
2014,East Aurora,142401,2950,1311015,910,856367,2167382,03/14/2019
2014,Cheektowaga,143001,3771,1910629,1629,1598848,3509477,03/14/2019
2014,Cheektowaga-Maryvale,143002,3730,1961971,1822,2002026,3963997,03/14/2019
2014,Cleveland Hill,143003,2525,2116317,820,1408306,3524623,03/14/2019
2014,Depew,143007,3111,1953831,1358,1800594,3754425,03/14/2019
2014,Cheektowaga-Sloan,143009,2390,2149091,1190,2219080,4368171,03/14/2019
2014,Clarence,143201,6370,2742029,1681,1414868,4156897,03/14/2019
2014,Springville-Griffith,143801,2830,1438076,987,1015125,2453201,03/14/2019
2014,Eden,144001,2380,1331512,774,919312,2250824,03/14/2019
2014,Iroquois,144201,4164,2056822,1419,1480959,3537781,03/14/2019
2014,Evans-Brant,144401,3734,1932182,1271,1260560,3192742,03/14/2019
2014,Grand Island,144601,4896,2814212,1271,1542557,4356769,03/14/2019
2014,Hamburg,144801,5495,3088382,1714,2043342,5131724,03/14/2019
2014,Frontier,144804,7928,3593861,2601,2390083,5983944,03/14/2019
2014,Holland,145001,1596,661406,473,414281,1075687,03/14/2019
2014,Lancaster,145201,9688,4553446,2965,2853691,7407137,03/14/2019
2014,Akron,145601,1939,925661,796,704762,1630423,03/14/2019
2014,North Collins,145801,927,571810,315,392649,964459,03/14/2019
2014,Orchard Park,146001,7452,3971552,2008,2271471,6243023,03/14/2019
2014,Kenmore,146401,14448,8528739,5847,7333595,15862334,03/14/2019
2014,West Seneca,146801,11279,5780485,4860,5112729,10893214,03/14/2019
2014,Crown Point,152203,353,116082,175,113399,229481,03/14/2019
2014,Elizabethtown-Lewis,152401,462,179793,205,160120,339913,03/14/2019
2014,Keene,153001,234,58523,83,44236,102759,03/14/2019
2014,Minerva,153401,185,56204,107,63613,119817,03/14/2019
2014,Moriah,153601,854,454348,471,459098,913446,03/14/2019
2014,Newcomb,153801,97,7021,69,9908,16929,03/14/2019
2014,Lake Placid,154002,873,176833,359,152594,329427,03/14/2019
2014,Schroon Lake,154601,414,94447,224,105360,199807,03/14/2019
2014,Ticonderoga,154801,940,255355,528,283263,538618,03/14/2019
2014,Westport,155001,261,107576,144,115557,223133,03/14/2019
2014,Willsboro,155201,475,156068,277,170442,326510,03/14/2019
2014,Tupper Lake,162001,1122,401997,447,309574,711571,03/14/2019
2014,Chateaugay,163401,655,275374,283,232000,507374,03/14/2019
2014,Salmon River,164201,697,240177,331,214664,454841,03/14/2019
2014,Saranac Lake,164601,1960,530981,644,356074,887055,03/14/2019
2014,Malone,164801,2851,1298645,1151,989486,2288131,03/14/2019
2014,Brushton-Moira,165001,936,465274,366,355778,821052,03/14/2019
2014,St. Regis Falls,165401,420,212323,204,190723,403046,03/14/2019
2014,Gloversville,170500,2748,1738429,1329,1453925,3192354,03/14/2019
2014,Johnstown,170800,1994,920884,785,714883,1635767,03/14/2019
2014,Broadalbin-Perth,172201,2170,1097565,856,869640,1967205,03/14/2019
2014,Wheelerville,172401,314,73434,158,76981,150415,03/14/2019
2014,Mayfield,173001,1262,599631,561,524709,1124340,03/14/2019
2014,Northville,173201,554,170843,299,192899,363742,03/14/2019
2014,Batavia,180200,2922,1975748,1129,1550543,3526291,03/14/2019
2014,Alexander,182202,1128,741033,392,534128,1275161,03/14/2019
2014,Byron-Bergen,183001,1464,1078510,522,725388,1803898,03/14/2019
2014,Elba,183401,559,346808,208,262357,609165,03/14/2019
2014,Le Roy,183601,1626,1173017,571,827906,2000923,03/14/2019
2014,Oakfield-Alabama,183801,1052,716057,377,523129,1239186,03/14/2019
2014,Pavilion,184001,1033,675126,347,452937,1128063,03/14/2019
2014,Pembroke,184202,1446,847008,539,645092,1492100,03/14/2019
2014,Cairo-Durham,192401,1569,596399,818,628208,1224607,03/14/2019
2014,Catskill,192601,1963,920863,756,733364,1654227,03/14/2019
2014,Coxsackie-Athens,192801,1847,832640,666,621212,1453852,03/14/2019
2014,Greenville,193201,1792,932551,704,753834,1686385,03/14/2019
2014,Hunter-Tannersville,193601,527,156730,322,193658,350388,03/14/2019
2014,Windham-Ashland-Jewett,194601,453,100882,267,124504,225386,03/14/2019
2014,Piseco,202001,75,4856,46,6372,11228,03/14/2019
2014,Indian Lake,202601,283,55447,175,70917,126364,03/14/2019
2014,Inlet,202801,72,8551,49,12319,20870,03/14/2019
2014,Lake Pleasant,203001,165,36255,113,52534,88789,03/14/2019
2014,Long Lake,203201,131,14918,103,23611,38529,03/14/2019
2014,Raquette Lake,203202,18,207,16,393,600,03/14/2019
2014,Wells,203601,191,53293,116,68128,121421,03/14/2019
2014,Little Falls,210900,1187,928105,557,783700,1711805,03/14/2019
2014,West Canada Valley,212402,997,498192,336,343439,841631,03/14/2019
2014,Frankfort-Schuyler,212602,1305,789446,597,742857,1532303,03/14/2019
2014,Central Valley,212803,2510,1342368,1036,1095324,2437692,03/14/2019
2014,Herkimer,213001,1375,832567,722,844121,1676688,03/14/2019
2014,Dolgeville,213602,968,374210,445,331645,705855,03/14/2019
2014,Poland,213803,914,340998,349,262542,603540,03/14/2019
2014,Van Hornesville-Owen D. Young,215001,283,140829,128,125722,266551,03/14/2019
2014,Town Of Webb,215401,452,37517,315,55183,92700,03/14/2019
2014,Mount Markham,215601,1395,759749,522,559526,1319275,03/14/2019
2014,Watertown,221800,3480,958890,1249,709338,1668228,03/14/2019
2014,South Jefferson,222001,2146,710050,647,424103,1134153,03/14/2019
2014,Alexandria,222202,776,229100,314,189230,418330,03/14/2019
2014,Indian River,222401,1674,223370,510,135982,359352,03/14/2019
2014,General Brown,222601,1830,483080,571,309733,792813,03/14/2019
2014,Thousand Islands,223201,1426,432691,631,396567,829258,03/14/2019
2014,Belleville-Henderson,223402,662,155912,322,154132,310044,03/14/2019
2014,Sackets Harbor,223801,577,201698,187,136218,337916,03/14/2019
2014,Lyme,224401,545,155561,254,149506,305067,03/14/2019
2014,La Fargeville,224601,562,140066,201,103430,243496,03/14/2019
2014,Carthage,226001,2348,744188,744,477403,1221591,03/14/2019
2014,Copenhagen,232201,555,148584,175,94441,243025,03/14/2019
2014,Harrisville,232401,485,240238,242,219631,459869,03/14/2019
2014,Lowville,233601,1545,355573,541,251605,607178,03/14/2019
2014,South Lewis,234001,1443,558850,590,443728,1002578,03/14/2019
2014,Beaver River,234401,1199,383465,411,272406,655871,03/14/2019
2014,Avon,242001,1259,917307,383,560103,1477410,03/14/2019
2014,Caledonia-Mumford,242201,1264,735044,429,499505,1234549,03/14/2019
2014,Geneseo,242601,1332,647207,387,391841,1039048,03/14/2019
2014,Livonia,243401,2471,1501463,699,855804,2357267,03/14/2019
2014,Mount Morris,243601,584,455579,228,329496,785075,03/14/2019
2014,Dansville,243801,1953,998292,790,767481,1765773,03/14/2019
2014,Dalton-Nunda,244001,1034,630138,421,465249,1095387,03/14/2019
2014,York,245201,1070,688423,371,461692,1150115,03/14/2019
2014,Oneida,251200,2637,1609179,1034,1295101,2904280,03/14/2019
2014,Brookfield,252009,276,118211,102,85627,203838,03/14/2019
2014,Cazenovia,252201,2131,1029844,586,590420,1620264,03/14/2019
2014,De Ruyter,252401,509,270018,184,193359,463377,03/14/2019
2014,Morrisville-Eaton,252601,943,436100,309,277819,713919,03/14/2019
2014,Hamilton,253201,866,427965,261,266471,694436,03/14/2019
2014,Canastota,253601,1795,1185703,779,1038942,2224645,03/14/2019
2014,Madison,254001,576,333525,231,262119,595644,03/14/2019
2014,Stockbridge Valley,254601,570,322331,191,213470,535801,03/14/2019
2014,Chittenango,254801,2976,1986220,1019,1337639,3323859,03/14/2019
2014,Rochester,261400,21506,8692212,4881,3437484,12129696,03/14/2019
2014,Brighton,262001,4836,3702493,1024,1624735,5327228,03/14/2019
2014,Gates-Chili,262601,7417,5618155,2962,4500433,10118588,03/14/2019
2014,Greece,262801,16991,11795977,5856,8488743,20284720,03/14/2019
2014,East Irondequoit,263401,6161,5214889,2357,4112317,9327206,03/14/2019
2014,West Irondequoit,263403,5920,4763064,1977,3379432,8142496,03/14/2019
2014,Honeoye Falls-Lima,263601,3072,2113038,668,959812,3072850,03/14/2019
2014,Spencerport,263801,5190,3709197,1556,2330419,6039616,03/14/2019
2014,Hilton,264001,6202,4287470,1935,2768667,7056137,03/14/2019
2014,Penfield,264201,7458,5608743,1979,3084620,8693363,03/14/2019
2014,Fairport,264401,9176,5939193,2736,3673162,9612355,03/14/2019
2014,East Rochester,264413,1635,1227175,670,950729,2177904,03/14/2019
2014,Pittsford,264601,7605,5680441,1388,2184117,7864558,03/14/2019
2014,Churchville-Chili,264801,5650,3930731,1694,2441299,6372030,03/14/2019
2014,Rush-Henrietta,265001,8653,5047790,2669,3222496,8270286,03/14/2019
2014,Brockport,265201,4620,3493878,1197,1786562,5280440,03/14/2019
2014,Webster,265401,12705,7916442,3838,5022479,12938921,03/14/2019
2014,Wheatland-Chili,265601,1259,868898,401,550725,1419623,03/14/2019
2014,Amsterdam,270100,3716,2027164,1833,2015907,4043071,03/14/2019
2014,Canajoharie,272201,1204,656100,493,547512,1203612,03/14/2019
2014,Fonda-Fultonville,272801,1850,871075,625,590292,1461367,03/14/2019
2014,Fort Plain,273001,909,681794,403,586788,1268582,03/14/2019
2014,Oppenheim-Ephratah-St.Johnsvil,273803,1123,546634,498,458248,1004882,03/14/2019
2014,Glen Cove,280500,3425,3166818,1244,2345934,5512752,03/14/2019
2014,Long Beach,281000,6440,4963141,1230,1927597,6890738,03/14/2019
2014,Hempstead,282001,2460,3342162,467,1340720,4682882,03/14/2019
2014,Uniondale,282002,4557,4213925,891,1776178,5990103,03/14/2019
2014,East Meadow,282003,10627,13512912,2911,6747195,20260107,03/14/2019
2014,North Bellmore,282004,5677,7938486,1189,3595446,11533932,03/14/2019
2014,Levittown,282005,10530,17646733,2336,8486519,26133252,03/14/2019
2014,Seaford,282006,3706,4917285,812,2218529,7135814,03/14/2019
2014,Bellmore,282007,2873,3866573,495,1464351,5330924,03/14/2019
2014,Roosevelt,282008,1844,2242352,366,870821,3113173,03/14/2019
2014,Freeport,282009,5286,6811899,1083,2808160,9620059,03/14/2019
2014,Baldwin,282010,6640,9849290,1108,3415778,13265068,03/14/2019
2014,Oceanside,282011,8246,9866617,1665,4140255,14006872,03/14/2019
2014,Malverne,282012,2894,4236317,574,1839867,6076184,03/14/2019
2014,Valley Stream 13,282013,5795,7477454,1395,3753154,11230608,03/14/2019
2014,Hewlett-Woodmere,282014,4094,6681512,657,2250814,8932326,03/14/2019
2014,Lawrence,282015,5220,3997100,849,1302971,5300071,03/14/2019
2014,Elmont,282016,7365,8661498,1480,3780580,12442078,03/14/2019
2014,Franklin Square,282017,4814,5156947,1318,3099651,8256598,03/14/2019
2014,Garden City,282018,4777,4070109,626,1150468,5220577,03/14/2019
2014,East Rockaway,282019,1951,2673619,506,1467135,4140754,03/14/2019
2014,Lynbrook,282020,3595,4945635,743,2147368,7093003,03/14/2019
2014,Rockville Centre,282021,4485,5542975,688,1768594,7311569,03/14/2019
2014,Floral Park-Bellerose,282022,4077,4293793,831,1849170,6142963,03/14/2019
2014,Wantagh,282023,4211,5920393,684,2107619,8028012,03/14/2019
2014,Valley Stream 24,282024,2388,2706321,490,1220441,3926762,03/14/2019
2014,Merrick,282025,4318,6075592,614,1897765,7973357,03/14/2019
2014,Island Trees,282026,3184,3911214,765,2048472,5959686,03/14/2019
2014,West Hempstead,282027,3348,4122379,667,1804707,5927086,03/14/2019
2014,North Merrick,282029,3206,4425115,637,1878366,6303481,03/14/2019
2014,Valley Stream 30,282030,2844,3185060,475,1166266,4351326,03/14/2019
2014,Island Park,282031,1415,1163715,321,579631,1743346,03/14/2019
2014,Westbury,282201,2746,4172525,665,2136165,6308690,03/14/2019
2014,East Williston,282202,1714,2008630,204,522144,2530774,03/14/2019
2014,Roslyn,282203,3409,4238012,358,912890,5150902,03/14/2019
2014,Port Washington,282204,4935,4558921,784,1574564,6133485,03/14/2019
2014,New Hyde Park-Garden City,282205,4520,4728049,1096,2521955,7250004,03/14/2019
2014,Manhasset,282206,2802,1967373,309,476161,2443534,03/14/2019
2014,Great Neck,282207,8220,5728915,1141,1626941,7355856,03/14/2019
2014,Herricks,282209,5576,6592133,979,2547340,9139473,03/14/2019
2014,Mineola,282210,4392,4572209,1104,2515769,7087978,03/14/2019
2014,Carle Place,282211,1787,2035416,420,1050255,3085671,03/14/2019
2014,North Shore,282401,3232,2996111,542,1104944,4101055,03/14/2019
2014,Syosset,282402,7059,9686625,1103,2540736,12227361,03/14/2019
2014,Locust Valley,282403,2734,2371412,459,875908,3247320,03/14/2019
2014,Plainview-Old Bethpage,282404,6865,9601687,1202,3699429,13301116,03/14/2019
2014,Oyster Bay-East Norwich,282406,2182,1622074,355,561696,2183770,03/14/2019
2014,Jericho,282415,2678,2965049,302,736413,3701462,03/14/2019
2014,Hicksville,282417,7155,6672113,1955,3868571,10540684,03/14/2019
2014,Plainedge,282418,4318,6940802,1055,3724436,10665238,03/14/2019
2014,Bethpage,282421,3941,4482547,1302,2398886,6881433,03/14/2019
2014,Farmingdale,282422,8119,11350780,1958,5935428,17286208,03/14/2019
2014,Massapequa,282423,10877,13419410,2319,6231702,19651112,03/14/2019
2014,Lockport,290900,5983,4919925,1975,2946629,7866554,03/14/2019
2014,Niagara Falls,291100,7250,3773281,3299,3100181,6873462,03/14/2019
2014,North Tonawanda,291200,6270,3909857,2531,3281184,7191041,03/14/2019
2014,Lewiston-Porter,292401,3825,2097363,1588,1842560,3939923,03/14/2019
2014,Newfane,292801,2210,1880838,874,1420466,3301304,03/14/2019
2014,Niagara-Wheatfield,293001,5121,2656942,2016,2098828,4755770,03/14/2019
2014,Starpoint,293201,4217,2805387,1168,1635699,4441086,03/14/2019
2014,Royalton-Hartland,293601,1965,1290314,688,933558,2223872,03/14/2019
2014,Barker,293801,1034,480207,404,387029,867236,03/14/2019
2014,Wilson,294201,1756,1261450,635,952628,2214078,03/14/2019
2014,Rome,301300,5839,3715035,2410,2948407,6663442,03/14/2019
2014,Utica,301600,6864,3913722,3175,3461602,7375324,03/14/2019
2014,Adirondack,302601,1812,770580,741,608264,1378844,03/14/2019
2014,Camden,303001,2578,1119988,1006,825059,1945047,03/14/2019
2014,Clinton,304001,1745,1293052,668,1000398,2293450,03/14/2019
2014,New Hartford,304801,3686,2481452,1189,1600052,4081504,03/14/2019
2014,New York Mills,304804,795,509646,433,579233,1088879,03/14/2019
2014,Sauquoit Valley,305002,1367,773572,448,515281,1288853,03/14/2019
2014,Remsen,305201,693,432074,259,326529,758603,03/14/2019
2014,Waterville,305401,1104,571630,385,389520,961150,03/14/2019
2014,Holland Patent,305801,2065,1213036,742,872493,2085529,03/14/2019
2014,Sherrill,306000,2532,1513491,1011,1237067,2750558,03/14/2019
2014,Westmoreland,306801,1435,1061429,538,789744,1851173,03/14/2019
2014,Oriskany,307001,888,531433,356,439343,970776,03/14/2019
2014,Whitesboro,307002,4957,3008095,1810,2327193,5335288,03/14/2019
2014,Syracuse,311500,14073,6153973,4329,3679646,9833619,03/14/2019
2014,West Genesee,312001,7343,4799934,2783,3730926,8530860,03/14/2019
2014,North Syracuse,312403,13717,9050711,3894,5013066,14063777,03/14/2019
2014,East Syracuse-Minoa,312601,4695,3520444,1876,2681244,6201688,03/14/2019
2014,Jamesville-Dewitt,312611,3899,2597453,848,1159933,3757386,03/14/2019
2014,Jordan-Elbridge,312801,1685,1355575,599,910730,2266305,03/14/2019
2014,Fabius-Pompey,313001,1102,854652,321,493549,1348201,03/14/2019
2014,Westhill,313201,2686,2179860,872,1451510,3631370,03/14/2019
2014,Solvay,313202,1703,1320879,876,1283313,2604192,03/14/2019
2014,La Fayette,313407,1015,555775,300,325181,880956,03/14/2019
2014,Baldwinsville,313601,7977,5527828,2145,3021328,8549156,03/14/2019
2014,Fayetteville-Manlius,313801,5757,4370672,1300,2056502,6427174,03/14/2019
2014,Marcellus,314001,2557,1730949,770,1081609,2812558,03/14/2019
2014,Onondaga,314201,1456,1224226,443,757655,1981881,03/14/2019
2014,Liverpool,314801,10032,7604719,3403,5123651,12728370,03/14/2019
2014,Lyncourt,314804,762,693335,411,661755,1355090,03/14/2019
2014,Skaneateles,315001,1932,803905,647,566684,1370589,03/14/2019
2014,Tully,315402,1319,737785,339,386985,1124770,03/14/2019
2014,Canandaigua,320200,4610,2585132,1368,1571399,4156531,03/14/2019
2014,Geneva,320500,2575,1660442,1034,1322728,2983170,03/14/2019
2014,East Bloomfield,322601,1299,936801,409,608220,1545021,03/14/2019
2014,Gorham-Middlesex,323201,2107,895835,744,641524,1537359,03/14/2019
2014,Manchester-Shortsville,323601,1105,949210,435,750993,1700203,03/14/2019
2014,Naples,323801,1246,544669,452,409154,953823,03/14/2019
2014,Phelps-Clifton Springs,324001,2197,1617970,682,1031077,2649047,03/14/2019
2014,Honeoye,324201,1387,658989,515,500202,1159191,03/14/2019
2014,Victor,324801,4987,2539919,1188,1237064,3776983,03/14/2019
2014,Middletown,330900,5401,4481706,1376,2314477,6796183,03/14/2019
2014,Newburgh,331100,8852,7973194,2661,4741736,12714930,03/14/2019
2014,Port Jervis,331300,2485,2498268,984,1914243,4412511,03/14/2019
2014,Washingtonville,332002,5200,4912431,881,1737608,6650039,03/14/2019
2014,Chester,332201,1209,1030078,311,536091,1566169,03/14/2019
2014,Cornwall,332401,3324,3080653,604,1176557,4257210,03/14/2019
2014,Pine Bush,332601,5580,4196093,1252,1933206,6129299,03/14/2019
2014,Goshen,333001,2944,2422076,680,1177441,3599517,03/14/2019
2014,Highland Falls,333601,769,602719,230,371106,973825,03/14/2019
2014,Minisink Valley,333801,4476,3457173,860,1379147,4836320,03/14/2019
2014,Monroe-Woodbury,334001,7733,7787066,1311,2780674,10567740,03/14/2019
2014,Kiryas Joel Village,334002,792,427256,73,76777,504033,03/14/2019
2014,Valley,334201,4774,3968764,1271,2190744,6159508,03/14/2019
2014,Tuxedo,335003,465,220558,104,105663,326221,03/14/2019
2014,Warwick Valley,335401,4841,3984858,1003,1740073,5724931,03/14/2019
2014,Greenwood Lake,335411,1402,1286306,309,594210,1880516,03/14/2019
2014,Florida,335415,1060,1064558,266,560377,1624935,03/14/2019
2014,Albion,342001,2177,1112518,900,907352,2019870,03/14/2019
2014,Kendall,343007,1125,569121,418,435526,1004647,03/14/2019
2014,Holley,343204,1404,1009064,530,745092,1754156,03/14/2019
2014,Medina,343401,1903,1334619,856,1149239,2483858,03/14/2019
2014,Lyndonville,343801,880,478483,368,406619,885102,03/14/2019
2014,Fulton,350400,3402,2688975,1305,1933271,4622246,03/14/2019
2014,Oswego,351200,4884,2810003,1696,1868997,4679000,03/14/2019
2014,Altmar Parish-Williamstown,352002,1491,750059,523,506249,1256308,03/14/2019
2014,Hannibal,353001,1556,1107317,515,700630,1807947,03/14/2019
2014,Central Square,353201,5286,2966576,1624,1783321,4749897,03/14/2019
2014,Mexico,353401,2635,1404448,816,867622,2272070,03/14/2019
2014,Pulaski,355001,1095,656375,397,472325,1128700,03/14/2019
2014,Sandy Creek,355201,1078,474260,507,433225,907485,03/14/2019
2014,Phoenix,355401,2473,2083945,828,1368432,3452377,03/14/2019
2014,Oneonta,361200,2352,1272742,864,963659,2236401,03/14/2019
2014,Gilbertsville-Mt Upton,362202,583,192120,315,208062,400182,03/14/2019
2014,Cherry Valley-Springfield,362401,812,263380,396,259287,522667,03/14/2019
2014,Edmeston,362801,613,209007,226,158343,367350,03/14/2019
2014,Laurens,363401,515,238831,222,217757,456588,03/14/2019
2014,Schenevus,363601,511,243395,244,236243,479638,03/14/2019
2014,Milford,364001,545,248363,319,295991,544354,03/14/2019
2014,Morris,364201,512,237608,243,226600,464208,03/14/2019
2014,Otego-Unadilla,364801,1271,674641,552,585310,1259951,03/14/2019
2014,Cooperstown,365001,1154,353637,463,294177,647814,03/14/2019
2014,Richfield Springs,365601,725,216544,409,245264,461808,03/14/2019
2014,Worcester,366606,446,234309,272,289454,523763,03/14/2019
2014,Mahopac,372001,5765,7358974,1038,2782085,10141059,03/14/2019
2014,Carmel,372002,6268,7972018,1202,3161910,11133928,03/14/2019
2014,Haldane,372601,1042,919665,282,485777,1405442,03/14/2019
2014,Garrison,372604,467,231926,86,91423,323349,03/14/2019
2014,Putnam Valley,372803,2529,3821409,420,1316446,5137855,03/14/2019
2014,Brewster,373001,4530,4981887,951,2203146,7185033,03/14/2019
2014,Rensselaer,381400,1225,594952,403,371010,965962,03/14/2019
2014,Troy,381700,3895,2228539,1256,1458406,3686945,03/14/2019
2014,Lansingburgh,381701,2474,1226433,900,893008,2119441,03/14/2019
2014,Berlin,382001,1412,610837,451,402765,1013602,03/14/2019
2014,Brunswick,382202,1746,914819,572,592905,1507724,03/14/2019
2014,East Greenbush,382401,6616,3420144,1706,1839994,5260138,03/14/2019
2014,Hoosick Falls,382801,1513,795495,565,577924,1373419,03/14/2019
2014,North Greenbush,383201,374,74630,135,57390,132020,03/14/2019
2014,Wynantskill,383204,851,513365,289,367102,880467,03/14/2019
2014,Averill Park,384001,4503,2275488,1060,1112272,3387760,03/14/2019
2014,Hoosic Valley,384201,1469,752474,446,471315,1223789,03/14/2019
2014,Schodack,384401,1451,874975,360,457955,1332930,03/14/2019
2014,Clarkstown,392001,10756,10746908,2094,4456861,15203769,03/14/2019
2014,Nanuet,392008,2312,2449003,595,1308747,3757750,03/14/2019
2014,Haverstraw-Stony Point,392201,7487,12908206,2016,6726152,19634358,03/14/2019
2014,South Orangetown,392401,4039,4591212,1044,2533723,7124935,03/14/2019
2014,Nyack,392404,3794,5177543,853,2558372,7735915,03/14/2019
2014,Pearl River,392408,3082,3760338,764,1978724,5739062,03/14/2019
2014,Ramapo,392601,5238,8948326,1278,4298908,13247234,03/14/2019
2014,East Ramapo,392602,10548,11791403,2050,4447460,16238863,03/14/2019
2014,Ogdensburg,401200,1953,1447894,733,917918,2365812,03/14/2019
2014,Brasher Falls,402001,1216,783550,492,597398,1380948,03/14/2019
2014,Canton,402201,1655,940712,543,604333,1545045,03/14/2019
2014,Clifton-Fine,402601,440,144308,251,141831,286139,03/14/2019
2014,Colton-Pierrepont,402801,582,243410,279,223952,467362,03/14/2019
2014,Edwards-Knox,403401,675,208578,262,152102,360680,03/14/2019
2014,Gouverneur,404001,1779,646867,663,442554,1089421,03/14/2019
2014,Hammond,404201,383,147925,170,130443,278368,03/14/2019
2014,Hermon-Dekalb,404401,482,255490,229,225779,481269,03/14/2019
2014,Lisbon,405002,796,421573,272,285634,707207,03/14/2019
2014,Madrid-Waddington,405601,899,457949,412,408432,866381,03/14/2019
2014,Massena,405801,3120,1637280,1371,1369613,3006893,03/14/2019
2014,Morristown,406001,577,248465,257,223629,472094,03/14/2019
2014,Norwood-Norfolk,406201,1332,966505,566,779283,1745788,03/14/2019
2014,Heuvelton,406404,797,474102,319,369601,843703,03/14/2019
2014,Parishville-Hopkinton,406601,576,220378,246,177142,397520,03/14/2019
2014,Potsdam,407402,1795,1227470,539,720784,1948254,03/14/2019
2014,Mechanicville,411000,1636,960385,546,679681,1640066,03/14/2019
2014,Saratoga Springs,411500,8973,4232377,1899,1852975,6085352,03/14/2019
2014,Burnt Hills-Ballston Lake,412001,4799,3128428,1346,1862893,4991321,03/14/2019
2014,Shenendehowa,412402,14196,9682952,2563,3656710,13339662,03/14/2019
2014,Corinth,412601,1430,629524,563,477775,1107299,03/14/2019
2014,Edinburg,413001,330,57395,165,56625,114020,03/14/2019
2014,Galway,413201,1565,762982,517,499563,1262545,03/14/2019
2014,Ballston Spa,414201,5322,4097392,1276,1890284,5987676,03/14/2019
2014,South Glens Falls,414401,3872,2409324,1192,1499517,3908841,03/14/2019
2014,Schuylerville,415001,2255,1715141,546,809747,2524888,03/14/2019
2014,Stillwater,415201,1685,807842,454,439781,1247623,03/14/2019
2014,Waterford-Halfmoon,415401,952,821176,382,607476,1428652,03/14/2019
2014,Schenectady,421500,7124,4680028,2580,3233534,7913562,03/14/2019
2014,Duanesburg,422001,1275,613556,295,294245,907801,03/14/2019
2014,Scotia-Glenville,422202,4031,2248679,1198,1405585,3654264,03/14/2019
2014,Niskayuna,422401,5873,3174326,1079,1244754,4419080,03/14/2019
2014,Schalmont,422801,3180,1711899,1031,1176123,2888022,03/14/2019
2014,Rotterdam-Mohonasen,422803,4641,2167207,1869,1845623,4012830,03/14/2019
2014,Cobleskill-Richmondville,432602,2214,1197661,955,1003329,2200990,03/14/2019
2014,Gilboa-Conesville,433401,480,157336,306,193889,351225,03/14/2019
2014,Jefferson,433601,382,155679,183,147152,302831,03/14/2019
2014,Middleburgh,433801,1137,672101,523,588647,1260748,03/14/2019
2014,Schoharie,434201,1390,853924,506,622785,1476709,03/14/2019
2014,Sharon Springs,434601,368,220594,190,225217,445811,03/14/2019
2014,Odessa-Montour,442001,1142,527141,436,409098,936239,03/14/2019
2014,Watkins Glen,442401,1648,588290,703,510881,1099171,03/14/2019
2014,South Seneca,452801,1211,575283,512,475239,1050522,03/14/2019
2014,Romulus,453003,636,359857,248,287363,647220,03/14/2019
2014,Seneca Falls,453201,1817,1305553,745,1077418,2382971,03/14/2019
2014,Waterloo,453801,2133,1367157,818,1014972,2382129,03/14/2019
2014,Corning,460300,6607,4886441,2252,3239847,8126288,03/14/2019
2014,Hornell,460600,1688,897495,665,649529,1547024,03/14/2019
2014,Addison,462001,1397,850522,504,554797,1405319,03/14/2019
2014,Avoca,462201,715,287528,296,223121,510649,03/14/2019
2014,Bath,462402,1703,933637,674,736023,1669660,03/14/2019
2014,Bradford,462601,407,207928,168,170748,378676,03/14/2019
2014,Campbell-Savona,463002,1084,656106,443,527421,1183527,03/14/2019
2014,Canisteo-Greenwood,463202,1131,566467,556,521701,1088168,03/14/2019
2014,Arkport,465201,604,378326,302,342670,720996,03/14/2019
2014,Jasper-Troupsburg,465601,561,222725,239,187959,410684,03/14/2019
2014,Prattsburgh,466001,615,264909,216,180743,445652,03/14/2019
2014,Hammondsport,467201,931,269327,436,257641,526968,03/14/2019
2014,Wayland-Cohocton,467401,1851,880586,716,643819,1524405,03/14/2019
2014,Babylon,472001,2425,3193878,418,1123087,4316965,03/14/2019
2014,West Babylon,472002,4880,5873103,1146,2853876,8726979,03/14/2019
2014,North Babylon,472003,5813,6729723,1500,3626335,10356058,03/14/2019
2014,Lindenhurst,472004,8131,9909925,1819,4608632,14518557,03/14/2019
2014,Copiague,472005,4280,5082270,1219,2874000,7956270,03/14/2019
2014,Amityville,472006,4088,4539502,1125,2012019,6551521,03/14/2019
2014,Deer Park,472007,4636,5595895,1411,3504715,9100610,03/14/2019
2014,Wyandanch,472009,885,1125354,208,535428,1660782,03/14/2019
2014,Three Village,472201,8497,9439738,1572,3648200,13087938,03/14/2019
2014,Brookhaven-Comsewogue,472203,4081,4433116,944,2068966,6502082,03/14/2019
2014,South Country,472204,4548,4585475,820,1726443,6311918,03/14/2019
2014,Sachem,472205,15880,14227471,3094,5758852,19986323,03/14/2019
2014,Port Jefferson,472206,1398,879351,257,343334,1222685,03/14/2019
2014,Mount Sinai,472207,2936,3381535,642,1561633,4943168,03/14/2019
2014,Miller Place,472208,3478,3999970,472,1142423,5142393,03/14/2019
2014,Rocky Point,472209,3720,4678504,530,1382416,6060920,03/14/2019
2014,Middle Country,472211,11062,12158229,2562,5855850,18014079,03/14/2019
2014,Longwood,472212,11142,12860440,3382,7286717,20147157,03/14/2019
2014,Patchogue-Medford,472224,8574,9640301,1855,4172234,13812535,03/14/2019
2014,William Floyd,472232,8096,9838112,1544,3730295,13568407,03/14/2019
2014,Center Moriches,472233,1627,1984023,276,697503,2681526,03/14/2019
2014,East Moriches,472234,1274,1511754,189,472754,1984508,03/14/2019
2014,Eastport- South Manor,472235,3910,4480411,903,1887135,6367546,03/14/2019
2014,East Hampton,472401,900,188664,371,159003,347667,03/14/2019
2014,Wainscott,472402,75,4646,23,3063,7709,03/14/2019
2014,Amagansett,472403,138,16166,93,23260,39426,03/14/2019
2014,Springs,472404,765,291002,322,263142,554144,03/14/2019
2014,Sag Harbor,472405,976,279216,464,283832,563048,03/14/2019
2014,Montauk,472406,421,90693,236,109056,199749,03/14/2019
2014,Elwood,472601,2851,3300264,614,1531657,4831921,03/14/2019
2014,Cold Spring Harbor,472602,1293,1283526,126,273113,1556639,03/14/2019
2014,Huntington,472603,6531,7070113,1243,2834601,9904714,03/14/2019
2014,Northport-East Northport,472604,8122,6809812,1524,2750580,9560392,03/14/2019
2014,Half Hollow Hills,472605,9286,8588530,2033,3798578,12387108,03/14/2019
2014,Harborfields,472606,4130,4702089,729,1786931,6489020,03/14/2019
2014,Commack,472610,8470,10411467,1844,4876478,15287945,03/14/2019
2014,South Huntington,472613,7514,8639742,1751,4333199,12972941,03/14/2019
2014,Bay Shore,472801,5164,6132448,1183,2907276,9039724,03/14/2019
2014,Islip,472802,3570,4532228,768,1901773,6434001,03/14/2019
2014,East Islip,472803,5120,5869642,1177,3080539,8950181,03/14/2019
2014,Sayville,472804,3889,4473121,888,2159338,6632459,03/14/2019
2014,Bayport-Blue Point,472805,2877,3761560,523,1461466,5223026,03/14/2019
2014,Hauppauge,472806,4751,3272755,1096,1581522,4854277,03/14/2019
2014,Connetquot,472807,7996,8819416,1909,4252590,13072006,03/14/2019
2014,West Islip,472809,6147,6623149,1320,3042551,9665700,03/14/2019
2014,Brentwood,472812,7881,6060023,2148,3513538,9573561,03/14/2019
2014,Central Islip,472813,4693,6325774,1159,3221976,9547750,03/14/2019
2014,Fire Island,472814,79,8554,23,5345,13899,03/14/2019
2014,Shoreham-Wading River,473001,2981,3042541,766,1568429,4610970,03/14/2019
2014,Riverhead,473002,5936,4653122,2748,3839137,8492259,03/14/2019
2014,Shelter Island,473201,482,79050,209,73353,152403,03/14/2019
2014,Smithtown,473401,12426,13684994,2673,5979622,19664616,03/14/2019
2014,Kings Park,473405,4858,4911961,1025,2204236,7116197,03/14/2019
2014,Remsenburg-Speonk,473601,347,105269,90,58391,163660,03/14/2019
2014,Westhampton Beach,473602,851,289364,250,176146,465510,03/14/2019
2014,Quogue,473603,176,18919,43,9946,28865,03/14/2019
2014,Hampton Bays,473605,1892,1325274,757,1125562,2450836,03/14/2019
2014,Southhampton,473606,1220,160930,478,134163,295093,03/14/2019
2014,Bridgehampton,473609,162,14326,74,14004,28330,03/14/2019
2014,Sagaponack,473610,30,638,5,228,866,03/14/2019
2014,Tuckahoe Common,473613,413,166936,182,156082,323018,03/14/2019
2014,East Quogue,473617,954,577655,299,372901,950556,03/14/2019
2014,Oysterponds,473802,330,78290,174,88276,166566,03/14/2019
2014,Fishers Island,473804,28,6811,4,2081,8892,03/14/2019
2014,Southold,473805,1342,687648,571,630291,1317939,03/14/2019
2014,Greenport,473810,549,300086,287,340479,640565,03/14/2019
2014,Mattituck-Cutchogue,473812,1929,1061302,667,782933,1844235,03/14/2019
2014,New Suffolk,473815,73,13770,36,14452,28222,03/14/2019
2014,Fallsburg,482801,983,643952,373,489525,1133477,03/14/2019
2014,Eldred,483401,920,353491,379,301843,655334,03/14/2019
2014,Liberty,483601,1209,820166,556,765784,1585950,03/14/2019
2014,Tri-Valley,484201,1135,591295,393,399719,991014,03/14/2019
2014,Roscoe,484401,318,130454,182,152829,283283,03/14/2019
2014,Livingston Manor,484402,533,214105,263,209790,423895,03/14/2019
2014,Monticello,484601,2717,1267716,1132,1077849,2345565,03/14/2019
2014,Sullivan West,484802,1826,686658,971,751769,1438427,03/14/2019
2014,Waverly,492001,1723,743380,690,590482,1333862,03/14/2019
2014,Candor,492401,951,525314,405,428844,954158,03/14/2019
2014,Newark Valley,492602,1606,897050,578,660893,1557943,03/14/2019
2014,Owego-Apalachin,493001,2702,1533968,1028,1167605,2701573,03/14/2019
2014,Spencer-Van Etten,493401,1190,529674,496,442466,972140,03/14/2019
2014,Tioga,493603,1027,287671,413,236554,524225,03/14/2019
2014,Ithaca,500700,7713,4071902,1783,1798376,5870278,03/14/2019
2014,Dryden,502401,2367,1619238,684,847540,2466778,03/14/2019
2014,Groton,502801,1254,776552,392,476573,1253125,03/14/2019
2014,Lansing,503201,1662,980208,372,449140,1429348,03/14/2019
2014,Newfield,503401,977,535116,363,335671,870787,03/14/2019
2014,Trumansburg,503601,1618,926727,501,567402,1494129,03/14/2019
2014,Kingston,510800,7935,5207218,2972,3985106,9192324,03/14/2019
2014,Highland,513203,2168,1514382,609,872290,2386672,03/14/2019
2014,Rondout Valley,513401,3292,1918977,1131,1362446,3281423,03/14/2019
2014,Marlboro,513601,2204,1729694,590,918411,2648105,03/14/2019
2014,New Paltz,513801,2904,1836978,742,988834,2825812,03/14/2019
2014,Onteora,514001,2861,1096181,1407,1112783,2208964,03/14/2019
2014,Saugerties,514801,3901,2432743,1473,1912528,4345271,03/14/2019
2014,Wallkill,515201,3711,3086639,997,1439493,4526132,03/14/2019
2014,Ellenville,515602,1449,989869,612,768191,1758060,03/14/2019
2014,Glens Falls,520500,2571,1282807,933,978124,2260931,03/14/2019
2014,Bolton,522001,346,50404,176,55045,105449,03/14/2019
2014,Lake George,522201,1298,235963,550,212766,448729,03/14/2019
2014,North Warren,522402,931,180229,484,193163,373392,03/14/2019
2014,Johnsburg,523001,456,140363,255,164651,305014,03/14/2019
2014,Hadley-Luzerne,523201,1243,395940,595,380627,776567,03/14/2019
2014,Queensbury,523402,4205,1817610,1380,1222089,3039699,03/14/2019
2014,Glens Falls Common,523418,243,89743,81,61003,150746,03/14/2019
2014,Warrensburg,524001,1058,442012,524,448232,890244,03/14/2019
2014,Argyle,532001,842,382357,337,310900,693257,03/14/2019
2014,Fort Ann,532802,765,296929,262,213015,509944,03/14/2019
2014,Fort Edward,533001,498,239905,196,199759,439664,03/14/2019
2014,Granville,533201,1354,614941,595,538828,1153769,03/14/2019
2014,Greenwich,533401,1368,640993,517,509452,1150445,03/14/2019
2014,Hartford,533801,649,321411,253,258821,580232,03/14/2019
2014,Hudson Falls,534401,2502,974544,1008,815306,1789850,03/14/2019
2014,Putnam,534601,152,24693,70,23675,48368,03/14/2019
2014,Salem,534801,808,325130,360,291601,616731,03/14/2019
2014,Cambridge,535010,1248,512850,592,488004,1000854,03/14/2019
2014,Whitehall,535201,816,242435,377,215128,457563,03/14/2019
2014,Newark,542001,2573,1603055,993,1260377,2863432,03/14/2019
2014,Clyde-Savannah,542401,1041,745390,414,559233,1304623,03/14/2019
2014,Lyons,542801,1130,691964,437,495818,1187782,03/14/2019
2014,Gananda,543002,1401,1288781,185,356290,1645071,03/14/2019
2014,Marion,543201,1273,886936,381,549442,1436378,03/14/2019
2014,Wayne,543401,3459,2159389,1002,1303775,3463164,03/14/2019
2014,Palmyra-Macedon,543601,2538,1898124,893,1373606,3271730,03/14/2019
2014,Sodus,544201,1347,821266,615,714951,1536217,03/14/2019
2014,Williamson,544602,1442,1054379,511,808115,1862494,03/14/2019
2014,North Rose-Wolcott,544801,1639,740567,746,675990,1416557,03/14/2019
2014,Red Creek,544803,1112,466122,435,368653,834775,03/14/2019
2014,Mount Vernon,550800,4433,12932603,1181,5494097,18426700,03/14/2019
2014,New Rochelle,551000,7653,15031104,1594,5895866,20926970,03/14/2019
2014,Peekskill,551200,2979,6301139,625,2179939,8481078,03/14/2019
2014,Rye,551400,1879,1939164,363,767413,2706577,03/14/2019
2014,White Plains,551700,6431,13444546,1142,4105048,17549594,03/14/2019
2014,Yonkers,551800,15511,20003615,4144,15819530,35823145,03/14/2019
2014,Katonah-Lewisboro,552001,3999,6633630,556,1834433,8468063,03/14/2019
2014,Bedford,552002,3892,4734505,740,1741118,6475623,03/14/2019
2014,Croton-Harmon,552202,2036,3646184,306,1085668,4731852,03/14/2019
2014,Hendrick Hudson,552203,3125,4930895,540,1579171,6510066,03/14/2019
2014,Eastchester,552401,2789,6405404,640,2674994,9080398,03/14/2019
2014,Tuckahoe,552402,1114,2097528,195,708614,2806142,03/14/2019
2014,Bronxville,552403,544,1200620,41,264652,1465272,03/14/2019
2014,Tarrytowns,552601,2183,4687295,508,2092385,6779680,03/14/2019
2014,Irvington,552602,1416,3084039,219,981210,4065249,03/14/2019
2014,Dobbs Ferry,552603,1205,2979670,226,1119808,4099478,03/14/2019
2014,Hastings On Hudson,552604,1487,3805261,267,1345055,5150316,03/14/2019
2014,Ardsley,552605,2192,4218689,342,1391529,5610218,03/14/2019
2014,Edgemont,552606,1103,2709612,129,655417,3365029,03/14/2019
2014,Greenburgh,552607,3605,6203433,974,2895417,9098850,03/14/2019
2014,Elmsford,552609,1132,1752583,331,1076199,2828782,03/14/2019
2014,Harrison,552801,2388,2665698,656,1457896,4123594,03/14/2019
2014,Mamaroneck,553201,3564,5494345,535,1611455,7105800,03/14/2019
2014,Mount Pleasant,553401,2638,3775133,742,2216830,5991963,03/14/2019
2014,Pocantico Hills,553402,407,325541,92,149264,474805,03/14/2019
2014,Valhalla,553405,1705,2838754,403,1376232,4214986,03/14/2019
2014,Pleasantville,553409,1835,3517450,351,1236867,4754317,03/14/2019
2014,Chappaqua,553604,2841,4763208,281,977863,5741071,03/14/2019
2014,Byram Hills,553801,1973,2352705,233,584506,2937211,03/14/2019
2014,North Salem,554001,1553,2064295,303,803259,2867554,03/14/2019
2014,Ossining,554201,5143,11126529,895,3735068,14861597,03/14/2019
2014,Briarcliff Manor,554202,1361,2686316,109,455484,3141800,03/14/2019
2014,Pelham,554401,1963,3463659,338,1182695,4646354,03/14/2019
2014,Rye Neck,554801,1204,1827218,247,742080,2569298,03/14/2019
2014,Port Chester-Rye,554804,2577,4266928,813,2380841,6647769,03/14/2019
2014,Blind Brook-Rye,554805,1272,1839152,172,532072,2371224,03/14/2019
2014,Scarsdale,555001,2460,3342870,235,677560,4020430,03/14/2019
2014,Somers,555201,4499,7140194,1387,4054125,11194319,03/14/2019
2014,Lakeland,555401,7839,16012522,1948,6537685,22550207,03/14/2019
2014,Yorktown,555402,4668,9186704,741,2964308,12151012,03/14/2019
2014,Attica,562201,2187,1118919,720,768656,1887575,03/14/2019
2014,Letchworth,562601,1260,542306,437,367366,909672,03/14/2019
2014,Wyoming,563802,390,202258,129,136498,338756,03/14/2019
2014,Perry,564201,1109,560191,493,495709,1055900,03/14/2019
2014,Warsaw,564801,1272,835935,396,535981,1371916,03/14/2019
2014,Penn Yan,573001,2735,859189,1130,738200,1597389,03/14/2019
2014,Dundee,573401,1053,335885,470,297498,633383,03/14/2019
2014,New York City School,650000,458642,133226852,116914,67772522,200999374,03/14/2019
2013,Albany,010100,10309,6365936,2961,3606844,9972780,03/14/2019
2013,Cohoes,010300,2198,1282457,675,796476,2078933,03/14/2019
2013,Watervliet,011800,1267,522205,447,370080,892285,03/14/2019
2013,Berne-Knox-Westerlo,012001,1689,895897,408,430534,1326431,03/14/2019
2013,Bethlehem,012206,6829,4068170,1154,1439339,5507509,03/14/2019
2013,Ravena-Coeymans-Selkirk,012402,2899,1699400,780,925780,2625180,03/14/2019
2013,South Colonie,012601,9115,4669857,2660,2784949,7454806,03/14/2019
2013,North Colonie,012605,8012,3736118,1680,1618900,5355018,03/14/2019
2013,Menands,012615,399,199649,91,94379,294028,03/14/2019
2013,Green Island,012801,272,158586,124,151400,309986,03/14/2019
2013,Guilderland,013002,7484,3851393,1530,1648428,5499821,03/14/2019
2013,Voorheesville,013403,1997,1064431,400,448000,1512431,03/14/2019
2013,Alfred-Almond,022001,887,605582,292,379563,985145,03/14/2019
2013,Andover,023001,464,353376,174,229995,583371,03/14/2019
2013,Genesee Valley,023202,767,344379,361,291526,635905,03/14/2019
2013,Belfast,023401,481,237257,189,163216,400473,03/14/2019
2013,Canaseraga,024002,382,213823,142,143036,356859,03/14/2019
2013,Cuba-Rushford,024801,1384,604761,568,451583,1056344,03/14/2019
2013,Friendship,025001,407,273519,160,160615,434134,03/14/2019
2013,Fillmore,025801,805,313053,271,193106,506159,03/14/2019
2013,Whitesville,026001,234,130799,95,91402,222201,03/14/2019
2013,Scio,026601,484,323329,195,227648,550977,03/14/2019
2013,Wellsville,027001,1717,1163386,733,875387,2038773,03/14/2019
2013,Bolivar-Richburg,027602,994,511474,369,306639,818113,03/14/2019
2013,Binghamton,030200,5906,3631252,2347,2686202,6317454,03/14/2019
2013,Chenango Forks,032001,2147,1375248,680,854095,2229343,03/14/2019
2013,South Mountain-Hickory,032201,137,20476,17,5362,25838,03/14/2019
2013,Harpursville,032601,1131,463507,355,271279,734786,03/14/2019
2013,Susquehanna Valley,032801,2486,1894352,836,1300855,3195207,03/14/2019
2013,Chenango Valley,033001,2667,2028424,1108,1735135,3763559,03/14/2019
2013,Maine-Endwell,033801,3557,2624113,1232,1812812,4436925,03/14/2019
2013,Deposit,034201,715,285056,320,263774,548830,03/14/2019
2013,Whitney Point,034401,1867,1012165,580,607507,1619672,03/14/2019
2013,Union-Endicott,034601,5610,3755614,2300,3164109,6919723,03/14/2019
2013,Johnson City,034602,3184,2037749,1375,1728763,3766512,03/14/2019
2013,Vestal,034801,5614,3501994,1806,2325051,5827045,03/14/2019
2013,Windsor,035001,2201,1235823,713,803369,2039192,03/14/2019
2013,Olean,041200,2775,1864545,977,1119549,2984094,03/14/2019
2013,Salamanca,041600,956,492140,481,404398,896538,03/14/2019
2013,Allegany-Limestone,042001,1589,908489,616,596950,1505439,03/14/2019
2013,West Valley,042204,517,360282,180,247770,608052,03/14/2019
2013,Ellicottville,043601,702,162136,249,121286,283422,03/14/2019
2013,Franklinville,044001,973,533821,367,365366,899187,03/14/2019
2013,Hinsdale,044601,673,323949,225,198101,522050,03/14/2019
2013,Cattaraugus - Little Valley,046402,1493,690475,491,408302,1098777,03/14/2019
2013,Gowanda,047201,1506,668684,574,490158,1158842,03/14/2019
2013,Portville,047401,1122,718102,389,452113,1170215,03/14/2019
2013,Randolph,047601,1208,422583,457,292168,714751,03/14/2019
2013,Yorkshire-Pioneer,048401,3447,1348836,1035,781984,2130820,03/14/2019
2013,Auburn,050100,5447,2822026,1963,2051462,4873488,03/14/2019
2013,Weedsport,052201,1194,765263,357,462380,1227643,03/14/2019
2013,Cato-Meridian,052401,1411,763231,402,411521,1174752,03/14/2019
2013,Southern Cayuga,053001,1271,534900,365,305414,840314,03/14/2019
2013,Port Byron,053801,1338,861835,495,611753,1473588,03/14/2019
2013,Moravia,054201,1417,570924,410,331531,902455,03/14/2019
2013,Union Springs,055401,1291,594054,418,384642,978696,03/14/2019
2013,Dunkirk,060300,2301,1286774,1109,1094411,2381185,03/14/2019
2013,Jamestown,060800,4732,2708229,1800,1720641,4428870,03/14/2019
2013,Southwestern,062201,2150,1295841,838,987846,2283687,03/14/2019
2013,Frewsburg,062401,1090,782021,383,545501,1327522,03/14/2019
2013,Cassadaga Valley,062601,1501,725108,541,482165,1207273,03/14/2019
2013,Chautauqua Lake,062803,1177,289405,506,242821,532226,03/14/2019
2013,Pine Valley,063001,868,457599,328,324788,782387,03/14/2019
2013,Clymer,063201,626,257267,249,208229,465496,03/14/2019
2013,Bemus Point,063601,1121,460346,441,357803,818149,03/14/2019
2013,Falconer,063801,1515,869760,643,688565,1558325,03/14/2019
2013,Silver Creek,064601,1261,661703,494,495086,1156789,03/14/2019
2013,Forestville,064603,921,486966,329,340201,827167,03/14/2019
2013,Panama,064801,814,463122,280,306681,769803,03/14/2019
2013,Fredonia,065801,2186,1504889,748,1048358,2553247,03/14/2019
2013,Brocton,066001,769,592222,334,499804,1092026,03/14/2019
2013,Ripley,066201,463,383126,182,274744,657870,03/14/2019
2013,Sherman,066601,562,295239,182,180544,475783,03/14/2019
2013,Westfield,067201,1008,575318,446,487799,1063117,03/14/2019
2013,Elmira,070400,7793,4702945,2896,3266602,7969547,03/14/2019
2013,Horseheads,073401,5727,3192761,2034,2329774,5522535,03/14/2019
2013,Elmira Heights,073402,1302,859004,502,657950,1516954,03/14/2019
2013,Norwich,081100,2312,1224511,813,797270,2021781,03/14/2019
2013,Afton,082001,818,430912,365,381638,812550,03/14/2019
2013,Bainbridge-Guilford,082201,1164,616060,478,505461,1121521,03/14/2019
2013,Greene,083001,1432,693500,548,530510,1224010,03/14/2019
2013,Unadilla Valley,083803,1059,423737,418,327107,750844,03/14/2019
2013,Georgetown-So Otselic Valley,084401,557,286258,178,167322,453580,03/14/2019
2013,Oxford Academy,084601,1053,562705,434,439827,1002532,03/14/2019
2013,Sherburne-Earlville,085601,1673,759849,623,552043,1311892,03/14/2019
2013,Plattsburgh,091300,2043,1308170,755,965894,2274064,03/14/2019
2013,Ausable Valley,092201,1949,924394,722,633039,1557433,03/14/2019
2013,Beekmantown,092401,2798,1374192,886,809551,2183743,03/14/2019
2013,Northeastern Clinton,092801,1988,1146122,657,731064,1877186,03/14/2019
2013,Chazy,093001,697,388965,228,252417,641382,03/14/2019
2013,Northern Adirondack,093601,1420,444900,436,249827,694727,03/14/2019
2013,Peru,094001,2757,1556899,680,734285,2291184,03/14/2019
2013,Saranac,094401,2472,1413068,679,762098,2175166,03/14/2019
2013,Hudson,100600,2073,1003340,846,781480,1784820,03/14/2019
2013,Taconic Hills,102801,1992,676141,758,523355,1199496,03/14/2019
2013,Germantown,103602,927,384723,361,305085,689808,03/14/2019
2013,Chatham,103801,1795,815455,578,526560,1342015,03/14/2019
2013,Kinderhook,104401,2923,1434267,827,836277,2270544,03/14/2019
2013,New Lebanon,104801,847,335451,277,220684,556135,03/14/2019
2013,Cortland,110200,3167,1587991,1077,1119835,2707826,03/14/2019
2013,Cincinnatus,112001,735,355953,299,277246,633199,03/14/2019
2013,Mc Graw,112204,786,417770,246,255377,673147,03/14/2019
2013,Homer,113001,2758,1546502,809,928663,2475165,03/14/2019
2013,Marathon,113401,953,463882,327,307331,771213,03/14/2019
2013,Andes,122002,238,55865,163,72075,127940,03/14/2019
2013,Downsville,122401,385,105879,230,128394,234273,03/14/2019
2013,Charlotte Valley,122601,573,201034,265,183988,385022,03/14/2019
2013,Delhi,122801,1316,507048,533,429411,936459,03/14/2019
2013,Franklin,123201,441,164472,174,134595,299067,03/14/2019
2013,Hancock,123606,468,192420,231,188166,380586,03/14/2019
2013,Margaretville,124601,654,156971,355,175453,332424,03/14/2019
2013,Roxbury,124802,499,190889,260,201246,392135,03/14/2019
2013,Sidney,125001,1370,627169,683,626588,1253757,03/14/2019
2013,Stamford,125201,512,235995,245,229093,465088,03/14/2019
2013,South Kortright,125202,519,214312,272,225128,439440,03/14/2019
2013,Walton,125601,1262,458494,533,390777,849271,03/14/2019
2013,Beacon,130200,3648,2572594,846,1262527,3835121,03/14/2019
2013,Poughkeepsie,131300,3004,1778424,861,1052337,2830761,03/14/2019
2013,Dover,132602,1644,1512588,331,649636,2162224,03/14/2019
2013,Hyde Park,133201,5605,4988756,1587,2756221,7744977,03/14/2019
2013,Northeast,133801,945,513009,304,342841,855850,03/14/2019
2013,Pawling,134001,1890,1613155,357,638212,2251367,03/14/2019
2013,Pine Plains,134201,1809,888239,575,581864,1470103,03/14/2019
2013,Arlington,134601,11548,11282629,1998,3963225,15245854,03/14/2019
2013,Spackenkill,134602,1808,1705882,416,763787,2469669,03/14/2019
2013,Red Hook,134801,2367,2052813,660,1192089,3244902,03/14/2019
2013,Rhinebeck,135001,1779,1208021,578,819962,2027983,03/14/2019
2013,Wappingers,135601,15977,10482624,3415,4530463,15013087,03/14/2019
2013,Millbrook,135801,1527,870247,330,393958,1264205,03/14/2019
2013,Buffalo,140200,30322,10730547,7839,4165998,14896545,03/14/2019
2013,Lackawanna,140900,2533,826093,1204,645034,1471127,03/14/2019
2013,Tonawanda,141600,3296,1711195,1257,1329284,3040479,03/14/2019
2013,Alden,142001,2688,1557172,925,1078835,2636007,03/14/2019
2013,Amherst,142201,5472,3379911,1375,1747861,5127772,03/14/2019
2013,Williamsville,142203,16324,8987226,4010,4446460,13433686,03/14/2019
2013,Sweet Home,142207,5234,2203237,2132,1887936,4091173,03/14/2019
2013,East Aurora,142401,3026,1328666,886,811961,2140627,03/14/2019
2013,Cheektowaga,143001,3950,2042027,1624,1589353,3631380,03/14/2019
2013,Cheektowaga-Maryvale,143002,3898,2144729,1831,2066924,4211653,03/14/2019
2013,Cleveland Hill,143003,2672,2207896,820,1380273,3588169,03/14/2019
2013,Depew,143007,3230,2002038,1334,1719689,3721727,03/14/2019
2013,Cheektowaga-Sloan,143009,2539,2255507,1186,2153852,4409359,03/14/2019
2013,Clarence,143201,6345,2711476,1597,1311823,4023299,03/14/2019
2013,Springville-Griffith,143801,2993,1521442,905,906794,2428236,03/14/2019
2013,Eden,144001,2442,1354567,738,858773,2213340,03/14/2019
2013,Iroquois,144201,4239,2075444,1371,1389269,3464713,03/14/2019
2013,Evans-Brant,144401,3872,2101581,1205,1179219,3280800,03/14/2019
2013,Grand Island,144601,5058,2866191,1150,1355543,4221734,03/14/2019
2013,Hamburg,144801,5654,3137172,1607,1860233,4997405,03/14/2019
2013,Frontier,144804,8291,3754878,2384,2142354,5897232,03/14/2019
2013,Holland,145001,1664,680784,440,374449,1055233,03/14/2019
2013,Lancaster,145201,9840,4567923,2827,2646138,7214061,03/14/2019
2013,Akron,145601,1916,963774,708,647139,1610913,03/14/2019
2013,North Collins,145801,969,589800,301,365389,955189,03/14/2019
2013,Orchard Park,146001,7614,3999437,1887,2071601,6071038,03/14/2019
2013,Kenmore,146401,14798,8618826,5748,7014517,15633343,03/14/2019
2013,West Seneca,146801,11882,6025789,4652,4776486,10802275,03/14/2019
2013,Crown Point,152203,410,133866,165,103059,236925,03/14/2019
2013,Elizabethtown-Lewis,152401,512,196645,202,153463,350108,03/14/2019
2013,Keene,153001,265,65478,79,41028,106506,03/14/2019
2013,Minerva,153401,200,60209,111,64768,124977,03/14/2019
2013,Moriah,153601,951,495251,464,441480,936731,03/14/2019
2013,Newcomb,153801,114,8079,62,8424,16503,03/14/2019
2013,Lake Placid,154002,983,198721,352,146202,344923,03/14/2019
2013,Schroon Lake,154601,465,104997,228,103588,208585,03/14/2019
2013,Ticonderoga,154801,1098,295893,504,262693,558586,03/14/2019
2013,Westport,155001,269,109029,161,124905,233934,03/14/2019
2013,Willsboro,155201,514,165295,273,170547,335842,03/14/2019
2013,Tupper Lake,162001,1224,433771,438,293580,727351,03/14/2019
2013,Chateaugay,163401,728,300865,258,204548,505413,03/14/2019
2013,Salmon River,164201,792,273279,329,211602,484881,03/14/2019
2013,Saranac Lake,164601,2171,579814,625,336872,916686,03/14/2019
2013,Malone,164801,3078,1378859,1123,936349,2315208,03/14/2019
2013,Brushton-Moira,165001,1018,497489,371,348774,846263,03/14/2019
2013,St. Regis Falls,165401,487,241879,189,173865,415744,03/14/2019
2013,Gloversville,170500,3030,1872976,1295,1384378,3257354,03/14/2019
2013,Johnstown,170800,2162,984545,766,675995,1660540,03/14/2019
2013,Broadalbin-Perth,172201,2323,1166463,810,804321,1970784,03/14/2019
2013,Wheelerville,172401,344,81391,138,65065,146456,03/14/2019
2013,Mayfield,173001,1346,638703,521,478063,1116766,03/14/2019
2013,Northville,173201,604,184277,275,173492,357769,03/14/2019
2013,Batavia,180200,3112,2072112,1106,1480352,3552464,03/14/2019
2013,Alexander,182202,1179,775744,385,519408,1295152,03/14/2019
2013,Byron-Bergen,183001,1533,1128146,499,677011,1805157,03/14/2019
2013,Elba,183401,581,355018,205,256688,611706,03/14/2019
2013,Le Roy,183601,1684,1200877,590,835865,2036742,03/14/2019
2013,Oakfield-Alabama,183801,1130,758945,373,500446,1259391,03/14/2019
2013,Pavilion,184001,1111,722304,329,423835,1146139,03/14/2019
2013,Pembroke,184202,1481,879261,526,619317,1498578,03/14/2019
2013,Cairo-Durham,192401,1725,648465,783,588417,1236882,03/14/2019
2013,Catskill,192601,2126,991193,731,687453,1678646,03/14/2019
2013,Coxsackie-Athens,192801,1989,886509,620,558761,1445270,03/14/2019
2013,Greenville,193201,1940,997536,660,685726,1683262,03/14/2019
2013,Hunter-Tannersville,193601,654,192809,297,174210,367019,03/14/2019
2013,Windham-Ashland-Jewett,194601,533,117607,263,120404,238011,03/14/2019
2013,Piseco,202001,86,5744,44,6082,11826,03/14/2019
2013,Indian Lake,202601,306,59444,173,68659,128103,03/14/2019
2013,Inlet,202801,84,9886,47,11628,21514,03/14/2019
2013,Lake Pleasant,203001,181,41833,99,47770,89603,03/14/2019
2013,Long Lake,203201,144,16047,100,22882,38929,03/14/2019
2013,Raquette Lake,203202,20,232,15,368,600,03/14/2019
2013,Wells,203601,207,57077,112,64119,121196,03/14/2019
2013,Little Falls,210900,1287,989218,568,805571,1794789,03/14/2019
2013,West Canada Valley,212402,1080,531858,328,326007,857865,03/14/2019
2013,Frankfort-Schuyler,212602,1381,853256,583,715917,1569173,03/14/2019
2013,Central Valley,212803,2632,1356172,1013,1026470,2382642,03/14/2019
2013,Herkimer,213001,1442,860586,737,837816,1698402,03/14/2019
2013,Dolgeville,213602,1069,414808,421,307671,722479,03/14/2019
2013,Poland,213803,979,360621,330,242416,603037,03/14/2019
2013,Van Hornesville-Owen D. Young,215001,306,149807,125,120677,270484,03/14/2019
2013,Town Of Webb,215401,486,39892,304,52033,91925,03/14/2019
2013,Mount Markham,215601,1530,834045,505,534044,1368089,03/14/2019
2013,Watertown,221800,3879,1070666,1154,651549,1722215,03/14/2019
2013,South Jefferson,222001,2334,761626,594,379550,1141176,03/14/2019
2013,Alexandria,222202,871,253387,302,177202,430589,03/14/2019
2013,Indian River,222401,1881,259369,467,126024,385393,03/14/2019
2013,General Brown,222601,1971,512294,542,284832,797126,03/14/2019
2013,Thousand Islands,223201,1525,457704,593,363063,820767,03/14/2019
2013,Belleville-Henderson,223402,723,169109,303,141359,310468,03/14/2019
2013,Sackets Harbor,223801,637,221174,170,121788,342962,03/14/2019
2013,Lyme,224401,576,162234,243,140105,302339,03/14/2019
2013,La Fargeville,224601,650,160753,173,87151,247904,03/14/2019
2013,Carthage,226001,2593,890237,725,496208,1386445,03/14/2019
2013,Copenhagen,232201,605,162339,165,88075,250414,03/14/2019
2013,Harrisville,232401,533,265513,231,208452,473965,03/14/2019
2013,Lowville,233601,1670,384183,503,231304,615487,03/14/2019
2013,South Lewis,234001,1504,581774,565,412340,994114,03/14/2019
2013,Beaver River,234401,1252,393930,403,257207,651137,03/14/2019
2013,Avon,242001,1313,953586,360,511181,1464767,03/14/2019
2013,Caledonia-Mumford,242201,1319,754991,410,474596,1229587,03/14/2019
2013,Geneseo,242601,1368,654303,357,352173,1006476,03/14/2019
2013,Livonia,243401,2588,1546566,649,778089,2324655,03/14/2019
2013,Mount Morris,243601,627,476787,227,322776,799563,03/14/2019
2013,Dansville,243801,2102,1059991,774,744338,1804329,03/14/2019
2013,Dalton-Nunda,244001,1124,672724,392,433150,1105874,03/14/2019
2013,York,245201,1136,718180,343,422282,1140462,03/14/2019
2013,Oneida,251200,2787,1675827,1035,1256814,2932641,03/14/2019
2013,Brookfield,252009,304,125947,106,86057,212004,03/14/2019
2013,Cazenovia,252201,2220,1060062,551,539545,1599607,03/14/2019
2013,De Ruyter,252401,565,295187,172,176047,471234,03/14/2019
2013,Morrisville-Eaton,252601,1034,470794,294,259183,729977,03/14/2019
2013,Hamilton,253201,925,450776,243,238309,689085,03/14/2019
2013,Canastota,253601,1928,1254792,773,1003630,2258422,03/14/2019
2013,Madison,254001,611,350174,223,243652,593826,03/14/2019
2013,Stockbridge Valley,254601,610,338994,185,201716,540710,03/14/2019
2013,Chittenango,254801,3121,2061699,991,1261329,3323028,03/14/2019
2013,Rochester,261400,25371,10087254,4580,3108429,13195683,03/14/2019
2013,Brighton,262001,5172,3903025,957,1467872,5370897,03/14/2019
2013,Gates-Chili,262601,7776,5807187,2902,4302632,10109819,03/14/2019
2013,Greece,262801,18174,12642685,5538,7903226,20545911,03/14/2019
2013,East Irondequoit,263401,6625,5534774,2314,3908288,9443062,03/14/2019
2013,West Irondequoit,263403,6237,4953680,1959,3258485,8212165,03/14/2019
2013,Honeoye Falls-Lima,263601,3209,2178226,622,864068,3042294,03/14/2019
2013,Spencerport,263801,5422,3897904,1485,2202825,6100729,03/14/2019
2013,Hilton,264001,6469,4471333,1824,2566261,7037594,03/14/2019
2013,Penfield,264201,7829,5808493,1800,2725763,8534256,03/14/2019
2013,Fairport,264401,9516,6076378,2573,3354285,9430663,03/14/2019
2013,East Rochester,264413,1792,1324329,625,857202,2181531,03/14/2019
2013,Pittsford,264601,7991,5884361,1252,1918503,7802864,03/14/2019
2013,Churchville-Chili,264801,5839,4036064,1630,2302419,6338483,03/14/2019
2013,Rush-Henrietta,265001,8998,5213163,2440,2880844,8094007,03/14/2019
2013,Brockport,265201,4881,3697906,1085,1593204,5291110,03/14/2019
2013,Webster,265401,13077,8057648,3658,4661621,12719269,03/14/2019
2013,Wheatland-Chili,265601,1338,913222,384,508884,1422106,03/14/2019
2013,Amsterdam,270100,4090,2208156,1832,1976240,4184396,03/14/2019
2013,Canajoharie,272201,1261,679516,480,516660,1196176,03/14/2019
2013,Fonda-Fultonville,272801,1997,929384,596,550132,1479516,03/14/2019
2013,Fort Plain,273001,975,748920,404,593867,1342787,03/14/2019
2013,Oppenheim-Ephratah-St.Johnsvil,273803,1220,604200,474,436114,1040314,03/14/2019
2013,Glen Cove,280500,3387,3127207,1201,2202441,5329648,03/14/2019
2013,Long Beach,281000,7284,5588952,1160,1701495,7290447,03/14/2019
2013,Hempstead,282001,3313,4490811,451,1219483,5710294,03/14/2019
2013,Uniondale,282002,5717,5274908,859,1600617,6875525,03/14/2019
2013,East Meadow,282003,11443,15044377,2841,6341398,21385775,03/14/2019
2013,North Bellmore,282004,6062,8499565,1133,3221811,11721376,03/14/2019
2013,Levittown,282005,11154,18779105,2323,7957114,26736219,03/14/2019
2013,Seaford,282006,3963,5254713,801,2033666,7288379,03/14/2019
2013,Bellmore,282007,3063,4113100,488,1347675,5460775,03/14/2019
2013,Roosevelt,282008,2481,2941949,367,861676,3803625,03/14/2019
2013,Freeport,282009,6299,8067554,1031,2541298,10608852,03/14/2019
2013,Baldwin,282010,7422,10961325,1081,3109599,14070924,03/14/2019
2013,Oceanside,282011,8817,10531551,1577,3657153,14188704,03/14/2019
2013,Malverne,282012,3211,4694872,562,1690340,6385212,03/14/2019
2013,Valley Stream 13,282013,6313,8201706,1327,3369896,11571602,03/14/2019
2013,Hewlett-Woodmere,282014,4489,7249035,628,2054490,9303525,03/14/2019
2013,Lawrence,282015,5961,4478264,798,1199619,5677883,03/14/2019
2013,Elmont,282016,8664,10165224,1422,3413882,13579106,03/14/2019
2013,Franklin Square,282017,5194,5584107,1289,2854759,8438866,03/14/2019
2013,Garden City,282018,5097,4308680,611,1050667,5359347,03/14/2019
2013,East Rockaway,282019,2098,2883380,501,1361721,4245101,03/14/2019
2013,Lynbrook,282020,3840,5259571,727,1990950,7250521,03/14/2019
2013,Rockville Centre,282021,4767,5848337,668,1613546,7461883,03/14/2019
2013,Floral Park-Bellerose,282022,4349,4569298,814,1709367,6278665,03/14/2019
2013,Wantagh,282023,4361,6155001,702,2034106,8189107,03/14/2019
2013,Valley Stream 24,282024,2659,3011436,468,1090760,4102196,03/14/2019
2013,Merrick,282025,4546,6362851,594,1715030,8077881,03/14/2019
2013,Island Trees,282026,3402,4291173,752,1942364,6233537,03/14/2019
2013,West Hempstead,282027,3681,4532053,642,1626273,6158326,03/14/2019
2013,North Merrick,282029,3397,4681445,619,1707062,6388507,03/14/2019
2013,Valley Stream 30,282030,3187,3560285,464,1066773,4627058,03/14/2019
2013,Island Park,282031,1608,1324784,315,533630,1858414,03/14/2019
2013,Westbury,282201,3409,5177763,622,1884776,7062539,03/14/2019
2013,East Williston,282202,1886,2196184,192,458571,2654755,03/14/2019
2013,Roslyn,282203,3793,4636039,327,813037,5449076,03/14/2019
2013,Port Washington,282204,5477,5036503,715,1346865,6383368,03/14/2019
2013,New Hyde Park-Garden City,282205,4872,5107136,1057,2285266,7392402,03/14/2019
2013,Manhasset,282206,3117,2188050,308,445605,2633655,03/14/2019
2013,Great Neck,282207,9114,6259473,1073,1482715,7742188,03/14/2019
2013,Herricks,282209,5990,7064411,929,2259694,9324105,03/14/2019
2013,Mineola,282210,4743,4940845,1045,2243228,7184073,03/14/2019
2013,Carle Place,282211,1933,2205271,410,963693,3168964,03/14/2019
2013,North Shore,282401,3643,3363391,508,969124,4332515,03/14/2019
2013,Syosset,282402,7663,10327543,1067,2380252,12707795,03/14/2019
2013,Locust Valley,282403,3107,2686999,412,735183,3422182,03/14/2019
2013,Plainview-Old Bethpage,282404,7295,10331933,1169,3416615,13748548,03/14/2019
2013,Oyster Bay-East Norwich,282406,2497,1845521,322,478077,2323598,03/14/2019
2013,Jericho,282415,2960,3253542,290,657964,3911506,03/14/2019
2013,Hicksville,282417,8063,7545703,1924,3576728,11122431,03/14/2019
2013,Plainedge,282418,4651,7473499,1020,3382693,10856192,03/14/2019
2013,Bethpage,282421,4242,4843280,1289,2208871,7052151,03/14/2019
2013,Farmingdale,282422,8814,12405594,1926,5548465,17954059,03/14/2019
2013,Massapequa,282423,11557,14391573,2316,5893579,20285152,03/14/2019
2013,Lockport,290900,6220,5043215,1851,2685403,7728618,03/14/2019
2013,Niagara Falls,291100,8083,4189841,3153,2915019,7104860,03/14/2019
2013,North Tonawanda,291200,6576,4052498,2410,3044208,7096706,03/14/2019
2013,Lewiston-Porter,292401,4045,2191381,1512,1707884,3899265,03/14/2019
2013,Newfane,292801,2304,1979288,818,1323606,3302894,03/14/2019
2013,Niagara-Wheatfield,293001,5338,2751965,1907,1926466,4678431,03/14/2019
2013,Starpoint,293201,4267,2833503,1075,1478816,4312319,03/14/2019
2013,Royalton-Hartland,293601,2056,1335736,645,848013,2183749,03/14/2019
2013,Barker,293801,1109,509419,367,340969,850388,03/14/2019
2013,Wilson,294201,1843,1310398,616,899334,2209732,03/14/2019
2013,Rome,301300,6273,3924527,2367,2839069,6763596,03/14/2019
2013,Utica,301600,7714,4313266,3191,3411640,7724906,03/14/2019
2013,Adirondack,302601,1902,799467,718,576471,1375938,03/14/2019
2013,Camden,303001,2725,1173327,983,797603,1970930,03/14/2019
2013,Clinton,304001,1926,1410517,644,924555,2335072,03/14/2019
2013,New Hartford,304801,3741,2478368,1179,1544656,4023024,03/14/2019
2013,New York Mills,304804,837,529837,417,543207,1073044,03/14/2019
2013,Sauquoit Valley,305002,1446,807206,427,479524,1286730,03/14/2019
2013,Remsen,305201,722,454012,247,310960,764972,03/14/2019
2013,Waterville,305401,1162,593857,369,363765,957622,03/14/2019
2013,Holland Patent,305801,2231,1290344,689,793374,2083718,03/14/2019
2013,Sherrill,306000,2674,1579101,960,1140676,2719777,03/14/2019
2013,Westmoreland,306801,1505,1097055,523,749038,1846093,03/14/2019
2013,Oriskany,307001,923,636174,336,469677,1105851,03/14/2019
2013,Whitesboro,307002,5155,3103075,1770,2207627,5310702,03/14/2019
2013,Syracuse,311500,16256,7292906,4056,3443937,10736843,03/14/2019
2013,West Genesee,312001,7644,4926310,2677,3487380,8413690,03/14/2019
2013,North Syracuse,312403,14405,9362996,3718,4647792,14010788,03/14/2019
2013,East Syracuse-Minoa,312601,4937,3655295,1852,2563825,6219120,03/14/2019
2013,Jamesville-Dewitt,312611,4074,2675922,804,1068052,3743974,03/14/2019
2013,Jordan-Elbridge,312801,1778,1464980,570,842850,2307830,03/14/2019
2013,Fabius-Pompey,313001,1156,889403,319,483040,1372443,03/14/2019
2013,Westhill,313201,2772,2218730,848,1372469,3591199,03/14/2019
2013,Solvay,313202,1851,1418184,853,1214835,2633019,03/14/2019
2013,La Fayette,313407,1079,582676,283,297814,880490,03/14/2019
2013,Baldwinsville,313601,8242,5649904,2036,2781277,8431181,03/14/2019
2013,Fayetteville-Manlius,313801,6011,4536967,1245,1927760,6464727,03/14/2019
2013,Marcellus,314001,2665,1777913,741,1011878,2789791,03/14/2019
2013,Onondaga,314201,1559,1309151,408,680428,1989579,03/14/2019
2013,Liverpool,314801,10633,7938719,3244,4756834,12695553,03/14/2019
2013,Lyncourt,314804,846,760468,400,625780,1386248,03/14/2019
2013,Skaneateles,315001,2051,841470,621,529958,1371428,03/14/2019
2013,Tully,315402,1356,747700,329,365061,1112761,03/14/2019
2013,Canandaigua,320200,4685,2596208,1259,1407083,4003291,03/14/2019
2013,Geneva,320500,2646,1685715,1024,1273973,2959688,03/14/2019
2013,East Bloomfield,322601,1360,978762,373,535454,1514216,03/14/2019
2013,Gorham-Middlesex,323201,2170,931079,712,608427,1539506,03/14/2019
2013,Manchester-Shortsville,323601,1142,960871,411,692207,1653078,03/14/2019
2013,Naples,323801,1331,573236,409,360754,933990,03/14/2019
2013,Phelps-Clifton Springs,324001,2303,1687454,654,958377,2645831,03/14/2019
2013,Honeoye,324201,1495,712040,461,443112,1155152,03/14/2019
2013,Victor,324801,5027,2537947,1066,1088616,3626563,03/14/2019
2013,Middletown,330900,5992,4879795,1292,2112883,6992678,03/14/2019
2013,Newburgh,331100,10010,8874837,2604,4547860,13422697,03/14/2019
2013,Port Jervis,331300,2748,2775065,926,1806632,4581697,03/14/2019
2013,Washingtonville,332002,5459,5048091,840,1633742,6681833,03/14/2019
2013,Chester,332201,1352,1134330,285,484517,1618847,03/14/2019
2013,Cornwall,332401,3565,3251235,579,1087467,4338702,03/14/2019
2013,Pine Bush,332601,6040,4478573,1191,1795974,6274547,03/14/2019
2013,Goshen,333001,3087,2494992,662,1126967,3621959,03/14/2019
2013,Highland Falls,333601,863,670906,229,360817,1031723,03/14/2019
2013,Minisink Valley,333801,4771,3624788,791,1239785,4864573,03/14/2019
2013,Monroe-Woodbury,334001,8330,8318691,1258,2612187,10930878,03/14/2019
2013,Kiryas Joel Village,334002,756,401289,54,52868,454157,03/14/2019
2013,Valley,334201,5111,4195601,1208,2031263,6226864,03/14/2019
2013,Tuxedo,335003,510,238880,86,84966,323846,03/14/2019
2013,Warwick Valley,335401,5187,4205502,927,1564762,5770264,03/14/2019
2013,Greenwood Lake,335411,1559,1410463,296,554802,1965265,03/14/2019
2013,Florida,335415,1126,1113864,263,539819,1653683,03/14/2019
2013,Albion,342001,2294,1186460,846,848514,2034974,03/14/2019
2013,Kendall,343007,1206,611912,386,396993,1008905,03/14/2019
2013,Holley,343204,1477,1186417,505,783993,1970410,03/14/2019
2013,Medina,343401,2022,1451740,825,1121413,2573153,03/14/2019
2013,Lyndonville,343801,938,510831,343,375841,886672,03/14/2019
2013,Fulton,350400,3706,2895486,1266,1811825,4707311,03/14/2019
2013,Oswego,351200,5196,2959844,1659,1770087,4729931,03/14/2019
2013,Altmar Parish-Williamstown,352002,1662,909665,498,517780,1427445,03/14/2019
2013,Hannibal,353001,1695,1195710,491,659173,1854883,03/14/2019
2013,Central Square,353201,5653,3141414,1518,1617717,4759131,03/14/2019
2013,Mexico,353401,2882,1508760,770,792450,2301210,03/14/2019
2013,Pulaski,355001,1186,700550,373,427917,1128467,03/14/2019
2013,Sandy Creek,355201,1201,527579,474,398581,926160,03/14/2019
2013,Phoenix,355401,2711,2276752,786,1291536,3568288,03/14/2019
2013,Oneonta,361200,2547,1375821,823,909057,2284878,03/14/2019
2013,Gilbertsville-Mt Upton,362202,631,205843,315,203877,409720,03/14/2019
2013,Cherry Valley-Springfield,362401,882,281250,388,247862,529112,03/14/2019
2013,Edmeston,362801,650,218075,209,142776,360851,03/14/2019
2013,Laurens,363401,554,253429,208,200791,454220,03/14/2019
2013,Schenevus,363601,546,256642,225,211366,468008,03/14/2019
2013,Milford,364001,597,268568,322,291842,560410,03/14/2019
2013,Morris,364201,574,262625,230,208280,470905,03/14/2019
2013,Otego-Unadilla,364801,1366,715084,545,563117,1278201,03/14/2019
2013,Cooperstown,365001,1251,378175,437,270294,648469,03/14/2019
2013,Richfield Springs,365601,815,240672,386,225804,466476,03/14/2019
2013,Worcester,366606,510,264103,269,281446,545549,03/14/2019
2013,Mahopac,372001,6118,7711374,1006,2626155,10337529,03/14/2019
2013,Carmel,372002,6743,8447198,1121,2886247,11333445,03/14/2019
2013,Haldane,372601,1097,970212,253,425805,1396017,03/14/2019
2013,Garrison,372604,496,248539,86,90939,339478,03/14/2019
2013,Putnam Valley,372803,2714,4050809,399,1215673,5266482,03/14/2019
2013,Brewster,373001,4814,5274872,912,2131570,7406442,03/14/2019
2013,Rensselaer,381400,1359,647336,374,336034,983370,03/14/2019
2013,Troy,381700,4164,2347378,1191,1341380,3688758,03/14/2019
2013,Lansingburgh,381701,2624,1280205,880,849990,2130195,03/14/2019
2013,Berlin,382001,1543,666030,437,374472,1040502,03/14/2019
2013,Brunswick,382202,1828,944189,563,573755,1517944,03/14/2019
2013,East Greenbush,382401,6870,3508236,1645,1728611,5236847,03/14/2019
2013,Hoosick Falls,382801,1633,841908,539,544026,1385934,03/14/2019
2013,North Greenbush,383201,378,74480,124,51201,125681,03/14/2019
2013,Wynantskill,383204,885,529529,270,336272,865801,03/14/2019
2013,Averill Park,384001,4784,2327723,1028,1039396,3367119,03/14/2019
2013,Hoosic Valley,384201,1576,799684,421,434210,1233894,03/14/2019
2013,Schodack,384401,1496,891000,335,412615,1303615,03/14/2019
2013,Clarkstown,392001,11271,11101834,1996,4123291,15225125,03/14/2019
2013,Nanuet,392008,2427,2532730,588,1254377,3787107,03/14/2019
2013,Haverstraw-Stony Point,392201,8386,14142530,2002,6498767,20641297,03/14/2019
2013,South Orangetown,392401,4334,4986207,962,2328316,7314523,03/14/2019
2013,Nyack,392404,4104,5601450,794,2309774,7911224,03/14/2019
2013,Pearl River,392408,3238,4046693,721,1890873,5937566,03/14/2019
2013,Ramapo,392601,5560,9393017,1241,4015924,13408941,03/14/2019
2013,East Ramapo,392602,11618,12921686,1853,3916953,16838639,03/14/2019
2013,Ogdensburg,401200,2061,1510992,719,854950,2365942,03/14/2019
2013,Brasher Falls,402001,1346,853643,475,561648,1415291,03/14/2019
2013,Canton,402201,1774,997584,518,563927,1561511,03/14/2019
2013,Clifton-Fine,402601,486,158516,237,131544,290060,03/14/2019
2013,Colton-Pierrepont,402801,618,256474,264,205182,461656,03/14/2019
2013,Edwards-Knox,403401,716,220508,244,139507,360015,03/14/2019
2013,Gouverneur,404001,1929,695388,629,421101,1116489,03/14/2019
2013,Hammond,404201,402,152825,170,127096,279921,03/14/2019
2013,Hermon-Dekalb,404401,529,282291,219,210355,492646,03/14/2019
2013,Lisbon,405002,818,427407,265,269295,696702,03/14/2019
2013,Madrid-Waddington,405601,951,480109,397,385014,865123,03/14/2019
2013,Massena,405801,3379,1750626,1324,1293036,3043662,03/14/2019
2013,Morristown,406001,624,265113,258,219274,484387,03/14/2019
2013,Norwood-Norfolk,406201,1418,1028815,545,742961,1771776,03/14/2019
2013,Heuvelton,406404,876,514223,294,335200,849423,03/14/2019
2013,Parishville-Hopkinton,406601,639,239004,220,156071,395075,03/14/2019
2013,Potsdam,407402,1913,1321599,512,679003,2000602,03/14/2019
2013,Mechanicville,411000,1671,966509,520,632930,1599439,03/14/2019
2013,Saratoga Springs,411500,9488,4413903,1768,1680069,6093972,03/14/2019
2013,Burnt Hills-Ballston Lake,412001,4915,3165418,1303,1749673,4915091,03/14/2019
2013,Shenendehowa,412402,14466,9730871,2409,3337890,13068761,03/14/2019
2013,Corinth,412601,1545,675906,548,449080,1124986,03/14/2019
2013,Edinburg,413001,335,57750,162,54543,112293,03/14/2019
2013,Galway,413201,1648,794044,482,451866,1245910,03/14/2019
2013,Ballston Spa,414201,5499,4168724,1217,1732980,5901704,03/14/2019
2013,South Glens Falls,414401,3968,2448324,1165,1423719,3872043,03/14/2019
2013,Schuylerville,415001,2390,1789821,518,751640,2541461,03/14/2019
2013,Stillwater,415201,1723,815492,426,401485,1216977,03/14/2019
2013,Waterford-Halfmoon,415401,991,834700,379,600548,1435248,03/14/2019
2013,Schenectady,421500,8134,5243075,2523,3089649,8332724,03/14/2019
2013,Duanesburg,422001,1313,624035,290,280804,904839,03/14/2019
2013,Scotia-Glenville,422202,4168,2292295,1145,1309916,3602211,03/14/2019
2013,Niskayuna,422401,6079,3234041,1009,1131897,4365938,03/14/2019
2013,Schalmont,422801,3336,1772255,996,1109730,2881985,03/14/2019
2013,Rotterdam-Mohonasen,422803,4856,2235955,1840,1774783,4010738,03/14/2019
2013,Cobleskill-Richmondville,432602,2412,1287695,906,923819,2211514,03/14/2019
2013,Gilboa-Conesville,433401,516,176188,285,184977,361165,03/14/2019
2013,Jefferson,433601,430,172862,168,130602,303464,03/14/2019
2013,Middleburgh,433801,1230,715823,515,565360,1281183,03/14/2019
2013,Schoharie,434201,1483,898064,492,595038,1493102,03/14/2019
2013,Sharon Springs,434601,402,237783,173,199244,437027,03/14/2019
2013,Odessa-Montour,442001,1214,598757,435,428080,1026837,03/14/2019
2013,Watkins Glen,442401,1771,629610,716,507093,1136703,03/14/2019
2013,South Seneca,452801,1370,647221,501,453852,1101073,03/14/2019
2013,Romulus,453003,698,395873,240,271055,666928,03/14/2019
2013,Seneca Falls,453201,1908,1352031,716,1008033,2360064,03/14/2019
2013,Waterloo,453801,2277,1445438,788,986164,2431602,03/14/2019
2013,Corning,460300,7061,5227705,2156,3052959,8280664,03/14/2019
2013,Hornell,460600,1796,938514,648,618148,1556662,03/14/2019
2013,Addison,462001,1482,909751,498,544076,1453827,03/14/2019
2013,Avoca,462201,770,310223,284,212565,522788,03/14/2019
2013,Bath,462402,1806,981868,658,708305,1690173,03/14/2019
2013,Bradford,462601,459,230215,165,162266,392481,03/14/2019
2013,Campbell-Savona,463002,1174,702182,429,497979,1200161,03/14/2019
2013,Canisteo-Greenwood,463202,1258,638301,542,501764,1140065,03/14/2019
2013,Arkport,465201,644,394583,317,335245,729828,03/14/2019
2013,Jasper-Troupsburg,465601,637,252426,235,181392,433818,03/14/2019
2013,Prattsburgh,466001,658,280529,211,170744,451273,03/14/2019
2013,Hammondsport,467201,1009,288889,413,239467,528356,03/14/2019
2013,Wayland-Cohocton,467401,2025,962174,683,605786,1567960,03/14/2019
2013,Babylon,472001,2551,3299758,416,1100655,4400413,03/14/2019
2013,West Babylon,472002,5242,6201272,1144,2792309,8993581,03/14/2019
2013,North Babylon,472003,6303,7171478,1512,3578761,10750239,03/14/2019
2013,Lindenhurst,472004,8211,10310198,1820,4711375,15021573,03/14/2019
2013,Copiague,472005,4940,5770458,1203,2762521,8532979,03/14/2019
2013,Amityville,472006,4326,5059954,1135,2044216,7104170,03/14/2019
2013,Deer Park,472007,5085,6006666,1421,3468360,9475026,03/14/2019
2013,Wyandanch,472009,1152,1440770,211,532885,1973655,03/14/2019
2013,Three Village,472201,8971,9815057,1524,3441506,13256563,03/14/2019
2013,Brookhaven-Comsewogue,472203,4440,4709346,936,1993221,6702567,03/14/2019
2013,South Country,472204,5076,5045258,756,1548339,6593597,03/14/2019
2013,Sachem,472205,17022,15022710,2915,5267372,20290082,03/14/2019
2013,Port Jefferson,472206,1502,931148,236,306791,1237939,03/14/2019
2013,Mount Sinai,472207,3124,3547004,603,1423427,4970431,03/14/2019
2013,Miller Place,472208,3716,4209309,433,1015430,5224739,03/14/2019
2013,Rocky Point,472209,4065,5021521,494,1256433,6277954,03/14/2019
2013,Middle Country,472211,12009,13118410,2466,5544540,18662950,03/14/2019
2013,Longwood,472212,12304,14053462,3290,6913588,20967050,03/14/2019
2013,Patchogue-Medford,472224,9585,10590281,1690,3683473,14273754,03/14/2019
2013,William Floyd,472232,9476,11324999,1429,3379404,14704403,03/14/2019
2013,Center Moriches,472233,1724,2070405,259,636925,2707330,03/14/2019
2013,East Moriches,472234,1316,1537088,187,455043,1992131,03/14/2019
2013,Eastport- South Manor,472235,4175,4706920,899,1837820,6544740,03/14/2019
2013,East Hampton,472401,1066,229024,341,151479,380503,03/14/2019
2013,Wainscott,472402,93,7373,23,3838,11211,03/14/2019
2013,Amagansett,472403,189,23620,89,23252,46872,03/14/2019
2013,Springs,472404,894,347698,289,237140,584838,03/14/2019
2013,Sag Harbor,472405,1145,338399,441,274379,612778,03/14/2019
2013,Montauk,472406,622,115083,216,108662,223745,03/14/2019
2013,Elwood,472601,3051,3499108,604,1447644,4946752,03/14/2019
2013,Cold Spring Harbor,472602,1490,1473501,114,238573,1712074,03/14/2019
2013,Huntington,472603,7093,7768892,1224,2736489,10505381,03/14/2019
2013,Northport-East Northport,472604,8553,7287075,1480,2633564,9920639,03/14/2019
2013,Half Hollow Hills,472605,10099,9226139,1982,3553896,12780035,03/14/2019
2013,Harborfields,472606,4385,4968304,710,1680073,6648377,03/14/2019
2013,Commack,472610,8887,10856035,1844,4749483,15605518,03/14/2019
2013,South Huntington,472613,8305,9468717,1727,4103992,13572709,03/14/2019
2013,Bay Shore,472801,5679,6626363,1138,2708165,9334528,03/14/2019
2013,Islip,472802,3837,4789871,740,1761756,6551627,03/14/2019
2013,East Islip,472803,5347,6038832,1164,2987455,9026287,03/14/2019
2013,Sayville,472804,4003,4535292,875,2065540,6600832,03/14/2019
2013,Bayport-Blue Point,472805,3034,3908007,508,1379797,5287804,03/14/2019
2013,Hauppauge,472806,4965,3350168,1063,1506812,4856980,03/14/2019
2013,Connetquot,472807,8468,9195322,1836,3975450,13170772,03/14/2019
2013,West Islip,472809,6420,6814538,1339,2994445,9808983,03/14/2019
2013,Brentwood,472812,9925,7544178,2088,3328446,10872624,03/14/2019
2013,Central Islip,472813,5730,7625232,1091,2951294,10576526,03/14/2019
2013,Fire Island,472814,99,10779,20,4416,15195,03/14/2019
2013,Shoreham-Wading River,473001,3156,3180245,719,1432178,4612423,03/14/2019
2013,Riverhead,473002,6494,5037927,2663,3624155,8662082,03/14/2019
2013,Shelter Island,473201,535,91841,223,80707,172548,03/14/2019
2013,Smithtown,473401,13155,14282434,2598,5610925,19893359,03/14/2019
2013,Kings Park,473405,5202,5286464,984,2090712,7377176,03/14/2019
2013,Remsenburg-Speonk,473601,397,121163,80,51590,172753,03/14/2019
2013,Westhampton Beach,473602,931,320574,245,171931,492505,03/14/2019
2013,Quogue,473603,184,21119,47,11442,32561,03/14/2019
2013,Hampton Bays,473605,2087,1454459,734,1071054,2525513,03/14/2019
2013,Southhampton,473606,1448,197751,477,136446,334197,03/14/2019
2013,Bridgehampton,473609,221,19286,72,13257,32543,03/14/2019
2013,Sagaponack,473610,47,1037,6,279,1316,03/14/2019
2013,Tuckahoe Common,473613,458,186964,168,143493,330457,03/14/2019
2013,East Quogue,473617,1058,629535,292,352104,981639,03/14/2019
2013,Oysterponds,473802,352,82439,166,81942,164381,03/14/2019
2013,Fishers Island,473804,29,6931,5,2519,9450,03/14/2019
2013,Southold,473805,1432,725400,543,585692,1311092,03/14/2019
2013,Greenport,473810,580,315751,288,330305,646056,03/14/2019
2013,Mattituck-Cutchogue,473812,2052,1114580,644,735605,1850185,03/14/2019
2013,New Suffolk,473815,74,13775,36,14061,27836,03/14/2019
2013,Fallsburg,482801,1230,811039,333,415661,1226700,03/14/2019
2013,Eldred,483401,1075,407323,377,291278,698601,03/14/2019
2013,Liberty,483601,1300,852633,563,755993,1608626,03/14/2019
2013,Tri-Valley,484201,1245,641671,360,362176,1003847,03/14/2019
2013,Roscoe,484401,370,147674,176,145159,292833,03/14/2019
2013,Livingston Manor,484402,580,230333,249,194221,424554,03/14/2019
2013,Monticello,484601,3065,1407989,1048,974482,2382471,03/14/2019
2013,Sullivan West,484802,2101,781269,887,672190,1453459,03/14/2019
2013,Waverly,492001,1821,808971,684,593819,1402790,03/14/2019
2013,Candor,492401,1006,545921,396,404646,950567,03/14/2019
2013,Newark Valley,492602,1714,943067,561,625740,1568807,03/14/2019
2013,Owego-Apalachin,493001,2856,1606316,1012,1119635,2725951,03/14/2019
2013,Spencer-Van Etten,493401,1277,561298,488,420777,982075,03/14/2019
2013,Tioga,493603,1119,309986,406,223797,533783,03/14/2019
2013,Ithaca,500700,8118,4217321,1684,1644122,5861443,03/14/2019
2013,Dryden,502401,2453,1661470,653,790246,2451716,03/14/2019
2013,Groton,502801,1299,798553,382,447728,1246281,03/14/2019
2013,Lansing,503201,1729,1004017,358,415475,1419492,03/14/2019
2013,Newfield,503401,1047,563319,336,301526,864845,03/14/2019
2013,Trumansburg,503601,1703,975468,453,501946,1477414,03/14/2019
2013,Kingston,510800,8425,5461079,2883,3770903,9231982,03/14/2019
2013,Highland,513203,2354,1623361,584,814552,2437913,03/14/2019
2013,Rondout Valley,513401,3598,2106244,1049,1245290,3351534,03/14/2019
2013,Marlboro,513601,2431,1862763,595,915061,2777824,03/14/2019
2013,New Paltz,513801,3105,1933182,684,886905,2820087,03/14/2019
2013,Onteora,514001,3238,1254833,1323,1045051,2299884,03/14/2019
2013,Saugerties,514801,4255,2621370,1392,1769119,4390489,03/14/2019
2013,Wallkill,515201,3962,3239230,990,1395025,4634255,03/14/2019
2013,Ellenville,515602,1654,1115789,570,700350,1816139,03/14/2019
2013,Glens Falls,520500,2745,1390679,914,955677,2346356,03/14/2019
2013,Bolton,522001,373,53794,165,50702,104496,03/14/2019
2013,Lake George,522201,1377,247815,503,189687,437502,03/14/2019
2013,North Warren,522402,1002,193502,456,176490,369992,03/14/2019
2013,Johnsburg,523001,504,152434,260,164505,316939,03/14/2019
2013,Hadley-Luzerne,523201,1304,407810,576,366922,774732,03/14/2019
2013,Queensbury,523402,4413,1888178,1282,1102710,2990888,03/14/2019
2013,Glens Falls Common,523418,269,98283,80,57877,156160,03/14/2019
2013,Warrensburg,524001,1148,472580,507,422531,895111,03/14/2019
2013,Argyle,532001,885,396712,326,293494,690206,03/14/2019
2013,Fort Ann,532802,803,309961,251,201275,511236,03/14/2019
2013,Fort Edward,533001,535,254134,195,192553,446687,03/14/2019
2013,Granville,533201,1476,662609,553,486781,1149390,03/14/2019
2013,Greenwich,533401,1430,660750,498,477921,1138671,03/14/2019
2013,Hartford,533801,683,336219,235,235319,571538,03/14/2019
2013,Hudson Falls,534401,2592,998819,1008,794374,1793193,03/14/2019
2013,Putnam,534601,159,25449,67,21645,47094,03/14/2019
2013,Salem,534801,864,342677,347,276239,618916,03/14/2019
2013,Cambridge,535010,1337,541393,551,448387,989780,03/14/2019
2013,Whitehall,535201,903,264808,374,209357,474165,03/14/2019
2013,Newark,542001,2810,1734125,955,1153309,2887434,03/14/2019
2013,Clyde-Savannah,542401,1112,793112,412,551493,1344605,03/14/2019
2013,Lyons,542801,1161,701916,432,478480,1180396,03/14/2019
2013,Gananda,543002,1447,1309739,172,322634,1632373,03/14/2019
2013,Marion,543201,1335,934679,364,510914,1445593,03/14/2019
2013,Wayne,543401,3599,2242368,919,1184250,3426618,03/14/2019
2013,Palmyra-Macedon,543601,2542,1922019,850,1273945,3195964,03/14/2019
2013,Sodus,544201,1464,888011,590,675064,1563075,03/14/2019
2013,Williamson,544602,1507,1093044,478,737414,1830458,03/14/2019
2013,North Rose-Wolcott,544801,1752,790532,724,646536,1437068,03/14/2019
2013,Red Creek,544803,1157,482792,422,346402,829194,03/14/2019
2013,Mount Vernon,550800,5316,14525500,1126,5100509,19626009,03/14/2019
2013,New Rochelle,551000,8655,16670122,1481,5411322,22081444,03/14/2019
2013,Peekskill,551200,3357,6871892,647,2244475,9116367,03/14/2019
2013,Rye,551400,1870,2271248,278,699113,2970361,03/14/2019
2013,White Plains,551700,7099,14477453,1041,3604738,18082191,03/14/2019
2013,Yonkers,551800,17759,28131931,4199,10716336,38848267,03/14/2019
2013,Katonah-Lewisboro,552001,4381,7121252,533,1706520,8827772,03/14/2019
2013,Bedford,552002,4248,5059152,711,1638822,6697974,03/14/2019
2013,Croton-Harmon,552202,2144,3788141,289,983888,4772029,03/14/2019
2013,Hendrick Hudson,552203,3288,5142267,527,1491041,6633308,03/14/2019
2013,Eastchester,552401,2997,6744373,628,2513528,9257901,03/14/2019
2013,Tuckahoe,552402,1220,2250820,193,678862,2929682,03/14/2019
2013,Bronxville,552403,547,1359585,42,298960,1658545,03/14/2019
2013,Tarrytowns,552601,2316,4885793,487,1932517,6818310,03/14/2019
2013,Irvington,552602,1501,3205859,219,925509,4131368,03/14/2019
2013,Dobbs Ferry,552603,1313,3187883,210,992878,4180761,03/14/2019
2013,Hastings On Hudson,552604,1562,3947385,281,1354652,5302037,03/14/2019
2013,Ardsley,552605,2314,4387629,327,1288668,5676297,03/14/2019
2013,Edgemont,552606,1220,2914566,131,616502,3531068,03/14/2019
2013,Greenburgh,552607,3920,6609896,942,2664012,9273908,03/14/2019
2013,Elmsford,552609,1280,1960090,317,1000667,2960757,03/14/2019
2013,Harrison,552801,2727,2990279,629,1357082,4347361,03/14/2019
2013,Mamaroneck,553201,4037,6110113,537,1521855,7631968,03/14/2019
2013,Mount Pleasant,553401,2638,3757159,715,2035958,5793117,03/14/2019
2013,Pocantico Hills,553402,428,337036,89,138499,475535,03/14/2019
2013,Valhalla,553405,1771,2899316,421,1385283,4284599,03/14/2019
2013,Pleasantville,553409,1811,3400594,359,1236992,4637586,03/14/2019
2013,Chappaqua,553604,3064,5056834,258,869789,5926623,03/14/2019
2013,Byram Hills,553801,2138,2507723,223,544098,3051821,03/14/2019
2013,North Salem,554001,1660,2174258,288,740616,2914874,03/14/2019
2013,Ossining,554201,5692,11782611,827,3595321,15377932,03/14/2019
2013,Briarcliff Manor,554202,1410,2722743,104,426944,3149687,03/14/2019
2013,Pelham,554401,2085,3615221,337,1131645,4746866,03/14/2019
2013,Rye Neck,554801,1328,2049613,254,687098,2736711,03/14/2019
2013,Port Chester-Rye,554804,2879,4511839,846,2544826,7056665,03/14/2019
2013,Blind Brook-Rye,554805,1437,1985591,173,504413,2490004,03/14/2019
2013,Scarsdale,555001,2760,3690809,201,564503,4255312,03/14/2019
2013,Somers,555201,4817,7497332,1311,3723938,11221270,03/14/2019
2013,Lakeland,555401,8280,16635802,1874,6061662,22697464,03/14/2019
2013,Yorktown,555402,4899,9495890,724,2811313,12307203,03/14/2019
2013,Attica,562201,2301,1166161,671,705497,1871658,03/14/2019
2013,Letchworth,562601,1372,594831,414,347716,942547,03/14/2019
2013,Wyoming,563802,398,203439,129,133148,336587,03/14/2019
2013,Perry,564201,1176,584597,472,474734,1059331,03/14/2019
2013,Warsaw,564801,1357,882974,361,483443,1366417,03/14/2019
2013,Penn Yan,573001,2887,896234,1113,707697,1603931,03/14/2019
2013,Dundee,573401,1137,357329,478,291285,648614,03/14/2019
2013,New York City School,650000,566695,161293055,111917,63347458,224640513,03/14/2019
2012,Albany,010100,10467,6359344,3129,3693795,10053139,03/14/2019
2012,Cohoes,010300,2223,1278250,669,765379,2043629,03/14/2019
2012,Watervliet,011800,1301,526325,437,358227,884552,03/14/2019
2012,Berne-Knox-Westerlo,012001,1700,886752,415,427132,1313884,03/14/2019
2012,Bethlehem,012206,6856,4018658,1215,1467537,5486195,03/14/2019
2012,Ravena-Coeymans-Selkirk,012402,2923,1727728,779,920537,2648265,03/14/2019
2012,South Colonie,012601,9210,4652620,2600,2637114,7289734,03/14/2019
2012,North Colonie,012605,8049,3695814,1680,1568784,5264598,03/14/2019
2012,Menands,012615,392,193046,104,104507,297553,03/14/2019
2012,Green Island,012801,285,164282,120,142558,306840,03/14/2019
2012,Guilderland,013002,7541,3826401,1517,1583484,5409885,03/14/2019
2012,Voorheesville,013403,2011,1055733,396,429324,1485057,03/14/2019
2012,Alfred-Almond,022001,884,592164,290,363872,956036,03/14/2019
2012,Andover,023001,478,355391,184,241178,596569,03/14/2019
2012,Genesee Valley,023202,778,348133,351,275730,623863,03/14/2019
2012,Belfast,023401,467,225171,192,161837,387008,03/14/2019
2012,Canaseraga,024002,386,212015,144,139285,351300,03/14/2019
2012,Cuba-Rushford,024801,1397,603491,565,442157,1045648,03/14/2019
2012,Friendship,025001,396,272405,169,194052,466457,03/14/2019
2012,Fillmore,025801,807,309863,275,191153,501016,03/14/2019
2012,Whitesville,026001,237,133152,93,87655,220807,03/14/2019
2012,Scio,026601,482,320135,187,213924,534059,03/14/2019
2012,Wellsville,027001,1712,1230170,755,905248,2135418,03/14/2019
2012,Bolivar-Richburg,027602,1010,508068,377,311725,819793,03/14/2019
2012,Binghamton,030200,6149,3682881,2340,2619002,6301883,03/14/2019
2012,Chenango Forks,032001,2158,1376524,687,820479,2197003,03/14/2019
2012,South Mountain-Hickory,032201,140,20574,19,5789,26363,03/14/2019
2012,Harpursville,032601,1153,462348,353,260539,722887,03/14/2019
2012,Susquehanna Valley,032801,2495,1896960,855,1296255,3193215,03/14/2019
2012,Chenango Valley,033001,2672,2026720,1107,1700100,3726820,03/14/2019
2012,Maine-Endwell,033801,3607,2621188,1249,1768313,4389501,03/14/2019
2012,Deposit,034201,736,292979,318,257216,550195,03/14/2019
2012,Whitney Point,034401,1857,984167,585,604291,1588458,03/14/2019
2012,Union-Endicott,034601,5698,3776447,2301,3062150,6838597,03/14/2019
2012,Johnson City,034602,3256,2059181,1403,1696939,3756120,03/14/2019
2012,Vestal,034801,5743,3524468,1825,2278864,5803332,03/14/2019
2012,Windsor,035001,2232,1216721,714,759076,1975797,03/14/2019
2012,Olean,041200,2821,1861734,996,1090670,2952404,03/14/2019
2012,Salamanca,041600,984,505031,487,398869,903900,03/14/2019
2012,Allegany-Limestone,042001,1609,904867,614,571753,1476620,03/14/2019
2012,West Valley,042204,523,359979,187,252797,612776,03/14/2019
2012,Ellicottville,043601,699,160390,254,120208,280598,03/14/2019
2012,Franklinville,044001,982,534679,363,348522,883201,03/14/2019
2012,Hinsdale,044601,666,317941,234,201228,519169,03/14/2019
2012,Cattaraugus - Little Valley,046402,1532,706778,485,391078,1097856,03/14/2019
2012,Gowanda,047201,1520,667824,575,477462,1145286,03/14/2019
2012,Portville,047401,1140,715539,393,437812,1153351,03/14/2019
2012,Randolph,047601,1211,422710,463,290227,712937,03/14/2019
2012,Yorkshire-Pioneer,048401,3436,1324290,1055,767988,2092278,03/14/2019
2012,Auburn,050100,5497,2811179,2013,2040604,4851783,03/14/2019
2012,Weedsport,052201,1202,766134,350,437938,1204072,03/14/2019
2012,Cato-Meridian,052401,1420,759848,404,404661,1164509,03/14/2019
2012,Southern Cayuga,053001,1279,534183,375,308212,842395,03/14/2019
2012,Port Byron,053801,1333,861673,523,642380,1504053,03/14/2019
2012,Moravia,054201,1413,535023,415,304707,839730,03/14/2019
2012,Union Springs,055401,1289,589103,436,393139,982242,03/14/2019
2012,Dunkirk,060300,2320,1345217,1124,1115478,2460695,03/14/2019
2012,Jamestown,060800,4792,2751295,1768,1666966,4418261,03/14/2019
2012,Southwestern,062201,2211,1322741,801,920439,2243180,03/14/2019
2012,Frewsburg,062401,1090,776584,389,536507,1313091,03/14/2019
2012,Cassadaga Valley,062601,1514,731272,533,458580,1189852,03/14/2019
2012,Chautauqua Lake,062803,1207,292977,477,221579,514556,03/14/2019
2012,Pine Valley,063001,867,452535,333,323765,776300,03/14/2019
2012,Clymer,063201,632,256945,244,198248,455193,03/14/2019
2012,Bemus Point,063601,1147,464066,443,345567,809633,03/14/2019
2012,Falconer,063801,1549,880983,641,666002,1546985,03/14/2019
2012,Silver Creek,064601,1277,668488,483,472189,1140677,03/14/2019
2012,Forestville,064603,915,479565,331,330551,810116,03/14/2019
2012,Panama,064801,830,483416,267,287198,770614,03/14/2019
2012,Fredonia,065801,2213,1505612,740,1001233,2506845,03/14/2019
2012,Brocton,066001,795,634859,324,500357,1135216,03/14/2019
2012,Ripley,066201,452,385342,182,275166,660508,03/14/2019
2012,Sherman,066601,575,297013,177,170824,467837,03/14/2019
2012,Westfield,067201,1026,588672,428,457133,1045805,03/14/2019
2012,Elmira,070400,7802,4653510,2957,3229257,7882767,03/14/2019
2012,Horseheads,073401,5726,3154816,2071,2302338,5457154,03/14/2019
2012,Elmira Heights,073402,1301,844739,506,639855,1484594,03/14/2019
2012,Norwich,081100,2342,1219346,810,777552,1996898,03/14/2019
2012,Afton,082001,828,432810,358,364074,796884,03/14/2019
2012,Bainbridge-Guilford,082201,1167,610969,480,492320,1103289,03/14/2019
2012,Greene,083001,1442,702767,556,533587,1236354,03/14/2019
2012,Unadilla Valley,083803,1075,427393,411,313838,741231,03/14/2019
2012,Georgetown-So Otselic Valley,084401,567,286421,171,156164,442585,03/14/2019
2012,Oxford Academy,084601,1080,571565,429,421725,993290,03/14/2019
2012,Sherburne-Earlville,085601,1704,763958,621,532764,1296722,03/14/2019
2012,Plattsburgh,091300,2076,1336424,773,974794,2311218,03/14/2019
2012,Ausable Valley,092201,1981,924975,718,603132,1528107,03/14/2019
2012,Beekmantown,092401,2814,1360403,862,760363,2120766,03/14/2019
2012,Northeastern Clinton,092801,2025,1150199,636,683485,1833684,03/14/2019
2012,Chazy,093001,717,394806,221,237006,631812,03/14/2019
2012,Northern Adirondack,093601,1443,443610,435,240447,684057,03/14/2019
2012,Peru,094001,2763,1534610,668,697756,2232366,03/14/2019
2012,Saranac,094401,2484,1398018,682,743400,2141418,03/14/2019
2012,Hudson,100600,2082,1000192,869,776518,1776710,03/14/2019
2012,Taconic Hills,102801,2081,644301,754,561436,1205737,03/14/2019
2012,Germantown,103602,924,378756,363,298344,677100,03/14/2019
2012,Chatham,103801,1825,813724,567,497874,1311598,03/14/2019
2012,Kinderhook,104401,2954,1433745,804,790719,2224464,03/14/2019
2012,New Lebanon,104801,859,334647,275,213262,547909,03/14/2019
2012,Cortland,110200,3208,1587314,1071,1078266,2665580,03/14/2019
2012,Cincinnatus,112001,748,358585,294,263758,622343,03/14/2019
2012,Mc Graw,112204,790,416670,249,251879,668549,03/14/2019
2012,Homer,113001,2749,1522821,829,920925,2443746,03/14/2019
2012,Marathon,113401,969,473858,311,288479,762337,03/14/2019
2012,Andes,122002,248,62332,162,75816,138148,03/14/2019
2012,Downsville,122401,388,110422,232,131828,242250,03/14/2019
2012,Charlotte Valley,122601,586,203015,257,173558,376573,03/14/2019
2012,Delhi,122801,1325,509425,537,420006,929431,03/14/2019
2012,Franklin,123201,449,166256,169,124540,290796,03/14/2019
2012,Hancock,123606,480,193825,229,181744,375569,03/14/2019
2012,Margaretville,124601,685,163013,371,170594,333607,03/14/2019
2012,Roxbury,124802,545,206740,245,182835,389575,03/14/2019
2012,Sidney,125001,1416,649558,665,606139,1255697,03/14/2019
2012,Stamford,125201,528,241439,239,216871,458310,03/14/2019
2012,South Kortright,125202,530,217353,262,208250,425603,03/14/2019
2012,Walton,125601,1242,446763,563,399516,846279,03/14/2019
2012,Beacon,130200,3664,2543943,866,1251898,3795841,03/14/2019
2012,Poughkeepsie,131300,3041,1766171,845,1003816,2769987,03/14/2019
2012,Dover,132602,1664,1494308,334,637049,2131357,03/14/2019
2012,Hyde Park,133201,5650,4955420,1605,2728916,7684336,03/14/2019
2012,Northeast,133801,966,537311,314,355974,893285,03/14/2019
2012,Pawling,134001,1906,1602988,348,602137,2205125,03/14/2019
2012,Pine Plains,134201,1842,895443,575,564540,1459983,03/14/2019
2012,Arlington,134601,11611,11170022,2005,3858681,15028703,03/14/2019
2012,Spackenkill,134602,1826,1708102,421,747267,2455369,03/14/2019
2012,Red Hook,134801,2387,2085829,661,1176320,3262149,03/14/2019
2012,Rhinebeck,135001,1764,1213029,584,824660,2037689,03/14/2019
2012,Wappingers,135601,15971,10307649,3458,4427158,14734807,03/14/2019
2012,Millbrook,135801,1531,859710,346,400454,1260164,03/14/2019
2012,Buffalo,140200,30577,10876799,8195,4344932,15221731,03/14/2019
2012,Lackawanna,140900,2520,820300,1215,668498,1488798,03/14/2019
2012,Tonawanda,141600,3306,1692144,1304,1335772,3027916,03/14/2019
2012,Alden,142001,2713,1554063,913,1036920,2590983,03/14/2019
2012,Amherst,142201,5545,3376374,1401,1732062,5108436,03/14/2019
2012,Williamsville,142203,16348,8866662,4031,4339687,13206349,03/14/2019
2012,Sweet Home,142207,5266,2191367,2167,1866035,4057402,03/14/2019
2012,East Aurora,142401,3017,1318271,888,792852,2111123,03/14/2019
2012,Cheektowaga,143001,3972,2027898,1669,1584377,3612275,03/14/2019
2012,Cheektowaga-Maryvale,143002,3910,2125133,1897,2082117,4207250,03/14/2019
2012,Cleveland Hill,143003,2691,2192264,838,1366697,3558961,03/14/2019
2012,Depew,143007,3270,2002780,1341,1677135,3679915,03/14/2019
2012,Cheektowaga-Sloan,143009,2550,2238545,1205,2128771,4367316,03/14/2019
2012,Clarence,143201,6309,2654220,1610,1283641,3937861,03/14/2019
2012,Springville-Griffith,143801,3027,1523403,909,882023,2405426,03/14/2019
2012,Eden,144001,2435,1334161,746,842956,2177117,03/14/2019
2012,Iroquois,144201,4252,2070296,1365,1352929,3423225,03/14/2019
2012,Evans-Brant,144401,3945,2106911,1182,1119668,3226579,03/14/2019
2012,Grand Island,144601,5025,2820388,1170,1333913,4154301,03/14/2019
2012,Hamburg,144801,5707,3124532,1565,1755665,4880197,03/14/2019
2012,Frontier,144804,8344,3725778,2347,2037692,5763470,03/14/2019
2012,Holland,145001,1680,678551,429,354069,1032620,03/14/2019
2012,Lancaster,145201,9780,4480232,2840,2575340,7055572,03/14/2019
2012,Akron,145601,1938,953580,696,619361,1572941,03/14/2019
2012,North Collins,145801,989,594330,292,342757,937087,03/14/2019
2012,Orchard Park,146001,7691,3985321,1874,1995555,5980876,03/14/2019
2012,Kenmore,146401,14840,8531123,5880,6964281,15495404,03/14/2019
2012,West Seneca,146801,11959,5988064,4669,4648184,10636248,03/14/2019
2012,Crown Point,152203,415,134547,165,100607,235154,03/14/2019
2012,Elizabethtown-Lewis,152401,522,197502,201,150737,348239,03/14/2019
2012,Keene,153001,273,66598,77,38803,105401,03/14/2019
2012,Minerva,153401,212,64054,103,57999,122053,03/14/2019
2012,Moriah,153601,985,506326,459,423792,930118,03/14/2019
2012,Newcomb,153801,112,8012,64,8687,16699,03/14/2019
2012,Lake Placid,154002,1015,223656,354,146157,369813,03/14/2019
2012,Schroon Lake,154601,474,105588,231,102286,207874,03/14/2019
2012,Ticonderoga,154801,1120,297752,497,251043,548795,03/14/2019
2012,Westport,155001,280,112179,157,117367,229546,03/14/2019
2012,Willsboro,155201,521,165271,277,169627,334898,03/14/2019
2012,Tupper Lake,162001,1258,439565,437,282100,721665,03/14/2019
2012,Chateaugay,163401,747,304124,251,193217,497341,03/14/2019
2012,Salmon River,164201,795,277818,310,198816,476634,03/14/2019
2012,Saranac Lake,164601,2223,596615,622,324092,920707,03/14/2019
2012,Malone,164801,3108,1369250,1096,880789,2250039,03/14/2019
2012,Brushton-Moira,165001,1032,494473,358,323632,818105,03/14/2019
2012,St. Regis Falls,165401,493,245836,185,170143,415979,03/14/2019
2012,Gloversville,170500,3073,1872563,1305,1361916,3234479,03/14/2019
2012,Johnstown,170800,2160,979995,787,684469,1664464,03/14/2019
2012,Broadalbin-Perth,172201,2348,1161002,821,791447,1952449,03/14/2019
2012,Wheelerville,172401,351,91531,140,67950,159481,03/14/2019
2012,Mayfield,173001,1366,637786,524,465622,1103408,03/14/2019
2012,Northville,173201,622,187555,276,169065,356620,03/14/2019
2012,Oppenheim-Ephratah,173401,647,313072,210,182585,495657,03/14/2019
2012,Batavia,180200,3171,2171184,1107,1501836,3673020,03/14/2019
2012,Alexander,182202,1177,771238,383,507192,1278430,03/14/2019
2012,Byron-Bergen,183001,1528,1108110,507,664952,1773062,03/14/2019
2012,Elba,183401,585,359065,209,258410,617475,03/14/2019
2012,Le Roy,183601,1707,1207134,580,797204,2004338,03/14/2019
2012,Oakfield-Alabama,183801,1124,764650,382,506679,1271329,03/14/2019
2012,Pavilion,184001,1131,728325,307,381795,1110120,03/14/2019
2012,Pembroke,184202,1483,868836,519,591877,1460713,03/14/2019
2012,Cairo-Durham,192401,1742,644693,792,580131,1224824,03/14/2019
2012,Catskill,192601,2143,986862,738,676508,1663370,03/14/2019
2012,Coxsackie-Athens,192801,2010,880948,626,548885,1429833,03/14/2019
2012,Greenville,193201,1942,982055,661,671666,1653721,03/14/2019
2012,Hunter-Tannersville,193601,664,192385,304,174323,366708,03/14/2019
2012,Windham-Ashland-Jewett,194601,550,119889,264,117557,237446,03/14/2019
2012,Piseco,202001,87,7435,41,7125,14560,03/14/2019
2012,Indian Lake,202601,316,60467,170,66589,127056,03/14/2019
2012,Inlet,202801,85,9905,47,11316,21221,03/14/2019
2012,Lake Pleasant,203001,183,39463,102,45188,84651,03/14/2019
2012,Long Lake,203201,146,16079,101,22617,38696,03/14/2019
2012,Raquette Lake,203202,20,233,15,363,596,03/14/2019
2012,Wells,203601,208,56606,108,60116,116722,03/14/2019
2012,Little Falls,210900,1312,995670,555,757505,1753175,03/14/2019
2012,West Canada Valley,212402,1091,529324,320,308224,837548,03/14/2019
2012,Frankfort-Schuyler,212602,1400,852840,591,707056,1559896,03/14/2019
2012,Ilion,212801,1649,789187,541,497239,1286426,03/14/2019
2012,Mohawk,212802,1038,586265,453,495006,1081271,03/14/2019
2012,Herkimer,213001,1457,854837,745,821371,1676208,03/14/2019
2012,Dolgeville,213602,1079,431329,417,311780,743109,03/14/2019
2012,Poland,213803,984,361046,329,232321,593367,03/14/2019
2012,Van Hornesville-Owen D. Young,215001,319,154924,118,111659,266583,03/14/2019
2012,Town Of Webb,215401,490,39781,319,52890,92671,03/14/2019
2012,Mount Markham,215601,1539,832012,508,522013,1354025,03/14/2019
2012,Watertown,221800,3981,1107506,1151,636298,1743804,03/14/2019
2012,South Jefferson,222001,2326,750972,616,379933,1130905,03/14/2019
2012,Alexandria,222202,867,248197,310,175758,423955,03/14/2019
2012,Indian River,222401,1895,275390,469,129286,404676,03/14/2019
2012,General Brown,222601,1962,503342,549,280106,783448,03/14/2019
2012,Thousand Islands,223201,1527,457406,589,347708,805114,03/14/2019
2012,Belleville-Henderson,223402,720,167909,307,139391,307300,03/14/2019
2012,Sackets Harbor,223801,647,221766,175,121269,343035,03/14/2019
2012,Lyme,224401,590,166555,243,139973,306528,03/14/2019
2012,La Fargeville,224601,647,163383,184,89989,253372,03/14/2019
2012,Carthage,226001,2649,917984,742,502665,1420649,03/14/2019
2012,Copenhagen,232201,616,165519,166,87541,253060,03/14/2019
2012,Harrisville,232401,539,264815,231,204176,468991,03/14/2019
2012,Lowville,233601,1656,389388,527,240840,630228,03/14/2019
2012,South Lewis,234001,1508,579042,561,399743,978785,03/14/2019
2012,Beaver River,234401,1247,388465,402,247656,636121,03/14/2019
2012,Avon,242001,1327,950821,347,478029,1428850,03/14/2019
2012,Caledonia-Mumford,242201,1332,751407,402,452610,1204017,03/14/2019
2012,Geneseo,242601,1386,661052,355,342891,1003943,03/14/2019
2012,Livonia,243401,2626,1545997,642,751678,2297675,03/14/2019
2012,Mount Morris,243601,632,474022,226,313397,787419,03/14/2019
2012,Dansville,243801,2118,1054056,760,706966,1761022,03/14/2019
2012,Dalton-Nunda,244001,1140,671752,381,409618,1081370,03/14/2019
2012,York,245201,1136,718445,341,412893,1131338,03/14/2019
2012,Oneida,251200,2843,1684545,1009,1187133,2871678,03/14/2019
2012,Brookfield,252009,319,130030,93,71771,201801,03/14/2019
2012,Cazenovia,252201,2243,1056232,543,515617,1571849,03/14/2019
2012,De Ruyter,252401,565,291228,176,176633,467861,03/14/2019
2012,Morrisville-Eaton,252601,1050,470606,291,247333,717939,03/14/2019
2012,Hamilton,253201,951,455784,248,235933,691717,03/14/2019
2012,Canastota,253601,1954,1254938,759,956990,2211928,03/14/2019
2012,Madison,254001,601,342605,228,246071,588676,03/14/2019
2012,Stockbridge Valley,254601,615,341904,186,199939,541843,03/14/2019
2012,Chittenango,254801,3183,2083709,966,1198428,3282137,03/14/2019
2012,Rochester,261400,25824,10118295,4612,3047391,13165686,03/14/2019
2012,Brighton,262001,5217,3874316,990,1470191,5344507,03/14/2019
2012,Gates-Chili,262601,7784,5721667,2932,4222190,9943857,03/14/2019
2012,Greece,262801,18442,12712829,5496,7631149,20343978,03/14/2019
2012,East Irondequoit,263401,6701,5518882,2309,3798181,9317063,03/14/2019
2012,West Irondequoit,263403,6312,4947343,1960,3161203,8108546,03/14/2019
2012,Honeoye Falls-Lima,263601,3206,2141932,635,857768,2999700,03/14/2019
2012,Spencerport,263801,5427,3847406,1452,2088947,5936353,03/14/2019
2012,Hilton,264001,6528,4464577,1734,2374158,6838735,03/14/2019
2012,Penfield,264201,7840,5727946,1828,2674276,8402222,03/14/2019
2012,Fairport,264401,9619,6054113,2489,3138544,9192657,03/14/2019
2012,East Rochester,264413,1813,1338183,622,842706,2180889,03/14/2019
2012,Pittsford,264601,8089,5856740,1246,1848531,7705271,03/14/2019
2012,Churchville-Chili,264801,5885,4023871,1580,2170686,6194557,03/14/2019
2012,Rush-Henrietta,265001,9029,5154695,2413,2761781,7916476,03/14/2019
2012,Brockport,265201,4941,3683210,1063,1513507,5196717,03/14/2019
2012,Webster,265401,13171,8005922,3561,4406264,12412186,03/14/2019
2012,Wheatland-Chili,265601,1351,916044,389,505741,1421785,03/14/2019
2012,Amsterdam,270100,4147,2206185,1926,2025004,4231189,03/14/2019
2012,Canajoharie,272201,1276,675687,481,506252,1181939,03/14/2019
2012,Fonda-Fultonville,272801,2017,921655,605,540428,1462083,03/14/2019
2012,Fort Plain,273001,974,742920,424,609189,1352109,03/14/2019
2012,St. Johnsville,273802,591,303911,262,242957,546868,03/14/2019
2012,Glen Cove,280500,3431,3148415,1190,2088154,5236569,03/14/2019
2012,Long Beach,281000,6219,5453532,924,1703252,7156784,03/14/2019
2012,Hempstead,282001,3281,4331557,478,1301761,5633318,03/14/2019
2012,Uniondale,282002,5672,5099361,849,1582463,6681824,03/14/2019
2012,East Meadow,282003,11324,14257600,2861,6193764,20451364,03/14/2019
2012,North Bellmore,282004,6031,8221268,1133,3227279,11448547,03/14/2019
2012,Levittown,282005,11161,18260393,2290,7846316,26106709,03/14/2019
2012,Seaford,282006,3947,5089198,803,2040522,7129720,03/14/2019
2012,Bellmore,282007,3051,3985564,508,1408692,5394256,03/14/2019
2012,Roosevelt,282008,2428,2807765,376,885095,3692860,03/14/2019
2012,Freeport,282009,6273,7825050,1027,2537428,10362478,03/14/2019
2012,Baldwin,282010,7444,10709952,1077,3103764,13813716,03/14/2019
2012,Oceanside,282011,8765,10186486,1644,3822513,14008999,03/14/2019
2012,Malverne,282012,3196,4545384,579,1742039,6287423,03/14/2019
2012,Valley Stream 13,282013,6235,7873470,1365,3471076,11344546,03/14/2019
2012,Hewlett-Woodmere,282014,4524,7125742,639,2080973,9206715,03/14/2019
2012,Lawrence,282015,5950,4356791,837,1260240,5617031,03/14/2019
2012,Elmont,282016,8550,9759824,1456,3499703,13259527,03/14/2019
2012,Franklin Square,282017,5180,5403722,1307,2892498,8296220,03/14/2019
2012,Garden City,282018,5146,4250357,619,1058509,5308866,03/14/2019
2012,East Rockaway,282019,2083,2784152,503,1356246,4140398,03/14/2019
2012,Lynbrook,282020,3824,5102117,733,2000556,7102673,03/14/2019
2012,Rockville Centre,282021,4712,5657279,668,1594138,7251417,03/14/2019
2012,Floral Park-Bellerose,282022,4311,4407847,832,1745229,6153076,03/14/2019
2012,Wantagh,282023,4367,5955180,701,2022185,7977365,03/14/2019
2012,Valley Stream 24,282024,2646,2913958,482,1127284,4041242,03/14/2019
2012,Merrick,282025,4605,6279393,587,1701122,7980515,03/14/2019
2012,Island Trees,282026,3402,4155295,742,1912504,6067799,03/14/2019
2012,West Hempstead,282027,3676,4399324,637,1617786,6017110,03/14/2019
2012,North Merrick,282029,3373,4519749,639,1765942,6285691,03/14/2019
2012,Valley Stream 30,282030,3154,3429118,480,1106544,4535662,03/14/2019
2012,Island Park,282031,1589,1272063,329,557383,1829446,03/14/2019
2012,Westbury,282201,3372,4987310,652,1973644,6960954,03/14/2019
2012,East Williston,282202,1880,2134250,196,470982,2605232,03/14/2019
2012,Roslyn,282203,3808,4543487,326,815040,5358527,03/14/2019
2012,Port Washington,282204,5474,4909203,736,1385441,6294644,03/14/2019
2012,New Hyde Park-Garden City,282205,4840,4925351,1097,2373252,7298603,03/14/2019
2012,Manhasset,282206,3153,2159076,317,460764,2619840,03/14/2019
2012,Great Neck,282207,9131,6122918,1093,1509310,7632228,03/14/2019
2012,Herricks,282209,5956,6835321,942,2297215,9132536,03/14/2019
2012,Mineola,282210,4708,4764254,1064,2285229,7049483,03/14/2019
2012,Carle Place,282211,1948,2158799,402,946698,3105497,03/14/2019
2012,North Shore,282401,3648,3280303,514,983066,4263369,03/14/2019
2012,Syosset,282402,7665,10079386,1072,2377251,12456637,03/14/2019
2012,Locust Valley,282403,3116,2625410,399,714726,3340136,03/14/2019
2012,Plainview-Old Bethpage,282404,7326,9942950,1185,3418250,13361200,03/14/2019
2012,Oyster Bay-East Norwich,282406,2513,1810294,335,498280,2308574,03/14/2019
2012,Jericho,282415,2965,3178334,308,701991,3880325,03/14/2019
2012,Hicksville,282417,8035,7301568,1936,3600229,10901797,03/14/2019
2012,Plainedge,282418,4586,7169625,1062,3525838,10695463,03/14/2019
2012,Bethpage,282421,4190,4648984,1331,2289844,6938828,03/14/2019
2012,Farmingdale,282422,8812,12017317,1924,5509357,17526674,03/14/2019
2012,Massapequa,282423,11533,13825168,2324,5873643,19698811,03/14/2019
2012,Lockport,290900,6296,5044124,1828,2562095,7606219,03/14/2019
2012,Niagara Falls,291100,8101,4133842,3221,2881089,7014931,03/14/2019
2012,North Tonawanda,291200,6563,3990301,2374,2915034,6905335,03/14/2019
2012,Lewiston-Porter,292401,4109,2198148,1494,1639731,3837879,03/14/2019
2012,Newfane,292801,2329,1999378,818,1295878,3295256,03/14/2019
2012,Niagara-Wheatfield,293001,5368,2766093,1876,1840492,4606585,03/14/2019
2012,Starpoint,293201,4267,2801897,1043,1397173,4199070,03/14/2019
2012,Royalton-Hartland,293601,2073,1337098,632,818688,2155786,03/14/2019
2012,Barker,293801,1113,503851,366,331735,835586,03/14/2019
2012,Wilson,294201,1862,1320217,605,858185,2178402,03/14/2019
2012,Rome,301300,6283,3928966,2423,2838552,6767518,03/14/2019
2012,Utica,301600,7762,4309440,3252,3356433,7665873,03/14/2019
2012,Adirondack,302601,1905,793205,726,561954,1355159,03/14/2019
2012,Camden,303001,2727,1165380,1000,780664,1946044,03/14/2019
2012,Clinton,304001,1979,1417719,648,885156,2302875,03/14/2019
2012,New Hartford,304801,3772,2457730,1201,1519924,3977654,03/14/2019
2012,New York Mills,304804,838,525887,430,548161,1074048,03/14/2019
2012,Sauquoit Valley,305002,1456,803816,431,469894,1273710,03/14/2019
2012,Remsen,305201,726,463662,248,311490,775152,03/14/2019
2012,Waterville,305401,1170,591125,375,361020,952145,03/14/2019
2012,Holland Patent,305801,2244,1281612,685,763979,2045591,03/14/2019
2012,Sherrill,306000,2648,1540381,981,1131957,2672338,03/14/2019
2012,Westmoreland,306801,1509,1079527,529,739330,1818857,03/14/2019
2012,Oriskany,307001,934,643695,318,437539,1081234,03/14/2019
2012,Whitesboro,307002,5157,3059906,1812,2184266,5244172,03/14/2019
2012,Syracuse,311500,16493,7447678,4078,3361927,10809605,03/14/2019
2012,West Genesee,312001,7652,4869543,2692,3410073,8279616,03/14/2019
2012,North Syracuse,312403,14556,9314272,3644,4393748,13708020,03/14/2019
2012,East Syracuse-Minoa,312601,4984,3647964,1874,2519188,6167152,03/14/2019
2012,Jamesville-Dewitt,312611,4118,2662309,825,1057711,3720020,03/14/2019
2012,Jordan-Elbridge,312801,1769,1458043,570,827216,2285259,03/14/2019
2012,Fabius-Pompey,313001,1157,881121,314,466169,1347290,03/14/2019
2012,Westhill,313201,2795,2202422,834,1304957,3507379,03/14/2019
2012,Solvay,313202,1855,1388109,866,1290741,2678850,03/14/2019
2012,La Fayette,313407,1091,580298,272,276187,856485,03/14/2019
2012,Baldwinsville,313601,8244,5565306,1983,2624825,8190131,03/14/2019
2012,Fayetteville-Manlius,313801,6066,4518078,1226,1836957,6355035,03/14/2019
2012,Marcellus,314001,2668,1754916,738,981654,2736570,03/14/2019
2012,Onondaga,314201,1564,1312243,407,666984,1979227,03/14/2019
2012,Liverpool,314801,10721,7876624,3209,4535917,12412541,03/14/2019
2012,Lyncourt,314804,857,754205,389,588576,1342781,03/14/2019
2012,Skaneateles,315001,2095,848930,631,522798,1371728,03/14/2019
2012,Tully,315402,1371,742954,323,348752,1091706,03/14/2019
2012,Canandaigua,320200,4701,2568290,1230,1334417,3902707,03/14/2019
2012,Geneva,320500,2683,1701934,1040,1258804,2960738,03/14/2019
2012,East Bloomfield,322601,1365,972932,379,527963,1500895,03/14/2019
2012,Gorham-Middlesex,323201,2177,929356,723,604156,1533512,03/14/2019
2012,Manchester-Shortsville,323601,1164,974002,405,664880,1638882,03/14/2019
2012,Naples,323801,1351,572201,409,348559,920760,03/14/2019
2012,Phelps-Clifton Springs,324001,2322,1681466,651,932391,2613857,03/14/2019
2012,Honeoye,324201,1518,716722,452,419343,1136065,03/14/2019
2012,Victor,324801,5042,2533602,1040,1043188,3576790,03/14/2019
2012,Middletown,330900,6049,4839440,1287,2053381,6892821,03/14/2019
2012,Newburgh,331100,10147,8887788,2587,4359091,13246879,03/14/2019
2012,Port Jervis,331300,2795,2775015,917,1729323,4504338,03/14/2019
2012,Washingtonville,332002,5463,5021955,830,1569311,6591266,03/14/2019
2012,Chester,332201,1383,1142684,274,454121,1596805,03/14/2019
2012,Cornwall,332401,3574,3211716,591,1076240,4287956,03/14/2019
2012,Pine Bush,332601,6095,4452495,1153,1688382,6140877,03/14/2019
2012,Goshen,333001,3087,2467805,675,1105151,3572956,03/14/2019
2012,Highland Falls,333601,883,673271,224,341488,1014759,03/14/2019
2012,Minisink Valley,333801,4775,3571790,765,1158522,4730312,03/14/2019
2012,Monroe-Woodbury,334001,8350,8343885,1227,2513319,10857204,03/14/2019
2012,Kiryas Joel Village,334002,733,382666,38,34582,417248,03/14/2019
2012,Valley,334201,5189,4204297,1183,1924446,6128743,03/14/2019
2012,Tuxedo,335003,511,235738,87,82748,318486,03/14/2019
2012,Warwick Valley,335401,5272,4211517,888,1452973,5664490,03/14/2019
2012,Greenwood Lake,335411,1583,1410608,298,541792,1952400,03/14/2019
2012,Florida,335415,1114,1085535,265,526973,1612508,03/14/2019
2012,Albion,342001,2309,1186390,844,827333,2013723,03/14/2019
2012,Kendall,343007,1224,763589,373,459314,1222903,03/14/2019
2012,Holley,343204,1502,1202310,500,765943,1968253,03/14/2019
2012,Medina,343401,2054,1492524,805,1098956,2591480,03/14/2019
2012,Lyndonville,343801,955,517929,335,359744,877673,03/14/2019
2012,Fulton,350400,3711,2859528,1263,1754544,4614072,03/14/2019
2012,Oswego,351200,5224,2951263,1702,1777696,4728959,03/14/2019
2012,Altmar Parish-Williamstown,352002,1709,956037,488,505818,1461855,03/14/2019
2012,Hannibal,353001,1720,1198414,495,652117,1850531,03/14/2019
2012,Central Square,353201,5653,3081064,1536,1579199,4660263,03/14/2019
2012,Mexico,353401,2895,1489657,772,767329,2256986,03/14/2019
2012,Pulaski,355001,1180,687616,382,422236,1109852,03/14/2019
2012,Sandy Creek,355201,1211,529812,468,384400,914212,03/14/2019
2012,Phoenix,355401,2751,2279525,786,1247698,3527223,03/14/2019
2012,Oneonta,361200,2581,1373901,836,897027,2270928,03/14/2019
2012,Gilbertsville-Mt Upton,362202,654,210366,299,187495,397861,03/14/2019
2012,Cherry Valley-Springfield,362401,885,280655,382,240314,520969,03/14/2019
2012,Edmeston,362801,641,213012,218,145825,358837,03/14/2019
2012,Laurens,363401,544,245354,223,205181,450535,03/14/2019
2012,Schenevus,363601,557,257669,227,207582,465251,03/14/2019
2012,Milford,364001,620,274651,306,271725,546376,03/14/2019
2012,Morris,364201,583,263490,232,204243,467733,03/14/2019
2012,Otego-Unadilla,364801,1372,711230,553,551115,1262345,03/14/2019
2012,Cooperstown,365001,1267,384884,432,262883,647767,03/14/2019
2012,Richfield Springs,365601,817,237813,393,223996,461809,03/14/2019
2012,Worcester,366606,508,259714,265,271570,531284,03/14/2019
2012,Mahopac,372001,6144,7623005,992,2504771,10127776,03/14/2019
2012,Carmel,372002,6836,8432092,1097,2730349,11162441,03/14/2019
2012,Haldane,372601,1106,963012,264,436969,1399981,03/14/2019
2012,Garrison,372604,513,254222,88,90357,344579,03/14/2019
2012,Putnam Valley,372803,2717,3989752,395,1170486,5160238,03/14/2019
2012,Brewster,373001,4863,5380634,915,2112902,7493536,03/14/2019
2012,Rensselaer,381400,1377,643993,381,325386,969379,03/14/2019
2012,Troy,381700,4193,2334315,1209,1292048,3626363,03/14/2019
2012,Lansingburgh,381701,2692,1290116,872,824031,2114147,03/14/2019
2012,Berlin,382001,1583,674050,414,345455,1019505,03/14/2019
2012,Brunswick,382202,1846,940753,555,552893,1493646,03/14/2019
2012,East Greenbush,382401,6907,3479312,1635,1669281,5148593,03/14/2019
2012,Hoosick Falls,382801,1692,862796,544,500178,1362974,03/14/2019
2012,North Greenbush,383201,367,71366,119,47679,119045,03/14/2019
2012,Wynantskill,383204,893,524941,274,333198,858139,03/14/2019
2012,Averill Park,384001,4720,2309122,1000,999252,3308374,03/14/2019
2012,Hoosic Valley,384201,1609,806384,396,396862,1203246,03/14/2019
2012,Schodack,384401,1511,886718,341,407480,1294198,03/14/2019
2012,Clarkstown,392001,11345,11004957,1908,3815173,14820130,03/14/2019
2012,Nanuet,392008,2411,2485331,604,1241833,3727164,03/14/2019
2012,Haverstraw-Stony Point,392201,8557,14200201,1933,6041365,20241566,03/14/2019
2012,South Orangetown,392401,4363,4948551,987,2313570,7262121,03/14/2019
2012,Nyack,392404,4137,5561687,789,2219630,7781317,03/14/2019
2012,Pearl River,392408,3244,3998704,738,1875527,5874231,03/14/2019
2012,Ramapo,392601,5707,9463527,1216,3801942,13265469,03/14/2019
2012,East Ramapo,392602,11802,13030579,1851,3835132,16865711,03/14/2019
2012,Ogdensburg,401200,2099,1503302,717,823860,2327162,03/14/2019
2012,Brasher Falls,402001,1336,846224,475,537058,1383282,03/14/2019
2012,Canton,402201,1783,988964,517,545144,1534108,03/14/2019
2012,Clifton-Fine,402601,486,160694,231,125940,286634,03/14/2019
2012,Colton-Pierrepont,402801,630,253748,257,194299,448047,03/14/2019
2012,Edwards-Knox,403401,724,228088,238,133801,361889,03/14/2019
2012,Gouverneur,404001,1979,703608,632,412328,1115936,03/14/2019
2012,Hammond,404201,406,152402,169,122148,274550,03/14/2019
2012,Hermon-Dekalb,404401,544,288787,213,206970,495757,03/14/2019
2012,Lisbon,405002,812,420877,265,261874,682751,03/14/2019
2012,Madrid-Waddington,405601,960,477090,377,356832,833922,03/14/2019
2012,Massena,405801,3397,1734601,1353,1285217,3019818,03/14/2019
2012,Morristown,406001,630,263280,254,210733,474013,03/14/2019
2012,Norwood-Norfolk,406201,1407,1015244,534,707497,1722741,03/14/2019
2012,Heuvelton,406404,861,505636,294,328382,834018,03/14/2019
2012,Parishville-Hopkinton,406601,648,239027,209,146282,385309,03/14/2019
2012,Potsdam,407402,1927,1315665,530,678955,1994620,03/14/2019
2012,Mechanicville,411000,1658,945316,538,636700,1582016,03/14/2019
2012,Saratoga Springs,411500,9513,4360960,1783,1639197,6000157,03/14/2019
2012,Burnt Hills-Ballston Lake,412001,4943,3142613,1291,1678120,4820733,03/14/2019
2012,Shenendehowa,412402,14423,9556551,2269,3048217,12604768,03/14/2019
2012,Corinth,412601,1568,674978,530,418952,1093930,03/14/2019
2012,Edinburg,413001,343,58316,158,51773,110089,03/14/2019
2012,Galway,413201,1666,788882,465,422093,1210975,03/14/2019
2012,Ballston Spa,414201,5568,4233996,1190,1677886,5911882,03/14/2019
2012,South Glens Falls,414401,3959,2407256,1143,1364458,3771714,03/14/2019
2012,Schuylerville,415001,2401,1770227,506,709165,2479392,03/14/2019
2012,Stillwater,415201,1729,800832,407,367481,1168313,03/14/2019
2012,Waterford-Halfmoon,415401,995,827694,387,585225,1412919,03/14/2019
2012,Schenectady,421500,8303,5256920,2501,3011239,8268159,03/14/2019
2012,Duanesburg,422001,1317,615583,300,281727,897310,03/14/2019
2012,Scotia-Glenville,422202,4254,2310620,1127,1252142,3562762,03/14/2019
2012,Niskayuna,422401,6109,3203003,986,1070358,4273361,03/14/2019
2012,Schalmont,422801,3328,1742960,1017,1097451,2840411,03/14/2019
2012,Rotterdam-Mohonasen,422803,4821,2190986,1912,1789818,3980804,03/14/2019
2012,Cobleskill-Richmondville,432602,2439,1281337,913,904752,2186089,03/14/2019
2012,Gilboa-Conesville,433401,527,186365,290,193044,379409,03/14/2019
2012,Jefferson,433601,426,167955,176,133857,301812,03/14/2019
2012,Middleburgh,433801,1272,731023,497,531380,1262403,03/14/2019
2012,Schoharie,434201,1505,896067,462,541224,1437291,03/14/2019
2012,Sharon Springs,434601,400,234064,177,201547,435611,03/14/2019
2012,Odessa-Montour,442001,1220,626342,431,429971,1056313,03/14/2019
2012,Watkins Glen,442401,1781,626011,715,490894,1116905,03/14/2019
2012,South Seneca,452801,1380,650420,487,430560,1080980,03/14/2019
2012,Romulus,453003,722,412906,237,265787,678693,03/14/2019
2012,Seneca Falls,453201,1914,1372484,729,1019573,2392057,03/14/2019
2012,Waterloo,453801,2278,1432565,805,976504,2409069,03/14/2019
2012,Corning,460300,7043,5140715,2224,3035285,8176000,03/14/2019
2012,Hornell,460600,1847,950392,628,581359,1531751,03/14/2019
2012,Addison,462001,1464,888131,492,519937,1408068,03/14/2019
2012,Avoca,462201,773,315326,290,213827,529153,03/14/2019
2012,Bath,462402,1801,994592,673,726766,1721358,03/14/2019
2012,Bradford,462601,460,230453,162,154237,384690,03/14/2019
2012,Campbell-Savona,463002,1172,695441,423,478367,1173808,03/14/2019
2012,Canisteo-Greenwood,463202,1276,649243,540,492649,1141892,03/14/2019
2012,Arkport,465201,644,394133,321,332665,726798,03/14/2019
2012,Jasper-Troupsburg,465601,645,252986,229,170623,423609,03/14/2019
2012,Prattsburgh,466001,656,274258,223,172996,447254,03/14/2019
2012,Hammondsport,467201,1006,289857,429,241940,531797,03/14/2019
2012,Wayland-Cohocton,467401,2024,949608,685,592115,1541723,03/14/2019
2012,Babylon,472001,2572,3273195,436,1116299,4389494,03/14/2019
2012,West Babylon,472002,5283,6164079,1142,2693812,8857891,03/14/2019
2012,North Babylon,472003,6317,7089044,1525,3492586,10581630,03/14/2019
2012,Lindenhurst,472004,8216,10167536,1849,4645701,14813237,03/14/2019
2012,Copiague,472005,4975,5719922,1195,2663229,8383151,03/14/2019
2012,Amityville,472006,4309,4947965,1135,1955860,6903825,03/14/2019
2012,Deer Park,472007,5087,5950568,1424,3366471,9317039,03/14/2019
2012,Wyandanch,472009,1167,1435613,216,530160,1965773,03/14/2019
2012,Three Village,472201,8999,9726739,1546,3336871,13063610,03/14/2019
2012,Brookhaven-Comsewogue,472203,4448,4681061,919,1869082,6550143,03/14/2019
2012,South Country,472204,5098,5006452,750,1464691,6471143,03/14/2019
2012,Sachem,472205,17126,14934484,2853,4947781,19882265,03/14/2019
2012,Port Jefferson,472206,1505,921523,241,300467,1221990,03/14/2019
2012,Mount Sinai,472207,3121,3508827,586,1325963,4834790,03/14/2019
2012,Miller Place,472208,3718,4153169,428,957547,5110716,03/14/2019
2012,Rocky Point,472209,4011,4896900,509,1232203,6129103,03/14/2019
2012,Middle Country,472211,12023,12920943,2450,5221964,18142907,03/14/2019
2012,Longwood,472212,12307,13774804,3290,6550335,20325139,03/14/2019
2012,Patchogue-Medford,472224,9586,10473808,1701,3531919,14005727,03/14/2019
2012,William Floyd,472232,9518,11244700,1413,3177807,14422507,03/14/2019
2012,Center Moriches,472233,1704,2020307,272,639792,2660099,03/14/2019
2012,East Moriches,472234,1303,1496867,184,434496,1931363,03/14/2019
2012,Eastport- South Manor,472235,4176,4662096,903,1742927,6405023,03/14/2019
2012,East Hampton,472401,1094,227073,351,142675,369748,03/14/2019
2012,Wainscott,472402,95,7848,25,4270,12118,03/14/2019
2012,Amagansett,472403,187,23076,92,23023,46099,03/14/2019
2012,Springs,472404,906,347602,283,223052,570654,03/14/2019
2012,Sag Harbor,472405,1146,340491,450,276097,616588,03/14/2019
2012,Montauk,472406,607,112690,232,114210,226900,03/14/2019
2012,Elwood,472601,3079,3471408,607,1415884,4887292,03/14/2019
2012,Cold Spring Harbor,472602,1534,1490278,121,248052,1738330,03/14/2019
2012,Huntington,472603,7180,7730021,1227,2668189,10398210,03/14/2019
2012,Northport-East Northport,472604,8700,7424998,1458,2497371,9922369,03/14/2019
2012,Half Hollow Hills,472605,10455,9413964,1866,3186290,12600254,03/14/2019
2012,Harborfields,472606,4415,4916728,738,1699163,6615891,03/14/2019
2012,Commack,472610,8908,10710161,1837,4602432,15312593,03/14/2019
2012,South Huntington,472613,8364,9377749,1763,4074754,13452503,03/14/2019
2012,Bay Shore,472801,5660,6499040,1144,2643978,9143018,03/14/2019
2012,Islip,472802,3841,4746549,733,1701733,6448282,03/14/2019
2012,East Islip,472803,5394,6004680,1134,2831958,8836638,03/14/2019
2012,Sayville,472804,4023,4500210,866,1977033,6477243,03/14/2019
2012,Bayport-Blue Point,472805,3047,3872267,501,1306694,5178961,03/14/2019
2012,Hauppauge,472806,4977,3328183,1044,1420223,4748406,03/14/2019
2012,Connetquot,472807,8524,9096096,1819,3849527,12945623,03/14/2019
2012,West Islip,472809,6363,6655103,1371,2970253,9625356,03/14/2019
2012,Brentwood,472812,9882,7400691,2078,3211786,10612477,03/14/2019
2012,Central Islip,472813,5720,7494419,1031,2714787,10209206,03/14/2019
2012,Fire Island,472814,98,10522,20,4444,14966,03/14/2019
2012,Shoreham-Wading River,473001,3154,3139421,741,1415156,4554577,03/14/2019
2012,Riverhead,473002,6558,5009203,2679,3474838,8484041,03/14/2019
2012,Shelter Island,473201,558,98722,227,83265,181987,03/14/2019
2012,Smithtown,473401,13155,14037962,2576,5374724,19412686,03/14/2019
2012,Kings Park,473405,5223,5221060,965,1999716,7220776,03/14/2019
2012,Remsenburg-Speonk,473601,392,119026,80,50438,169464,03/14/2019
2012,Westhampton Beach,473602,936,318019,242,163718,481737,03/14/2019
2012,Quogue,473603,188,21660,48,11524,33184,03/14/2019
2012,Hampton Bays,473605,2095,1440765,718,1015772,2456537,03/14/2019
2012,Southhampton,473606,1458,202691,489,139917,342608,03/14/2019
2012,Bridgehampton,473609,220,20016,77,14524,34540,03/14/2019
2012,Sagaponack,473610,50,1116,7,324,1440,03/14/2019
2012,Tuckahoe Common,473613,468,189958,158,131871,321829,03/14/2019
2012,East Quogue,473617,1045,612847,293,342247,955094,03/14/2019
2012,Oysterponds,473802,355,83464,175,86086,169550,03/14/2019
2012,Fishers Island,473804,29,6798,5,2452,9250,03/14/2019
2012,Southold,473805,1441,719757,561,588437,1308194,03/14/2019
2012,Greenport,473810,594,316242,282,318146,634388,03/14/2019
2012,Mattituck-Cutchogue,473812,2062,1100895,652,726306,1827201,03/14/2019
2012,New Suffolk,473815,76,13902,36,13720,27622,03/14/2019
2012,Fallsburg,482801,1241,789548,335,422411,1211959,03/14/2019
2012,Eldred,483401,1078,402758,373,279829,682587,03/14/2019
2012,Liberty,483601,1331,876612,565,729424,1606036,03/14/2019
2012,Tri-Valley,484201,1259,640837,358,348265,989102,03/14/2019
2012,Roscoe,484401,372,146120,171,136471,282591,03/14/2019
2012,Livingston Manor,484402,598,234114,259,196753,430867,03/14/2019
2012,Monticello,484601,3136,1418377,1058,953086,2371463,03/14/2019
2012,Sullivan West,484802,2129,780974,879,648450,1429424,03/14/2019
2012,Waverly,492001,1814,822272,679,587343,1409615,03/14/2019
2012,Candor,492401,1010,520581,399,393650,914231,03/14/2019
2012,Newark Valley,492602,1726,937432,594,640781,1578213,03/14/2019
2012,Owego-Apalachin,493001,2882,1599802,1018,1093423,2693225,03/14/2019
2012,Spencer-Van Etten,493401,1305,566442,464,384360,950802,03/14/2019
2012,Tioga,493603,1144,316004,393,211601,527605,03/14/2019
2012,Ithaca,500700,8106,4178621,1720,1636241,5814862,03/14/2019
2012,Dryden,502401,2490,1664430,629,740942,2405372,03/14/2019
2012,Groton,502801,1315,796497,362,413577,1210074,03/14/2019
2012,Lansing,503201,1706,974506,376,422345,1396851,03/14/2019
2012,Newfield,503401,1038,552462,339,294597,847059,03/14/2019
2012,Trumansburg,503601,1699,969276,459,501091,1470367,03/14/2019
2012,Kingston,510800,8414,5384028,2930,3720305,9104333,03/14/2019
2012,Highland,513203,2374,1612691,585,795558,2408249,03/14/2019
2012,Rondout Valley,513401,3642,2124526,1029,1195083,3319609,03/14/2019
2012,Marlboro,513601,2453,1853549,564,837056,2690605,03/14/2019
2012,New Paltz,513801,3160,1938642,674,846185,2784827,03/14/2019
2012,Onteora,514001,3327,1312832,1277,1007666,2320498,03/14/2019
2012,Saugerties,514801,4336,2637972,1356,1679542,4317514,03/14/2019
2012,Wallkill,515201,3974,3200943,958,1286693,4487636,03/14/2019
2012,Ellenville,515602,1685,1119055,569,671999,1791054,03/14/2019
2012,Glens Falls,520500,2777,1352080,901,892954,2245034,03/14/2019
2012,Bolton,522001,377,53477,162,47981,101458,03/14/2019
2012,Lake George,522201,1382,245642,495,183485,429127,03/14/2019
2012,North Warren,522402,1020,214997,467,181886,396883,03/14/2019
2012,Johnsburg,523001,531,163275,256,155878,319153,03/14/2019
2012,Hadley-Luzerne,523201,1314,408474,574,355341,763815,03/14/2019
2012,Queensbury,523402,4448,1880848,1246,1041694,2922542,03/14/2019
2012,Glens Falls Common,523418,257,92632,86,62043,154675,03/14/2019
2012,Warrensburg,524001,1190,485861,495,402872,888733,03/14/2019
2012,Argyle,532001,906,400889,306,266775,667664,03/14/2019
2012,Fort Ann,532802,819,322563,244,193092,515655,03/14/2019
2012,Fort Edward,533001,532,249303,204,194856,444159,03/14/2019
2012,Granville,533201,1490,659226,552,472049,1131275,03/14/2019
2012,Greenwich,533401,1443,659291,494,457473,1116764,03/14/2019
2012,Hartford,533801,698,338898,224,218072,556970,03/14/2019
2012,Hudson Falls,534401,2621,999560,1011,775631,1775191,03/14/2019
2012,Putnam,534601,159,25278,62,19578,44856,03/14/2019
2012,Salem,534801,869,339629,344,266151,605780,03/14/2019
2012,Cambridge,535010,1327,528923,554,444179,973102,03/14/2019
2012,Whitehall,535201,911,263563,379,206627,470190,03/14/2019
2012,Newark,542001,2813,1725398,952,1142862,2868260,03/14/2019
2012,Clyde-Savannah,542401,1137,806156,415,541349,1347505,03/14/2019
2012,Lyons,542801,1184,706600,440,471206,1177806,03/14/2019
2012,Gananda,543002,1476,1313771,152,276854,1590625,03/14/2019
2012,Marion,543201,1348,929466,345,469910,1399376,03/14/2019
2012,Wayne,543401,3633,2276832,891,1130498,3407330,03/14/2019
2012,Palmyra-Macedon,543601,2557,1918271,827,1203911,3122182,03/14/2019
2012,Sodus,544201,1492,888523,593,651934,1540457,03/14/2019
2012,Williamson,544602,1536,1099410,463,698813,1798223,03/14/2019
2012,North Rose-Wolcott,544801,1766,800254,724,634804,1435058,03/14/2019
2012,Red Creek,544803,1163,479022,418,329510,808532,03/14/2019
2012,Mount Vernon,550800,5249,14244070,1223,5408926,19652996,03/14/2019
2012,New Rochelle,551000,8797,16608770,1529,5400972,22009742,03/14/2019
2012,Peekskill,551200,3378,6783394,609,2079490,8862884,03/14/2019
2012,Rye,551400,1981,2339298,295,718328,3057626,03/14/2019
2012,White Plains,551700,7090,14212583,1070,3623160,17835743,03/14/2019
2012,Yonkers,551800,17847,27670165,4055,10326681,37996846,03/14/2019
2012,Katonah-Lewisboro,552001,4459,7116876,529,1632568,8749444,03/14/2019
2012,Bedford,552002,4355,5097868,814,1541803,6639671,03/14/2019
2012,Croton-Harmon,552202,2178,3775028,280,928209,4703237,03/14/2019
2012,Hendrick Hudson,552203,3319,5106170,506,1387122,6493292,03/14/2019
2012,Eastchester,552401,3008,6640303,645,2477369,9117672,03/14/2019
2012,Tuckahoe,552402,1228,2236376,200,660330,2896706,03/14/2019
2012,Bronxville,552403,599,1407017,47,296358,1703375,03/14/2019
2012,Tarrytowns,552601,2319,4814304,481,1860550,6674854,03/14/2019
2012,Irvington,552602,1518,3176805,224,912881,4089686,03/14/2019
2012,Dobbs Ferry,552603,1316,3134549,210,966931,4101480,03/14/2019
2012,Hastings On Hudson,552604,1557,3868436,296,1374094,5242530,03/14/2019
2012,Ardsley,552605,2319,4323803,331,1263616,5587419,03/14/2019
2012,Edgemont,552606,1234,2901114,136,604198,3505312,03/14/2019
2012,Greenburgh,552607,3955,6540050,920,2526046,9066096,03/14/2019
2012,Elmsford,552609,1264,1909093,321,977666,2886759,03/14/2019
2012,Harrison,552801,2816,3039625,638,1301118,4340743,03/14/2019
2012,Mamaroneck,553201,4005,5945286,575,1571267,7516553,03/14/2019
2012,Mount Pleasant,553401,2674,3706134,713,2020269,5726403,03/14/2019
2012,Pocantico Hills,553402,439,340464,88,134343,474807,03/14/2019
2012,Valhalla,553405,1780,2880756,414,1312761,4193517,03/14/2019
2012,Pleasantville,553409,1833,3392795,357,1181338,4574133,03/14/2019
2012,Chappaqua,553604,3193,5171720,254,835776,6007496,03/14/2019
2012,Byram Hills,553801,2217,2560636,234,551466,3112102,03/14/2019
2012,North Salem,554001,1660,2144707,291,731512,2876219,03/14/2019
2012,Ossining,554201,5730,11903356,823,3256447,15159803,03/14/2019
2012,Briarcliff Manor,554202,1451,2753152,108,425071,3178223,03/14/2019
2012,Pelham,554401,2045,3601153,351,1179023,4780176,03/14/2019
2012,Rye Neck,554801,1372,2060233,249,661733,2721966,03/14/2019
2012,Port Chester-Rye,554804,2879,4639229,851,2261261,6900490,03/14/2019
2012,Blind Brook-Rye,554805,1416,1983021,177,513431,2496452,03/14/2019
2012,Scarsdale,555001,2899,3809854,211,574072,4383926,03/14/2019
2012,Somers,555201,4917,7507966,1264,3488289,10996255,03/14/2019
2012,Lakeland,555401,8326,16456372,1855,5936401,22392773,03/14/2019
2012,Yorktown,555402,4970,9467222,690,2603028,12070250,03/14/2019
2012,Attica,562201,2314,1163206,667,686052,1849258,03/14/2019
2012,Letchworth,562601,1394,594266,394,322995,917261,03/14/2019
2012,Wyoming,563802,433,218268,107,107229,325497,03/14/2019
2012,Perry,564201,1200,588998,441,428565,1017563,03/14/2019
2012,Warsaw,564801,1358,885450,375,489990,1375440,03/14/2019
2012,Penn Yan,573001,2906,892700,1131,695813,1588513,03/14/2019
2012,Dundee,573401,1139,370283,479,295102,665385,03/14/2019
2012,New York City School,650000,564612,159335096,108258,59193859,218528955,03/14/2019
2011,Albany,010100,10610,6302845,3236,3623333,9926178,03/14/2019
2011,Cohoes,010300,2224,1285967,661,736539,2022506,03/14/2019
2011,Watervliet,011800,1328,529585,436,348603,878188,03/14/2019
2011,Berne-Knox-Westerlo,012001,1710,880409,409,404910,1285319,03/14/2019
2011,Bethlehem,012206,6963,4034362,1146,1323681,5358043,03/14/2019
2011,Ravena-Coeymans-Selkirk,012402,2993,1754553,747,843485,2598038,03/14/2019
2011,South Colonie,012601,9192,4610448,2620,2546121,7156569,03/14/2019
2011,North Colonie,012605,8065,3664556,1694,1511957,5176513,03/14/2019
2011,Menands,012615,400,195235,98,94351,289586,03/14/2019
2011,Green Island,012801,285,163518,123,140163,303681,03/14/2019
2011,Guilderland,013002,7579,3807297,1502,1501210,5308507,03/14/2019
2011,Voorheesville,013403,2025,1052220,376,391586,1443806,03/14/2019
2011,Alfred-Almond,022001,887,589405,284,343212,932617,03/14/2019
2011,Andover,023001,486,360838,183,224920,585758,03/14/2019
2011,Genesee Valley,023202,761,349100,364,281974,631074,03/14/2019
2011,Belfast,023401,471,223035,187,153002,376037,03/14/2019
2011,Canaseraga,024002,381,210738,148,139435,350173,03/14/2019
2011,Cuba-Rushford,024801,1383,602474,577,444610,1047084,03/14/2019
2011,Friendship,025001,405,282612,170,193493,476105,03/14/2019
2011,Fillmore,025801,826,318516,277,187471,505987,03/14/2019
2011,Whitesville,026001,242,134080,87,78229,212309,03/14/2019
2011,Scio,026601,487,327508,205,231315,558823,03/14/2019
2011,Wellsville,027001,1711,1229902,777,914876,2144778,03/14/2019
2011,Bolivar-Richburg,027602,1002,505358,372,293697,799055,03/14/2019
2011,Binghamton,030200,6261,3632959,2351,2474068,6107027,03/14/2019
2011,Chenango Forks,032001,2169,1367719,678,800427,2168146,03/14/2019
2011,South Mountain-Hickory,032201,139,20185,21,6110,26295,03/14/2019
2011,Harpursville,032601,1155,460936,354,251653,712589,03/14/2019
2011,Susquehanna Valley,032801,2506,1906690,844,1241973,3148663,03/14/2019
2011,Chenango Valley,033001,2698,2035785,1108,1636058,3671843,03/14/2019
2011,Maine-Endwell,033801,3621,2606851,1266,1723624,4330475,03/14/2019
2011,Deposit,034201,761,300082,332,245304,545386,03/14/2019
2011,Whitney Point,034401,1865,969960,569,588266,1558226,03/14/2019
2011,Union-Endicott,034601,5740,3766136,2325,2986176,6752312,03/14/2019
2011,Johnson City,034602,3312,2070822,1403,1650328,3721150,03/14/2019
2011,Vestal,034801,5820,3512203,1811,2166059,5678262,03/14/2019
2011,Windsor,035001,2228,1257187,719,774319,2031506,03/14/2019
2011,Olean,041200,2841,1864162,1004,1059890,2924052,03/14/2019
2011,Salamanca,041600,995,509140,507,399861,909001,03/14/2019
2011,Allegany-Limestone,042001,1614,902840,615,557330,1460170,03/14/2019
2011,West Valley,042204,519,355063,187,241689,596752,03/14/2019
2011,Ellicottville,043601,707,165485,255,114639,280124,03/14/2019
2011,Franklinville,044001,991,549542,357,338412,887954,03/14/2019
2011,Hinsdale,044601,664,314968,242,199815,514783,03/14/2019
2011,Cattaraugus - Little Valley,046402,1545,716915,484,375976,1092891,03/14/2019
2011,Gowanda,047201,1518,661263,585,474661,1135924,03/14/2019
2011,Portville,047401,1132,703022,401,431805,1134827,03/14/2019
2011,Randolph,047601,1199,434060,461,288825,722885,03/14/2019
2011,Yorkshire-Pioneer,048401,3448,1312308,1033,737637,2049945,03/14/2019
2011,Auburn,050100,5524,2803028,2043,1988682,4791710,03/14/2019
2011,Weedsport,052201,1226,776566,329,399571,1176137,03/14/2019
2011,Cato-Meridian,052401,1549,786314,373,354576,1140890,03/14/2019
2011,Southern Cayuga,053001,1313,546117,383,302845,848962,03/14/2019
2011,Port Byron,053801,1356,877208,518,619911,1497119,03/14/2019
2011,Moravia,054201,1408,560068,406,300655,860723,03/14/2019
2011,Union Springs,055401,1288,589165,425,369399,958564,03/14/2019
2011,Dunkirk,060300,2344,1412467,1132,1130851,2543318,03/14/2019
2011,Jamestown,060800,4843,2783001,1815,1691976,4474977,03/14/2019
2011,Southwestern,062201,2258,1340256,819,904321,2244577,03/14/2019
2011,Frewsburg,062401,1100,777659,390,517312,1294971,03/14/2019
2011,Cassadaga Valley,062601,1513,733425,526,447658,1181083,03/14/2019
2011,Chautauqua Lake,062803,1223,294256,494,221238,515494,03/14/2019
2011,Pine Valley,063001,879,476146,322,313703,789849,03/14/2019
2011,Clymer,063201,632,256831,239,188201,445032,03/14/2019
2011,Bemus Point,063601,1156,461370,440,331660,793030,03/14/2019
2011,Falconer,063801,1556,874134,642,643823,1517957,03/14/2019
2011,Silver Creek,064601,1271,660937,489,462226,1123163,03/14/2019
2011,Forestville,064603,927,482186,323,314004,796190,03/14/2019
2011,Panama,064801,837,490360,271,285583,775943,03/14/2019
2011,Fredonia,065801,2215,1466043,750,1011268,2477311,03/14/2019
2011,Brocton,066001,797,659199,318,494690,1153889,03/14/2019
2011,Ripley,066201,456,382890,185,270205,653095,03/14/2019
2011,Sherman,066601,582,299317,166,156625,455942,03/14/2019
2011,Westfield,067201,1022,583279,444,454211,1037490,03/14/2019
2011,Elmira,070400,7958,4685958,2875,3036220,7722178,03/14/2019
2011,Horseheads,073401,5779,3169306,2014,2156532,5325838,03/14/2019
2011,Elmira Heights,073402,1324,851591,507,620337,1471928,03/14/2019
2011,Norwich,081100,2370,1218239,811,751427,1969666,03/14/2019
2011,Afton,082001,857,445381,339,332673,778054,03/14/2019
2011,Bainbridge-Guilford,082201,1179,613404,492,484554,1097958,03/14/2019
2011,Greene,083001,1480,716959,540,497498,1214457,03/14/2019
2011,Unadilla Valley,083803,1074,425494,430,316473,741967,03/14/2019
2011,Georgetown-So Otselic Valley,084401,569,283195,169,150084,433279,03/14/2019
2011,Oxford Academy,084601,1104,575865,431,411332,987197,03/14/2019
2011,Sherburne-Earlville,085601,1742,774804,614,507921,1282725,03/14/2019
2011,Plattsburgh,091300,2116,1361978,757,924385,2286363,03/14/2019
2011,Ausable Valley,092201,2015,950697,710,576170,1526867,03/14/2019
2011,Beekmantown,092401,2830,1354387,832,703892,2058279,03/14/2019
2011,Northeastern Clinton,092801,2055,1156655,620,635027,1791682,03/14/2019
2011,Chazy,093001,723,396900,219,228041,624941,03/14/2019
2011,Northern Adirondack,093601,1455,451022,434,233024,684046,03/14/2019
2011,Peru,094001,2782,1526716,650,651644,2178360,03/14/2019
2011,Saranac,094401,2493,1390194,683,712289,2102483,03/14/2019
2011,Hudson,100600,2115,1014358,875,754606,1768964,03/14/2019
2011,Taconic Hills,102801,2107,705644,748,486054,1191698,03/14/2019
2011,Germantown,103602,919,377727,347,275651,653378,03/14/2019
2011,Chatham,103801,1849,825153,570,480960,1306113,03/14/2019
2011,Kinderhook,104401,3000,1445687,775,731514,2177201,03/14/2019
2011,New Lebanon,104801,862,333605,266,197671,531276,03/14/2019
2011,Cortland,110200,3220,1587580,1061,1030073,2617653,03/14/2019
2011,Cincinnatus,112001,757,359254,289,248467,607721,03/14/2019
2011,Mc Graw,112204,764,426129,239,224336,650465,03/14/2019
2011,Homer,113001,2796,1535258,809,863796,2399054,03/14/2019
2011,Marathon,113401,981,487426,308,280674,768100,03/14/2019
2011,Andes,122002,255,71188,160,82174,153362,03/14/2019
2011,Downsville,122401,387,112290,231,129653,241943,03/14/2019
2011,Charlotte Valley,122601,601,206622,254,164638,371260,03/14/2019
2011,Delhi,122801,1318,509130,524,402281,911411,03/14/2019
2011,Franklin,123201,461,169482,167,118822,288304,03/14/2019
2011,Hancock,123606,480,206087,245,198715,404802,03/14/2019
2011,Margaretville,124601,681,163511,348,162543,326054,03/14/2019
2011,Roxbury,124802,571,216408,254,183450,399858,03/14/2019
2011,Sidney,125001,1435,668938,670,599569,1268507,03/14/2019
2011,Stamford,125201,531,246515,235,208732,455247,03/14/2019
2011,South Kortright,125202,525,213757,258,200061,413818,03/14/2019
2011,Walton,125601,1257,448311,567,387761,836072,03/14/2019
2011,Beacon,130200,3675,2537802,858,1170061,3707863,03/14/2019
2011,Poughkeepsie,131300,3055,1749426,858,982261,2731687,03/14/2019
2011,Dover,132602,1677,1478225,325,605432,2083657,03/14/2019
2011,Hyde Park,133201,5712,4965463,1593,2599461,7564924,03/14/2019
2011,Northeast,133801,992,567146,307,346092,913238,03/14/2019
2011,Pawling,134001,1911,1591939,334,550879,2142818,03/14/2019
2011,Pine Plains,134201,1864,903879,555,524512,1428391,03/14/2019
2011,Arlington,134601,11682,11026810,1967,3602299,14629109,03/14/2019
2011,Spackenkill,134602,1834,1847623,425,571551,2419174,03/14/2019
2011,Red Hook,134801,2400,2089716,653,1122813,3212529,03/14/2019
2011,Rhinebeck,135001,1780,1236917,567,782870,2019787,03/14/2019
2011,Wappingers,135601,15972,10130869,3431,4224610,14355479,03/14/2019
2011,Millbrook,135801,1524,847681,346,384204,1231885,03/14/2019
2011,Buffalo,140200,31221,11221796,8071,4174734,15396530,03/14/2019
2011,Lackawanna,140900,2534,813073,1271,653088,1466161,03/14/2019
2011,Tonawanda,141600,3316,1690476,1325,1309270,2999746,03/14/2019
2011,Alden,142001,2727,1552120,906,990833,2542953,03/14/2019
2011,Amherst,142201,5539,3341108,1471,1744899,5086007,03/14/2019
2011,Williamsville,142203,16295,8748196,4194,4330702,13078898,03/14/2019
2011,Sweet Home,142207,5248,2173203,2218,1841722,4014925,03/14/2019
2011,East Aurora,142401,3020,1309017,888,760518,2069535,03/14/2019
2011,Cheektowaga,143001,3849,1949948,1750,1594785,3544733,03/14/2019
2011,Cheektowaga-Maryvale,143002,3779,2052041,1986,2106807,4158848,03/14/2019
2011,Cleveland Hill,143003,2629,2126833,883,1384455,3511288,03/14/2019
2011,Depew,143007,3248,1993199,1347,1632150,3625349,03/14/2019
2011,Cheektowaga-Sloan,143009,2458,2148385,1260,2149473,4297858,03/14/2019
2011,Clarence,143201,6291,2649087,1637,1250706,3899793,03/14/2019
2011,Springville-Griffith,143801,3029,1509182,923,865540,2374722,03/14/2019
2011,Eden,144001,2453,1334590,731,793810,2128400,03/14/2019
2011,Iroquois,144201,4231,2043109,1365,1294984,3338093,03/14/2019
2011,Evans-Brant,144401,3988,2127583,1179,1076046,3203629,03/14/2019
2011,Grand Island,144601,4958,2755122,1188,1298417,4053539,03/14/2019
2011,Hamburg,144801,5734,3164207,1545,1610534,4774741,03/14/2019
2011,Frontier,144804,8392,3714071,2268,1881630,5595701,03/14/2019
2011,Holland,145001,1688,678082,430,341279,1019361,03/14/2019
2011,Lancaster,145201,9771,4438917,2833,2460984,6899901,03/14/2019
2011,Akron,145601,1968,984753,694,606797,1591550,03/14/2019
2011,North Collins,145801,982,584617,294,330837,915454,03/14/2019
2011,Orchard Park,146001,7781,3996953,1822,1858888,5855841,03/14/2019
2011,Kenmore,146401,14764,8447314,6085,6936167,15383481,03/14/2019
2011,West Seneca,146801,12012,5972885,4670,4479683,10452568,03/14/2019
2011,Crown Point,152203,416,134396,153,90920,225316,03/14/2019
2011,Elizabethtown-Lewis,152401,524,197231,191,136995,334226,03/14/2019
2011,Keene,153001,277,67090,80,38528,105618,03/14/2019
2011,Minerva,153401,213,64799,103,57094,121893,03/14/2019
2011,Moriah,153601,999,514329,456,403315,917644,03/14/2019
2011,Newcomb,153801,122,8310,65,8360,16670,03/14/2019
2011,Lake Placid,154002,1037,249113,352,155540,404653,03/14/2019
2011,Schroon Lake,154601,476,109064,229,96551,205615,03/14/2019
2011,Ticonderoga,154801,1137,299351,483,237625,536976,03/14/2019
2011,Westport,155001,289,114670,146,105060,219730,03/14/2019
2011,Willsboro,155201,527,167369,281,167687,335056,03/14/2019
2011,Tupper Lake,162001,1266,437842,440,272355,710197,03/14/2019
2011,Chateaugay,163401,744,303988,254,186041,490029,03/14/2019
2011,Salmon River,164201,799,284495,316,203438,487933,03/14/2019
2011,Saranac Lake,164601,2235,621953,609,311697,933650,03/14/2019
2011,Malone,164801,3095,1362455,1109,872259,2234714,03/14/2019
2011,Brushton-Moira,165001,1036,496385,346,303212,799597,03/14/2019
2011,St. Regis Falls,165401,502,262143,185,173322,435465,03/14/2019
2011,Gloversville,170500,3163,1909701,1294,1307724,3217425,03/14/2019
2011,Johnstown,170800,2199,1003494,794,676246,1679740,03/14/2019
2011,Broadalbin-Perth,172201,2361,1157796,803,741441,1899237,03/14/2019
2011,Wheelerville,172401,354,101262,144,75950,177212,03/14/2019
2011,Mayfield,173001,1397,646812,518,441921,1088733,03/14/2019
2011,Northville,173201,642,199016,272,159972,358988,03/14/2019
2011,Oppenheim-Ephratah,173401,652,314078,209,178680,492758,03/14/2019
2011,Batavia,180200,3185,2165013,1138,1480167,3645180,03/14/2019
2011,Alexander,182202,1179,775129,384,495630,1270759,03/14/2019
2011,Byron-Bergen,183001,1534,1115377,502,643769,1759146,03/14/2019
2011,Elba,183401,595,367902,204,245692,613594,03/14/2019
2011,Le Roy,183601,1708,1218263,583,780603,1998866,03/14/2019
2011,Oakfield-Alabama,183801,1116,783902,400,525448,1309350,03/14/2019
2011,Pavilion,184001,1119,727151,309,372397,1099548,03/14/2019
2011,Pembroke,184202,1476,863181,534,593431,1456612,03/14/2019
2011,Cairo-Durham,192401,1775,653641,779,549613,1203254,03/14/2019
2011,Catskill,192601,2171,993334,736,648087,1641421,03/14/2019
2011,Coxsackie-Athens,192801,2018,876264,625,528441,1404705,03/14/2019
2011,Greenville,193201,1947,976067,644,631272,1607339,03/14/2019
2011,Hunter-Tannersville,193601,674,193967,291,161808,355775,03/14/2019
2011,Windham-Ashland-Jewett,194601,556,120926,268,115175,236101,03/14/2019
2011,Piseco,202001,86,7323,37,6180,13503,03/14/2019
2011,Indian Lake,202601,315,59715,175,66141,125856,03/14/2019
2011,Inlet,202801,84,9770,48,11155,20925,03/14/2019
2011,Lake Pleasant,203001,176,37792,105,45058,82850,03/14/2019
2011,Long Lake,203201,151,16941,103,22357,39298,03/14/2019
2011,Raquette Lake,203202,21,256,13,311,567,03/14/2019
2011,Wells,203601,213,57754,112,60364,118118,03/14/2019
2011,Little Falls,210900,1323,988878,554,728612,1717490,03/14/2019
2011,West Canada Valley,212402,1099,527805,317,293782,821587,03/14/2019
2011,Frankfort-Schuyler,212602,1408,853688,580,665859,1519547,03/14/2019
2011,Ilion,212801,1671,786957,543,483721,1270678,03/14/2019
2011,Mohawk,212802,1064,594035,447,472038,1066073,03/14/2019
2011,Herkimer,213001,1463,850491,760,810954,1661445,03/14/2019
2011,Dolgeville,213602,1091,434809,405,293680,728489,03/14/2019
2011,Poland,213803,984,356100,323,227550,583650,03/14/2019
2011,Van Hornesville-Owen D. Young,215001,322,159222,117,108791,268013,03/14/2019
2011,Town Of Webb,215401,517,42735,299,47143,89878,03/14/2019
2011,Mount Markham,215601,1556,837448,496,493931,1331379,03/14/2019
2011,Watertown,221800,4061,1125624,1161,619336,1744960,03/14/2019
2011,South Jefferson,222001,2354,762347,600,362894,1125241,03/14/2019
2011,Alexandria,222202,867,261423,324,177297,438720,03/14/2019
2011,Indian River,222401,1887,288342,478,134478,422820,03/14/2019
2011,General Brown,222601,1959,521459,569,283389,804848,03/14/2019
2011,Thousand Islands,223201,1553,503851,591,352156,856007,03/14/2019
2011,Belleville-Henderson,223402,728,171761,293,129244,301005,03/14/2019
2011,Sackets Harbor,223801,646,229071,188,125874,354945,03/14/2019
2011,Lyme,224401,588,170131,244,136559,306690,03/14/2019
2011,La Fargeville,224601,650,180097,184,93913,274010,03/14/2019
2011,Carthage,226001,2668,949018,771,511310,1460328,03/14/2019
2011,Copenhagen,232201,624,172084,167,85719,257803,03/14/2019
2011,Harrisville,232401,534,262063,238,203413,465476,03/14/2019
2011,Lowville,233601,1662,405257,532,243940,649197,03/14/2019
2011,South Lewis,234001,1507,595602,576,400126,995728,03/14/2019
2011,Beaver River,234401,1241,383943,415,245814,629757,03/14/2019
2011,Avon,242001,1322,939596,342,453102,1392698,03/14/2019
2011,Caledonia-Mumford,242201,1338,747828,405,439541,1187369,03/14/2019
2011,Geneseo,242601,1403,669391,352,328793,998184,03/14/2019
2011,Livonia,243401,2637,1539721,638,717544,2257265,03/14/2019
2011,Mount Morris,243601,621,461901,242,323702,785603,03/14/2019
2011,Dansville,243801,2133,1055212,752,677083,1732295,03/14/2019
2011,Dalton-Nunda,244001,1155,684299,384,398757,1083056,03/14/2019
2011,York,245201,1153,722893,334,388316,1111209,03/14/2019
2011,Oneida,251200,2896,1705232,1014,1153547,2858779,03/14/2019
2011,Brookfield,252009,318,128085,100,75262,203347,03/14/2019
2011,Cazenovia,252201,2267,1056823,512,466118,1522941,03/14/2019
2011,De Ruyter,252401,572,293174,177,171754,464928,03/14/2019
2011,Morrisville-Eaton,252601,1058,471006,285,231882,702888,03/14/2019
2011,Hamilton,253201,962,463371,261,240583,703954,03/14/2019
2011,Canastota,253601,2014,1285530,724,878395,2163925,03/14/2019
2011,Madison,254001,603,352492,232,240632,593124,03/14/2019
2011,Stockbridge Valley,254601,616,349750,179,191489,541239,03/14/2019
2011,Chittenango,254801,3240,2011193,954,1186803,3197996,03/14/2019
2011,Rochester,261400,26224,10608784,4578,3039080,13647864,03/14/2019
2011,Brighton,262001,5315,3903989,971,1386090,5290079,03/14/2019
2011,Gates-Chili,262601,7905,5764278,2839,3951524,9715802,03/14/2019
2011,Greece,262801,18669,12759164,5290,7055620,19814784,03/14/2019
2011,East Irondequoit,263401,6743,5509999,2309,3656567,9166566,03/14/2019
2011,West Irondequoit,263403,6351,4940889,1948,3015701,7956590,03/14/2019
2011,Honeoye Falls-Lima,263601,3246,2151888,627,816259,2968147,03/14/2019
2011,Spencerport,263801,5443,3825241,1439,1997337,5822578,03/14/2019
2011,Hilton,264001,6630,4504972,1603,2113915,6618887,03/14/2019
2011,Penfield,264201,7904,5751332,1745,2460499,8211831,03/14/2019
2011,Fairport,264401,9821,6127470,2394,2899868,9027338,03/14/2019
2011,East Rochester,264413,1844,1359580,612,804135,2163715,03/14/2019
2011,Pittsford,264601,8255,5913257,1208,1710015,7623272,03/14/2019
2011,Churchville-Chili,264801,5986,4083058,1489,1978757,6061815,03/14/2019
2011,Rush-Henrietta,265001,9054,5142225,2325,2572839,7715064,03/14/2019
2011,Brockport,265201,4986,3677839,1038,1421667,5099506,03/14/2019
2011,Webster,265401,13207,7984333,3496,4162880,12147213,03/14/2019
2011,Wheatland-Chili,265601,1368,917619,371,461911,1379530,03/14/2019
2011,Amsterdam,270100,4264,2257743,1862,1891839,4149582,03/14/2019
2011,Canajoharie,272201,1312,703304,451,468665,1171969,03/14/2019
2011,Fonda-Fultonville,272801,2020,917409,608,523409,1440818,03/14/2019
2011,Fort Plain,273001,988,755544,409,574653,1330197,03/14/2019
2011,St. Johnsville,273802,599,310000,270,246008,556008,03/14/2019
2011,Glen Cove,280500,3411,3041671,1142,1991951,5033622,03/14/2019
2011,Long Beach,281000,7455,5436684,1106,1616457,7053141,03/14/2019
2011,Hempstead,282001,3251,4225048,498,1316750,5541798,03/14/2019
2011,Uniondale,282002,5591,4946290,862,1560570,6506860,03/14/2019
2011,East Meadow,282003,11247,14259975,2897,6195110,20455085,03/14/2019
2011,North Bellmore,282004,6027,8129477,1168,3183238,11312715,03/14/2019
2011,Levittown,282005,11158,18086412,2343,7686845,25773257,03/14/2019
2011,Seaford,282006,3974,5069606,794,1923693,6993299,03/14/2019
2011,Bellmore,282007,3065,3960310,512,1355152,5315462,03/14/2019
2011,Roosevelt,282008,2415,2738444,366,842627,3581071,03/14/2019
2011,Freeport,282009,6258,7694091,1015,2421904,10115995,03/14/2019
2011,Baldwin,282010,7444,10581178,1100,3025502,13606680,03/14/2019
2011,Oceanside,282011,8787,10100617,1662,3704648,13805265,03/14/2019
2011,Malverne,282012,3199,4501224,576,1658809,6160033,03/14/2019
2011,Valley Stream 13,282013,6227,9254414,1376,1869005,11123419,03/14/2019
2011,Hewlett-Woodmere,282014,4586,7135152,643,2001635,9136787,03/14/2019
2011,Lawrence,282015,6035,4364251,884,1271396,5635647,03/14/2019
2011,Elmont,282016,8493,9590645,1493,3432255,13022900,03/14/2019
2011,Franklin Square,282017,5162,5339140,1349,2861973,8201113,03/14/2019
2011,Garden City,282018,5361,4365205,641,1051318,5416523,03/14/2019
2011,East Rockaway,282019,2080,2756984,514,1341271,4098255,03/14/2019
2011,Lynbrook,282020,3867,5102832,728,1907005,7009837,03/14/2019
2011,Rockville Centre,282021,4835,5727531,689,1579940,7307471,03/14/2019
2011,Floral Park-Bellerose,282022,4373,4420623,792,1589020,6009643,03/14/2019
2011,Wantagh,282023,4423,6004594,698,1938266,7942860,03/14/2019
2011,Valley Stream 24,282024,2614,3347590,514,651915,3999505,03/14/2019
2011,Merrick,282025,4677,6298040,583,1612839,7910879,03/14/2019
2011,Island Trees,282026,3419,4150685,739,1830585,5981270,03/14/2019
2011,West Hempstead,282027,3697,4378158,637,1547159,5925317,03/14/2019
2011,North Merrick,282029,3390,4497284,652,1715267,6212551,03/14/2019
2011,Valley Stream 30,282030,3133,3368436,500,1100380,4468816,03/14/2019
2011,Island Park,282031,1602,1269557,324,526053,1795610,03/14/2019
2011,Westbury,282201,3371,5841514,659,1003720,6845234,03/14/2019
2011,East Williston,282202,1954,2188302,194,443984,2632286,03/14/2019
2011,Roslyn,282203,3960,4656537,330,787283,5443820,03/14/2019
2011,Port Washington,282204,5698,5046290,765,1376925,6423215,03/14/2019
2011,New Hyde Park-Garden City,282205,4868,4908234,1120,2322609,7230843,03/14/2019
2011,Manhasset,282206,3421,2310151,300,415805,2725956,03/14/2019
2011,Great Neck,282207,9395,6226409,1096,1438432,7664841,03/14/2019
2011,Herricks,282209,6069,6884888,946,2206159,9091047,03/14/2019
2011,Mineola,282210,4696,4714880,1075,2208855,6923735,03/14/2019
2011,Carle Place,282211,1957,2147861,407,918103,3065964,03/14/2019
2011,North Shore,282401,3748,3880981,521,399349,4280330,03/14/2019
2011,Syosset,282402,7864,10193561,1077,2247433,12440994,03/14/2019
2011,Locust Valley,282403,3226,2682630,405,692798,3375428,03/14/2019
2011,Plainview-Old Bethpage,282404,7409,10094387,1199,3358203,13452590,03/14/2019
2011,Oyster Bay-East Norwich,282406,2621,1865728,344,488154,2353882,03/14/2019
2011,Jericho,282415,3093,3269746,307,667586,3937332,03/14/2019
2011,Hicksville,282417,7999,7203083,2014,3593206,10796289,03/14/2019
2011,Plainedge,282418,4579,8572069,1073,1938244,10510313,03/14/2019
2011,Bethpage,282421,4169,4604078,1372,2230267,6834345,03/14/2019
2011,Farmingdale,282422,8816,11955165,1926,5310438,17265603,03/14/2019
2011,Massapequa,282423,11679,13991113,2290,5591004,19582117,03/14/2019
2011,Lockport,290900,6406,5064413,1759,2374024,7438437,03/14/2019
2011,Niagara Falls,291100,8188,4221921,3285,2902357,7124278,03/14/2019
2011,North Tonawanda,291200,6619,4070688,2386,2860269,6930957,03/14/2019
2011,Lewiston-Porter,292401,4194,2231316,1482,1568103,3799419,03/14/2019
2011,Newfane,292801,2354,1956076,796,1257715,3213791,03/14/2019
2011,Niagara-Wheatfield,293001,5401,2784250,1838,1726780,4511030,03/14/2019
2011,Starpoint,293201,4283,2809319,1005,1301345,4110664,03/14/2019
2011,Royalton-Hartland,293601,2080,1344229,617,773330,2117559,03/14/2019
2011,Barker,293801,1142,514039,350,303391,817430,03/14/2019
2011,Wilson,294201,1870,1315525,578,790290,2105815,03/14/2019
2011,Rome,301300,6288,3902376,2452,2784623,6686999,03/14/2019
2011,Utica,301600,7855,4297929,3334,3356410,7654339,03/14/2019
2011,Adirondack,302601,1939,817658,715,535287,1352945,03/14/2019
2011,Camden,303001,2835,1203796,998,745200,1948996,03/14/2019
2011,Clinton,304001,2017,1421269,642,838871,2260140,03/14/2019
2011,New Hartford,304801,3793,2454864,1252,1525475,3980339,03/14/2019
2011,New York Mills,304804,838,524223,450,554425,1078648,03/14/2019
2011,Sauquoit Valley,305002,1452,796959,443,466618,1263577,03/14/2019
2011,Remsen,305201,727,464887,244,293137,758024,03/14/2019
2011,Waterville,305401,1107,579726,361,357317,937043,03/14/2019
2011,Holland Patent,305801,2230,1276929,673,712486,1989415,03/14/2019
2011,Sherrill,306000,2650,1541854,1009,1124459,2666313,03/14/2019
2011,Westmoreland,306801,1507,1087012,539,725318,1812330,03/14/2019
2011,Oriskany,307001,948,660612,316,421706,1082318,03/14/2019
2011,Whitesboro,307002,5142,3039588,1839,2125326,5164914,03/14/2019
2011,Syracuse,311500,16672,7485189,4172,3400373,10885562,03/14/2019
2011,West Genesee,312001,7588,4792784,2717,3316840,8109624,03/14/2019
2011,North Syracuse,312403,14573,9195894,3656,4235015,13430909,03/14/2019
2011,East Syracuse-Minoa,312601,5026,3657852,1855,2402367,6060219,03/14/2019
2011,Jamesville-Dewitt,312611,4137,2652436,838,1033712,3686148,03/14/2019
2011,Jordan-Elbridge,312801,1795,1465907,563,786137,2252044,03/14/2019
2011,Fabius-Pompey,313001,1162,905509,304,448712,1354221,03/14/2019
2011,Westhill,313201,2787,2175509,853,1286260,3461769,03/14/2019
2011,Solvay,313202,1877,1395650,871,1249437,2645087,03/14/2019
2011,La Fayette,313407,1080,579969,266,264216,844185,03/14/2019
2011,Baldwinsville,313601,8229,5497697,1958,2486961,7984658,03/14/2019
2011,Fayetteville-Manlius,313801,6153,4541621,1203,1730668,6272289,03/14/2019
2011,Marcellus,314001,2670,1746159,719,918480,2664639,03/14/2019
2011,Onondaga,314201,1555,1315898,420,669743,1985641,03/14/2019
2011,Liverpool,314801,10777,7824128,3177,4325402,12149530,03/14/2019
2011,Lyncourt,314804,865,750901,405,597346,1348247,03/14/2019
2011,Skaneateles,315001,2136,862925,625,498400,1361325,03/14/2019
2011,Tully,315402,1371,734214,314,322260,1056474,03/14/2019
2011,Canandaigua,320200,4701,2543455,1206,1257067,3800522,03/14/2019
2011,Geneva,320500,2711,1721287,1029,1202506,2923793,03/14/2019
2011,East Bloomfield,322601,1374,965275,371,502342,1467617,03/14/2019
2011,Gorham-Middlesex,323201,2225,950826,705,570646,1521472,03/14/2019
2011,Manchester-Shortsville,323601,1166,971170,415,651190,1622360,03/14/2019
2011,Naples,323801,1365,584649,401,334568,919217,03/14/2019
2011,Phelps-Clifton Springs,324001,2338,1674424,635,870982,2545406,03/14/2019
2011,Honeoye,324201,1525,723335,456,411408,1134743,03/14/2019
2011,Victor,324801,5068,2576877,1007,966664,3543541,03/14/2019
2011,Middletown,330900,6060,4801511,1259,1902906,6704417,03/14/2019
2011,Newburgh,331100,10333,8856609,2553,4084836,12941445,03/14/2019
2011,Port Jervis,331300,2850,2817658,928,1682082,4499740,03/14/2019
2011,Washingtonville,332002,5548,5027847,785,1447629,6475476,03/14/2019
2011,Chester,332201,1415,1156924,254,400214,1557138,03/14/2019
2011,Cornwall,332401,3585,3193008,579,1006781,4199789,03/14/2019
2011,Pine Bush,332601,6188,4471711,1066,1477361,5949072,03/14/2019
2011,Goshen,333001,3155,2497203,646,1012819,3510022,03/14/2019
2011,Highland Falls,333601,890,683717,226,333195,1016912,03/14/2019
2011,Minisink Valley,333801,4820,3548744,737,1063684,4612428,03/14/2019
2011,Monroe-Woodbury,334001,8372,8276153,1141,2238053,10514206,03/14/2019
2011,Kiryas Joel Village,334002,686,350356,34,31892,382248,03/14/2019
2011,Valley,334201,5257,4226073,1136,1771772,5997845,03/14/2019
2011,Tuxedo,335003,517,235702,79,72235,307937,03/14/2019
2011,Warwick Valley,335401,5341,4211728,864,1351705,5563433,03/14/2019
2011,Greenwood Lake,335411,1596,1406173,295,513937,1920110,03/14/2019
2011,Florida,335415,1125,1086341,270,516348,1602689,03/14/2019
2011,Albion,342001,2357,1229970,815,786450,2016420,03/14/2019
2011,Kendall,343007,1252,776762,359,427927,1204689,03/14/2019
2011,Holley,343204,1527,1218981,476,701037,1920018,03/14/2019
2011,Medina,343401,2067,1510408,801,1074550,2584958,03/14/2019
2011,Lyndonville,343801,971,525248,318,328687,853935,03/14/2019
2011,Fulton,350400,3769,2879412,1235,1639172,4518584,03/14/2019
2011,Oswego,351200,5263,3030245,1701,1746571,4776816,03/14/2019
2011,Altmar Parish-Williamstown,352002,1710,1075635,500,570198,1645833,03/14/2019
2011,Hannibal,353001,1754,1214462,486,610065,1824527,03/14/2019
2011,Central Square,353201,5715,3103932,1499,1476859,4580791,03/14/2019
2011,Mexico,353401,2952,1493617,748,710270,2203887,03/14/2019
2011,Pulaski,355001,1184,682894,379,403327,1086221,03/14/2019
2011,Sandy Creek,355201,1208,548691,484,397871,946562,03/14/2019
2011,Phoenix,355401,2766,2274914,761,1158873,3433787,03/14/2019
2011,Oneonta,361200,2623,1383046,814,832655,2215701,03/14/2019
2011,Gilbertsville-Mt Upton,362202,667,212595,292,176482,389077,03/14/2019
2011,Cherry Valley-Springfield,362401,896,286267,368,219245,505512,03/14/2019
2011,Edmeston,362801,634,216933,219,146183,363116,03/14/2019
2011,Laurens,363401,563,252563,221,197712,450275,03/14/2019
2011,Schenevus,363601,567,268501,224,197943,466444,03/14/2019
2011,Milford,364001,624,284268,300,259838,544106,03/14/2019
2011,Morris,364201,577,264863,231,200564,465427,03/14/2019
2011,Otego-Unadilla,364801,1407,725527,532,507215,1232742,03/14/2019
2011,Cooperstown,365001,1284,414490,432,255317,669807,03/14/2019
2011,Richfield Springs,365601,833,242583,393,220116,462699,03/14/2019
2011,Worcester,366606,514,262166,257,253568,515734,03/14/2019
2011,Mahopac,372001,6183,7562315,954,2288662,9850977,03/14/2019
2011,Carmel,372002,6909,8420820,1044,2486915,10907735,03/14/2019
2011,Haldane,372601,1100,951405,248,396009,1347414,03/14/2019
2011,Garrison,372604,528,249577,81,88768,338345,03/14/2019
2011,Putnam Valley,372803,2770,4013218,369,1042640,5055858,03/14/2019
2011,Brewster,373001,4957,5430524,873,1928633,7359157,03/14/2019
2011,Rensselaer,381400,1381,636961,382,318537,955498,03/14/2019
2011,Troy,381700,4283,2336414,1190,1222059,3558473,03/14/2019
2011,Lansingburgh,381701,2757,1304212,860,782555,2086767,03/14/2019
2011,Berlin,382001,1595,684739,400,325572,1010311,03/14/2019
2011,Brunswick,382202,1863,949469,539,513706,1463175,03/14/2019
2011,East Greenbush,382401,6955,3509702,1620,1603520,5113222,03/14/2019
2011,Hoosick Falls,382801,1702,865790,544,499064,1364854,03/14/2019
2011,North Greenbush,383201,356,68715,119,45717,114432,03/14/2019
2011,Wynantskill,383204,895,525305,277,321316,846621,03/14/2019
2011,Averill Park,384001,4755,2302093,988,939276,3241369,03/14/2019
2011,Hoosic Valley,384201,1615,808604,393,379099,1187703,03/14/2019
2011,Schodack,384401,1510,877383,347,397965,1275348,03/14/2019
2011,Clarkstown,392001,11421,10955489,1849,3535762,14491251,03/14/2019
2011,Nanuet,392008,2429,2473371,581,1145509,3618880,03/14/2019
2011,Haverstraw-Stony Point,392201,8595,14113852,1903,5651634,19765486,03/14/2019
2011,South Orangetown,392401,4426,4976265,962,2159706,7135971,03/14/2019
2011,Nyack,392404,4141,5522383,794,2156472,7678855,03/14/2019
2011,Pearl River,392408,3267,3991837,725,1764989,5756826,03/14/2019
2011,Ramapo,392601,5744,9435326,1201,3622352,13057678,03/14/2019
2011,East Ramapo,392602,11828,12950798,1803,3583170,16533968,03/14/2019
2011,Ogdensburg,401200,2132,1499378,725,775228,2274606,03/14/2019
2011,Brasher Falls,402001,1341,836664,467,512746,1349410,03/14/2019
2011,Canton,402201,1788,980455,514,522143,1502598,03/14/2019
2011,Clifton-Fine,402601,490,161597,240,127415,289012,03/14/2019
2011,Colton-Pierrepont,402801,638,253724,248,181103,434827,03/14/2019
2011,Edwards-Knox,403401,731,232173,245,134788,366961,03/14/2019
2011,Gouverneur,404001,2013,719223,638,405150,1124373,03/14/2019
2011,Hammond,404201,419,163205,164,110340,273545,03/14/2019
2011,Hermon-Dekalb,404401,553,293117,203,192413,485530,03/14/2019
2011,Lisbon,405002,788,406919,274,253535,660454,03/14/2019
2011,Madrid-Waddington,405601,974,497410,380,357451,854861,03/14/2019
2011,Massena,405801,3431,1734512,1347,1230176,2964688,03/14/2019
2011,Morristown,406001,641,267157,248,197958,465115,03/14/2019
2011,Norwood-Norfolk,406201,1422,1020397,513,657855,1678252,03/14/2019
2011,Heuvelton,406404,852,507490,295,322820,830310,03/14/2019
2011,Parishville-Hopkinton,406601,648,236955,209,139422,376377,03/14/2019
2011,Potsdam,407402,1919,1296021,528,649878,1945899,03/14/2019
2011,Mechanicville,411000,1651,937842,557,634539,1572381,03/14/2019
2011,Saratoga Springs,411500,9552,4327541,1814,1595040,5922581,03/14/2019
2011,Burnt Hills-Ballston Lake,412001,4985,3142232,1248,1556092,4698324,03/14/2019
2011,Shenendehowa,412402,14351,9393571,2212,2848350,12241921,03/14/2019
2011,Corinth,412601,1589,697078,524,413864,1110942,03/14/2019
2011,Edinburg,413001,345,58166,158,50166,108332,03/14/2019
2011,Galway,413201,1674,785583,460,400972,1186555,03/14/2019
2011,Ballston Spa,414201,5582,4206856,1195,1615457,5822313,03/14/2019
2011,South Glens Falls,414401,3922,2357082,1152,1317221,3674303,03/14/2019
2011,Schuylerville,415001,2388,1738637,505,683635,2422272,03/14/2019
2011,Stillwater,415201,1734,796364,403,351438,1147802,03/14/2019
2011,Waterford-Halfmoon,415401,996,816406,393,569744,1386150,03/14/2019
2011,Schenectady,421500,8533,5341596,2432,2800017,8141613,03/14/2019
2011,Duanesburg,422001,1342,622170,274,246838,869008,03/14/2019
2011,Scotia-Glenville,422202,4308,2315516,1146,1217141,3532657,03/14/2019
2011,Niskayuna,422401,6157,3192847,946,980815,4173662,03/14/2019
2011,Schalmont,422801,3340,1738886,985,1024280,2763166,03/14/2019
2011,Rotterdam-Mohonasen,422803,4848,2192595,1915,1724924,3917519,03/14/2019
2011,Cobleskill-Richmondville,432602,2472,1284947,879,848951,2133898,03/14/2019
2011,Gilboa-Conesville,433401,551,197701,277,181888,379589,03/14/2019
2011,Jefferson,433601,437,171248,169,124421,295669,03/14/2019
2011,Middleburgh,433801,1299,734943,482,503950,1238893,03/14/2019
2011,Schoharie,434201,1566,922050,465,524049,1446099,03/14/2019
2011,Sharon Springs,434601,414,240118,171,188713,428831,03/14/2019
2011,Odessa-Montour,442001,1224,625596,417,403172,1028768,03/14/2019
2011,Watkins Glen,442401,1804,642654,683,457228,1099882,03/14/2019
2011,South Seneca,452801,1366,638145,502,425106,1063251,03/14/2019
2011,Romulus,453003,719,409172,240,260465,669637,03/14/2019
2011,Seneca Falls,453201,1908,1389642,723,993975,2383617,03/14/2019
2011,Waterloo,453801,2274,1421682,815,957113,2378795,03/14/2019
2011,Corning,460300,7144,5174570,2173,2841676,8016246,03/14/2019
2011,Hornell,460600,1865,941625,617,547315,1488940,03/14/2019
2011,Addison,462001,1468,887710,482,487258,1374968,03/14/2019
2011,Avoca,462201,797,324588,275,196696,521284,03/14/2019
2011,Bath,462402,1842,1018529,661,696183,1714712,03/14/2019
2011,Bradford,462601,471,243217,162,152144,395361,03/14/2019
2011,Campbell-Savona,463002,1200,730198,413,458402,1188600,03/14/2019
2011,Canisteo-Greenwood,463202,1307,676752,515,468376,1145128,03/14/2019
2011,Arkport,465201,650,391467,322,319224,710691,03/14/2019
2011,Jasper-Troupsburg,465601,646,258910,229,166066,424976,03/14/2019
2011,Prattsburgh,466001,650,274081,227,172620,446701,03/14/2019
2011,Hammondsport,467201,1018,301469,444,247555,549024,03/14/2019
2011,Wayland-Cohocton,467401,2035,977568,699,593328,1570896,03/14/2019
2011,Babylon,472001,2625,3307323,392,951368,4258691,03/14/2019
2011,West Babylon,472002,5314,6148334,1078,2428854,8577188,03/14/2019
2011,North Babylon,472003,6386,7113260,1446,3164090,10277350,03/14/2019
2011,Lindenhurst,472004,8243,10132074,1781,4262540,14394614,03/14/2019
2011,Copiague,472005,4969,5678495,1181,2496505,8175000,03/14/2019
2011,Amityville,472006,4253,4846587,1104,1798892,6645479,03/14/2019
2011,Deer Park,472007,5105,5938307,1405,3170183,9108490,03/14/2019
2011,Wyandanch,472009,1176,1433248,199,464404,1897652,03/14/2019
2011,Three Village,472201,8981,9553560,1572,3296780,12850340,03/14/2019
2011,Brookhaven-Comsewogue,472203,4413,4543992,919,1818750,6362742,03/14/2019
2011,South Country,472204,5068,4894790,763,1442486,6337276,03/14/2019
2011,Sachem,472205,17162,14727616,2785,4649414,19377030,03/14/2019
2011,Port Jefferson,472206,1508,909125,242,292300,1201425,03/14/2019
2011,Mount Sinai,472207,3118,3448377,576,1263003,4711380,03/14/2019
2011,Miller Place,472208,3728,4096301,425,920962,5017263,03/14/2019
2011,Rocky Point,472209,3990,4781521,507,1193812,5975333,03/14/2019
2011,Middle Country,472211,11962,12623486,2400,4963397,17586883,03/14/2019
2011,Longwood,472212,12322,13499995,3164,6273245,19773240,03/14/2019
2011,Patchogue-Medford,472224,9542,10207606,1692,3412480,13620086,03/14/2019
2011,William Floyd,472232,9487,11004538,1396,3059474,14064012,03/14/2019
2011,Center Moriches,472233,1688,1969945,258,586015,2555960,03/14/2019
2011,East Moriches,472234,1302,1473693,178,406746,1880439,03/14/2019
2011,Eastport- South Manor,472235,4180,4581533,868,1634376,6215909,03/14/2019
2011,East Hampton,472401,1116,231476,360,140443,371919,03/14/2019
2011,Wainscott,472402,94,7711,26,4227,11938,03/14/2019
2011,Amagansett,472403,197,24205,92,22174,46379,03/14/2019
2011,Springs,472404,916,350486,302,227009,577495,03/14/2019
2011,Sag Harbor,472405,1179,353781,446,266453,620234,03/14/2019
2011,Montauk,472406,613,114129,240,112898,227027,03/14/2019
2011,Elwood,472601,3098,3453503,589,1319103,4772606,03/14/2019
2011,Cold Spring Harbor,472602,1652,1575882,129,252080,1827962,03/14/2019
2011,Huntington,472603,7279,7741366,1184,2468241,10209607,03/14/2019
2011,Northport-East Northport,472604,8700,7336587,1458,2467634,9804221,03/14/2019
2011,Half Hollow Hills,472605,10462,9298223,1848,3095819,12394042,03/14/2019
2011,Harborfields,472606,4480,4927736,728,1607767,6535503,03/14/2019
2011,Commack,472610,8981,10692325,1821,4365861,15058186,03/14/2019
2011,South Huntington,472613,8452,9370179,1720,3816015,13186194,03/14/2019
2011,Bay Shore,472801,5717,6484751,1097,2421187,8905938,03/14/2019
2011,Islip,472802,3892,4735201,719,1576365,6311566,03/14/2019
2011,East Islip,472803,5437,5989601,1107,2663584,8653185,03/14/2019
2011,Sayville,472804,4041,4476730,852,1856568,6333298,03/14/2019
2011,Bayport-Blue Point,472805,3051,3824330,500,1258362,5082692,03/14/2019
2011,Hauppauge,472806,4991,3302968,1039,1353135,4656103,03/14/2019
2011,Connetquot,472807,8593,9076608,1745,3540552,12617160,03/14/2019
2011,West Islip,472809,6459,6689863,1297,2691639,9381502,03/14/2019
2011,Brentwood,472812,9834,7288818,2049,3034726,10323544,03/14/2019
2011,Central Islip,472813,5662,7330201,999,2516829,9847030,03/14/2019
2011,Fire Island,472814,100,10666,20,4286,14952,03/14/2019
2011,Shoreham-Wading River,473001,3139,3082607,763,1424264,4506871,03/14/2019
2011,Riverhead,473002,6655,5080151,2619,3246242,8326393,03/14/2019
2011,Shelter Island,473201,566,100058,232,82032,182090,03/14/2019
2011,Smithtown,473401,12157,13952626,2396,5136726,19089352,03/14/2019
2011,Kings Park,473405,5260,5226800,939,1857282,7084082,03/14/2019
2011,Remsenburg-Speonk,473601,399,120048,82,48933,168981,03/14/2019
2011,Westhampton Beach,473602,943,319531,233,152183,471714,03/14/2019
2011,Quogue,473603,192,22259,40,9336,31595,03/14/2019
2011,Hampton Bays,473605,2097,1434049,719,977091,2411140,03/14/2019
2011,Southhampton,473606,1494,212007,506,142886,354893,03/14/2019
2011,Bridgehampton,473609,231,21284,77,14213,35497,03/14/2019
2011,Sagaponack,473610,53,1244,7,329,1573,03/14/2019
2011,Tuckahoe Common,473613,465,187615,165,132348,319963,03/14/2019
2011,East Quogue,473617,1072,623611,291,324877,948488,03/14/2019
2011,Oysterponds,473802,361,86442,176,84915,171357,03/14/2019
2011,Fishers Island,473804,30,7124,4,1914,9038,03/14/2019
2011,Southold,473805,1483,740942,575,577257,1318199,03/14/2019
2011,Greenport,473810,590,313991,275,298521,612512,03/14/2019
2011,Mattituck-Cutchogue,473812,2089,1122984,651,703389,1826373,03/14/2019
2011,New Suffolk,473815,74,13500,37,13547,27047,03/14/2019
2011,Fallsburg,482801,1255,801610,341,400943,1202553,03/14/2019
2011,Eldred,483401,1081,409406,388,285532,694938,03/14/2019
2011,Liberty,483601,1378,900795,565,706156,1606951,03/14/2019
2011,Tri-Valley,484201,1265,640487,353,327281,967768,03/14/2019
2011,Roscoe,484401,373,145526,176,135374,280900,03/14/2019
2011,Livingston Manor,484402,614,239951,260,190975,430926,03/14/2019
2011,Monticello,484601,3204,1434801,1062,924488,2359289,03/14/2019
2011,Sullivan West,484802,2144,782986,880,624051,1407037,03/14/2019
2011,Waverly,492001,1829,830736,695,581199,1411935,03/14/2019
2011,Candor,492401,1042,535057,379,370153,905210,03/14/2019
2011,Newark Valley,492602,1728,940043,574,602004,1542047,03/14/2019
2011,Owego-Apalachin,493001,2933,1612771,1045,1086695,2699466,03/14/2019
2011,Spencer-Van Etten,493401,1304,559422,457,363277,922699,03/14/2019
2011,Tioga,493603,1209,331771,378,195523,527294,03/14/2019
2011,Ithaca,500700,8196,4216508,1681,1549949,5766457,03/14/2019
2011,Dryden,502401,2517,1666638,605,678318,2344956,03/14/2019
2011,Groton,502801,1338,803423,350,383521,1186944,03/14/2019
2011,Lansing,503201,1737,981953,367,395525,1377478,03/14/2019
2011,Newfield,503401,1035,546850,340,282146,828996,03/14/2019
2011,Trumansburg,503601,1713,980294,435,455034,1435328,03/14/2019
2011,Kingston,510800,8568,5388391,2792,3450932,8839323,03/14/2019
2011,Highland,513203,2409,1624830,551,718314,2343144,03/14/2019
2011,Rondout Valley,513401,3638,2108006,1048,1167063,3275069,03/14/2019
2011,Marlboro,513601,2469,1840624,543,771920,2612544,03/14/2019
2011,New Paltz,513801,3199,1942246,660,793542,2735788,03/14/2019
2011,Onteora,514001,3453,1404955,1234,961902,2366857,03/14/2019
2011,Saugerties,514801,4362,2634738,1334,1587007,4221745,03/14/2019
2011,Wallkill,515201,3972,3173926,962,1213474,4387400,03/14/2019
2011,Ellenville,515602,1691,1115121,573,645460,1760581,03/14/2019
2011,Glens Falls,520500,2829,1400477,839,815060,2215537,03/14/2019
2011,Bolton,522001,385,55375,157,43530,98905,03/14/2019
2011,Lake George,522201,1424,253984,469,164745,418729,03/14/2019
2011,North Warren,522402,1035,239117,469,199572,438689,03/14/2019
2011,Johnsburg,523001,548,188270,243,157660,345930,03/14/2019
2011,Hadley-Luzerne,523201,1330,419844,564,335988,755832,03/14/2019
2011,Queensbury,523402,4512,1891785,1174,941034,2832819,03/14/2019
2011,Glens Falls Common,523418,260,93002,90,62419,155421,03/14/2019
2011,Warrensburg,524001,1243,508049,471,371333,879382,03/14/2019
2011,Argyle,532001,924,405238,286,239951,645189,03/14/2019
2011,Fort Ann,532802,829,343123,239,187368,530491,03/14/2019
2011,Fort Edward,533001,545,254026,199,183556,437582,03/14/2019
2011,Granville,533201,1527,677398,518,426603,1104001,03/14/2019
2011,Greenwich,533401,1465,675542,486,435366,1110908,03/14/2019
2011,Hartford,533801,709,343150,209,195996,539146,03/14/2019
2011,Hudson Falls,534401,2655,1040902,997,760722,1801624,03/14/2019
2011,Putnam,534601,163,28367,57,18152,46519,03/14/2019
2011,Salem,534801,877,352927,348,255047,607974,03/14/2019
2011,Cambridge,535010,1336,545774,554,424695,970469,03/14/2019
2011,Whitehall,535201,914,267148,385,204993,472141,03/14/2019
2011,Newark,542001,2843,1754999,934,1096485,2851484,03/14/2019
2011,Clyde-Savannah,542401,1155,819945,411,527908,1347853,03/14/2019
2011,Lyons,542801,1203,710735,425,439373,1150108,03/14/2019
2011,Gananda,543002,1499,1315617,125,215682,1531299,03/14/2019
2011,Marion,543201,1357,934005,328,428808,1362813,03/14/2019
2011,Wayne,543401,3703,2307709,834,1017649,3325358,03/14/2019
2011,Palmyra-Macedon,543601,2608,1940205,789,1104635,3044840,03/14/2019
2011,Sodus,544201,1503,888116,581,613465,1501581,03/14/2019
2011,Williamson,544602,1548,1099029,459,663617,1762646,03/14/2019
2011,North Rose-Wolcott,544801,1833,846089,711,607309,1453398,03/14/2019
2011,Red Creek,544803,1196,489214,410,311733,800947,03/14/2019
2011,Mount Vernon,550800,4997,13198275,1432,6290730,19489005,03/14/2019
2011,New Rochelle,551000,8898,16494722,1578,5360399,21855121,03/14/2019
2011,Peekskill,551200,3381,6471953,623,2129014,8600967,03/14/2019
2011,Rye,551400,2142,2461714,295,702817,3164531,03/14/2019
2011,White Plains,551700,7217,14090501,1090,3608039,17698540,03/14/2019
2011,Yonkers,551800,17694,26977911,4280,10147706,37125617,03/14/2019
2011,Katonah-Lewisboro,552001,4744,7567748,473,1390703,8958451,03/14/2019
2011,Bedford,552002,4504,5222021,707,1506133,6728154,03/14/2019
2011,Croton-Harmon,552202,2202,3749200,283,920965,4670165,03/14/2019
2011,Hendrick Hudson,552203,3336,5030149,509,1364520,6394669,03/14/2019
2011,Eastchester,552401,3051,6565149,617,2314270,8879419,03/14/2019
2011,Tuckahoe,552402,1243,2210741,195,639296,2850037,03/14/2019
2011,Bronxville,552403,707,1490185,49,289712,1779897,03/14/2019
2011,Tarrytowns,552601,2340,5010335,470,1854953,6865288,03/14/2019
2011,Irvington,552602,1582,3208531,218,880715,4089246,03/14/2019
2011,Dobbs Ferry,552603,1342,3130732,219,988190,4118922,03/14/2019
2011,Hastings On Hudson,552604,1600,3878226,287,1302903,5181129,03/14/2019
2011,Ardsley,552605,2361,4341416,331,1214351,5555767,03/14/2019
2011,Edgemont,552606,1332,3017210,137,602198,3619408,03/14/2019
2011,Greenburgh,552607,3966,6373961,935,2483160,8857121,03/14/2019
2011,Elmsford,552609,1281,1908673,323,955867,2864540,03/14/2019
2011,Harrison,552801,2937,3153955,638,1297385,4451340,03/14/2019
2011,Mamaroneck,553201,4147,6040519,578,1533788,7574307,03/14/2019
2011,Mount Pleasant,553401,2657,3646131,709,1932235,5578366,03/14/2019
2011,Pocantico Hills,553402,437,333578,92,136848,470426,03/14/2019
2011,Valhalla,553405,1779,2840489,417,1297026,4137515,03/14/2019
2011,Pleasantville,553409,1849,3351633,347,1131616,4483249,03/14/2019
2011,Chappaqua,553604,3513,5599485,242,762111,6361596,03/14/2019
2011,Byram Hills,553801,2477,2907687,231,539952,3447639,03/14/2019
2011,North Salem,554001,1710,2177473,273,659093,2836566,03/14/2019
2011,Ossining,554201,5768,11722080,824,3186561,14908641,03/14/2019
2011,Briarcliff Manor,554202,1526,2790830,112,404515,3195345,03/14/2019
2011,Pelham,554401,2130,3709302,348,1087287,4796589,03/14/2019
2011,Rye Neck,554801,1419,2098088,251,633613,2731701,03/14/2019
2011,Port Chester-Rye,554804,2854,4518407,851,2190394,6708801,03/14/2019
2011,Blind Brook-Rye,554805,1494,2064890,158,437478,2502368,03/14/2019
2011,Scarsdale,555001,3160,4089313,215,556247,4645560,03/14/2019
2011,Somers,555201,4945,7393876,1298,3515784,10909660,03/14/2019
2011,Lakeland,555401,8390,16132086,1808,5771415,21903501,03/14/2019
2011,Yorktown,555402,5009,9394542,687,2496107,11890649,03/14/2019
2011,Attica,562201,2333,1171186,660,655134,1826320,03/14/2019
2011,Letchworth,562601,1401,598683,405,318994,917677,03/14/2019
2011,Wyoming,563802,442,243523,98,103191,346714,03/14/2019
2011,Perry,564201,1212,596684,436,412412,1009096,03/14/2019
2011,Warsaw,564801,1361,901802,379,485443,1387245,03/14/2019
2011,Penn Yan,573001,2946,934535,1099,660440,1594975,03/14/2019
2011,Dundee,573401,1147,376153,475,287054,663207,03/14/2019
2011,New York City School,650000,562404,156717572,107614,56068411,212785983,03/14/2019
2010,Albany,010100,10513,6190380,3137,3499764,9690144,03/14/2019
2010,Cohoes,010300,2256,1322567,655,717287,2039854,03/14/2019
2010,Watervliet,011800,1349,530650,451,347196,877846,03/14/2019
2010,Berne-Knox-Westerlo,012001,1747,893484,393,377246,1270730,03/14/2019
2010,Bethlehem,012206,7177,4078184,1091,1236765,5314949,03/14/2019
2010,Ravena-Coeymans-Selkirk,012402,3030,1740879,730,809586,2550465,03/14/2019
2010,South Colonie,012601,9264,4547837,2597,2475285,7023122,03/14/2019
2010,North Colonie,012605,8250,3674929,1678,1465933,5140862,03/14/2019
2010,Menands,012615,414,197609,96,90918,288527,03/14/2019
2010,Green Island,012801,284,159658,127,142001,301659,03/14/2019
2010,Guilderland,013002,7752,3815582,1424,1396679,5212261,03/14/2019
2010,Voorheesville,013403,2075,1056487,358,365135,1421622,03/14/2019
2010,Alfred-Almond,022001,899,593549,271,320757,914306,03/14/2019
2010,Andover,023001,496,373559,223,230424,603983,03/14/2019
2010,Genesee Valley,023202,762,357617,354,272370,629987,03/14/2019
2010,Belfast,023401,473,218668,175,137968,356636,03/14/2019
2010,Canaseraga,024002,394,227434,143,134910,362344,03/14/2019
2010,Cuba-Rushford,024801,1406,622375,550,428419,1050794,03/14/2019
2010,Friendship,025001,401,281475,157,176046,457521,03/14/2019
2010,Fillmore,025801,833,339079,269,185725,524804,03/14/2019
2010,Whitesville,026001,244,146524,85,78289,224813,03/14/2019
2010,Scio,026601,486,325114,192,213682,538796,03/14/2019
2010,Wellsville,027001,1747,1230962,760,858109,2089071,03/14/2019
2010,Bolivar-Richburg,027602,1023,510560,355,275573,786133,03/14/2019
2010,Binghamton,030200,6356,3686620,2396,2533123,6219743,03/14/2019
2010,Chenango Forks,032001,2211,1388185,666,785676,2173861,03/14/2019
2010,South Mountain-Hickory,032201,150,22274,20,5950,28224,03/14/2019
2010,Harpursville,032601,1171,464016,353,249927,713943,03/14/2019
2010,Susquehanna Valley,032801,2530,1890535,823,1194782,3085317,03/14/2019
2010,Chenango Valley,033001,2760,2075182,1112,1627867,3703049,03/14/2019
2010,Maine-Endwell,033801,3630,2553981,1292,1732684,4286665,03/14/2019
2010,Deposit,034201,774,329361,285,230138,559499,03/14/2019
2010,Whitney Point,034401,1872,991816,558,563495,1555311,03/14/2019
2010,Union-Endicott,034601,5812,3726450,2310,2914107,6640557,03/14/2019
2010,Johnson City,034602,3301,2013055,1437,1662679,3675734,03/14/2019
2010,Vestal,034801,5936,3608813,1809,2116471,5725284,03/14/2019
2010,Windsor,035001,2267,1263469,698,724369,1987838,03/14/2019
2010,Olean,041200,2933,1908985,971,1009454,2918439,03/14/2019
2010,Salamanca,041600,1039,522507,501,383167,905674,03/14/2019
2010,Allegany-Limestone,042001,1639,899350,593,524846,1424196,03/14/2019
2010,West Valley,042204,531,358477,179,229600,588077,03/14/2019
2010,Ellicottville,043601,745,175225,235,105460,280685,03/14/2019
2010,Franklinville,044001,1014,561306,335,316532,877838,03/14/2019
2010,Hinsdale,044601,674,313798,233,185993,499791,03/14/2019
2010,Cattaraugus - Little Valley,046402,1589,756826,456,359697,1116523,03/14/2019
2010,Gowanda,047201,1547,679117,574,469127,1148244,03/14/2019
2010,Portville,047401,1144,696010,385,410659,1106669,03/14/2019
2010,Randolph,047601,1237,478204,441,294414,772618,03/14/2019
2010,Yorkshire-Pioneer,048401,3516,1351484,989,721387,2072871,03/14/2019
2010,Auburn,050100,5613,2803559,2016,1914291,4717850,03/14/2019
2010,Weedsport,052201,1239,785991,317,380685,1166676,03/14/2019
2010,Cato-Meridian,052401,1488,787995,354,334018,1122013,03/14/2019
2010,Southern Cayuga,053001,1340,578122,394,312038,890160,03/14/2019
2010,Port Byron,053801,1374,885665,519,625540,1511205,03/14/2019
2010,Moravia,054201,1462,604019,374,286350,890369,03/14/2019
2010,Union Springs,055401,1315,620000,413,360727,980727,03/14/2019
2010,Dunkirk,060300,2407,1457530,1130,1129699,2587229,03/14/2019
2010,Jamestown,060800,4927,2802382,1766,1638816,4441198,03/14/2019
2010,Southwestern,062201,2304,1368913,788,868312,2237225,03/14/2019
2010,Frewsburg,062401,1096,759949,381,496347,1256296,03/14/2019
2010,Cassadaga Valley,062601,1551,757356,493,419648,1177004,03/14/2019
2010,Chautauqua Lake,062803,1262,295281,461,199876,495157,03/14/2019
2010,Pine Valley,063001,897,494532,306,303024,797556,03/14/2019
2010,Clymer,063201,639,273777,231,190040,463817,03/14/2019
2010,Bemus Point,063601,1197,475751,431,323328,799079,03/14/2019
2010,Falconer,063801,1579,871886,621,608692,1480578,03/14/2019
2010,Silver Creek,064601,1300,662996,472,440669,1103665,03/14/2019
2010,Forestville,064603,944,482416,310,294726,777142,03/14/2019
2010,Panama,064801,836,495834,265,280875,776709,03/14/2019
2010,Fredonia,065801,2297,1491758,704,927672,2419430,03/14/2019
2010,Brocton,066001,824,664216,301,418461,1082677,03/14/2019
2010,Ripley,066201,477,420151,169,253553,673704,03/14/2019
2010,Sherman,066601,584,298449,161,150406,448855,03/14/2019
2010,Westfield,067201,1067,601561,421,437162,1038723,03/14/2019
2010,Elmira,070400,8077,4642368,2841,2912702,7555070,03/14/2019
2010,Horseheads,073401,5879,3161128,1954,2053367,5214495,03/14/2019
2010,Elmira Heights,073402,1346,847539,494,590354,1437893,03/14/2019
2010,Norwich,081100,2381,1207670,827,753391,1961061,03/14/2019
2010,Afton,082001,874,466434,335,329614,796048,03/14/2019
2010,Bainbridge-Guilford,082201,1189,624617,490,483955,1108572,03/14/2019
2010,Greene,083001,1483,716386,550,503677,1220063,03/14/2019
2010,Unadilla Valley,083803,1136,464489,430,322825,787314,03/14/2019
2010,Georgetown-So Otselic Valley,084401,588,289864,159,137544,427408,03/14/2019
2010,Oxford Academy,084601,1134,587478,432,409362,996840,03/14/2019
2010,Sherburne-Earlville,085601,1770,785865,596,494515,1280380,03/14/2019
2010,Plattsburgh,091300,2160,1364495,733,876349,2240844,03/14/2019
2010,Ausable Valley,092201,2035,962846,683,550423,1513269,03/14/2019
2010,Beekmantown,092401,2875,1345448,824,676280,2021728,03/14/2019
2010,Northeastern Clinton,092801,2102,1201186,586,606442,1807628,03/14/2019
2010,Chazy,093001,732,391805,212,213870,605675,03/14/2019
2010,Northern Adirondack,093601,1466,460063,421,226848,686911,03/14/2019
2010,Peru,094001,2817,1515345,631,615311,2130656,03/14/2019
2010,Saranac,094401,2494,1362668,674,683860,2046528,03/14/2019
2010,Hudson,100600,2208,1054910,877,740982,1795892,03/14/2019
2010,Taconic Hills,102801,2220,735534,732,466644,1202178,03/14/2019
2010,Germantown,103602,950,388943,345,261932,650875,03/14/2019
2010,Chatham,103801,1955,872074,519,439968,1312042,03/14/2019
2010,Kinderhook,104401,3070,1454469,737,680401,2134870,03/14/2019
2010,New Lebanon,104801,911,360441,238,179774,540215,03/14/2019
2010,Cortland,110200,3192,1542801,1064,1011217,2554018,03/14/2019
2010,Cincinnatus,112001,759,354336,278,235227,589563,03/14/2019
2010,Mc Graw,112204,798,416539,236,228403,644942,03/14/2019
2010,Homer,113001,2846,1542833,789,830704,2373537,03/14/2019
2010,Marathon,113401,985,501158,295,274065,775223,03/14/2019
2010,Andes,122002,266,80892,153,84503,165395,03/14/2019
2010,Downsville,122401,396,114977,235,130135,245112,03/14/2019
2010,Charlotte Valley,122601,602,206260,253,163723,369983,03/14/2019
2010,Delhi,122801,1351,528008,526,403597,931605,03/14/2019
2010,Franklin,123201,471,170912,166,114491,285403,03/14/2019
2010,Hancock,123606,497,224168,227,183968,408136,03/14/2019
2010,Margaretville,124601,703,175591,333,153172,328763,03/14/2019
2010,Roxbury,124802,584,247712,246,190804,438516,03/14/2019
2010,Sidney,125001,1454,714493,655,614022,1328515,03/14/2019
2010,Stamford,125201,536,251264,232,205453,456717,03/14/2019
2010,South Kortright,125202,541,220472,247,189894,410366,03/14/2019
2010,Walton,125601,1267,445783,561,378529,824312,03/14/2019
2010,Beacon,130200,3758,2575557,817,1112129,3687686,03/14/2019
2010,Poughkeepsie,131300,3145,1765591,801,896229,2661820,03/14/2019
2010,Dover,132602,1697,1457849,297,548108,2005957,03/14/2019
2010,Hyde Park,133201,5828,4972404,1494,2416855,7389259,03/14/2019
2010,Northeast,133801,1028,597539,297,336297,933836,03/14/2019
2010,Pawling,134001,1975,1612529,324,523945,2136474,03/14/2019
2010,Pine Plains,134201,1958,930883,520,480663,1411546,03/14/2019
2010,Arlington,134601,11978,11145796,1836,3318128,14463924,03/14/2019
2010,Spackenkill,134602,1900,1710293,395,667428,2377721,03/14/2019
2010,Red Hook,134801,2466,2098827,603,1017476,3116303,03/14/2019
2010,Rhinebeck,135001,1899,1292374,532,719459,2011833,03/14/2019
2010,Wappingers,135601,16338,10206689,3172,3801627,14008316,03/14/2019
2010,Millbrook,135801,1549,844703,341,371748,1216451,03/14/2019
2010,Buffalo,140200,31863,11405156,8361,4256560,15661716,03/14/2019
2010,Lackawanna,140900,2530,796519,1315,641641,1438160,03/14/2019
2010,Tonawanda,141600,3355,1714203,1318,1302141,3016344,03/14/2019
2010,Alden,142001,2772,1544490,860,917980,2462470,03/14/2019
2010,Amherst,142201,5848,3457390,1295,1502767,4960157,03/14/2019
2010,Williamsville,142203,17213,9050939,3663,3694632,12745571,03/14/2019
2010,Sweet Home,142207,5401,2191276,2087,1693272,3884548,03/14/2019
2010,East Aurora,142401,3092,1313241,845,708510,2021751,03/14/2019
2010,Cheektowaga,143001,3865,1930211,1738,1551595,3481806,03/14/2019
2010,Cheektowaga-Maryvale,143002,3833,2046359,1970,2035651,4082010,03/14/2019
2010,Cleveland Hill,143003,2679,2123499,863,1318062,3441561,03/14/2019
2010,Depew,143007,3299,2006747,1302,1553960,3560707,03/14/2019
2010,Cheektowaga-Sloan,143009,2450,2088288,1284,2134495,4222783,03/14/2019
2010,Clarence,143201,6658,2802571,1442,1086665,3889236,03/14/2019
2010,Springville-Griffith,143801,3068,1505245,905,830489,2335734,03/14/2019
2010,Eden,144001,2514,1366138,680,736536,2102674,03/14/2019
2010,Iroquois,144201,4349,2054194,1295,1210229,3264423,03/14/2019
2010,Evans-Brant,144401,4094,2133293,1091,963897,3097190,03/14/2019
2010,Grand Island,144601,5112,2793218,1123,1204589,3997807,03/14/2019
2010,Hamburg,144801,5796,3084527,1463,1541712,4626239,03/14/2019
2010,Frontier,144804,8399,3644096,2276,1837273,5481369,03/14/2019
2010,Holland,145001,1728,689083,392,308392,997475,03/14/2019
2010,Lancaster,145201,9834,4376208,2711,2303372,6679580,03/14/2019
2010,Akron,145601,2019,990439,639,549725,1540164,03/14/2019
2010,North Collins,145801,1004,586312,279,307085,893397,03/14/2019
2010,Orchard Park,146001,8008,4032966,1749,1747349,5780315,03/14/2019
2010,Kenmore,146401,15115,8476537,5838,6511946,14988483,03/14/2019
2010,West Seneca,146801,11930,5832759,4677,4394749,10227508,03/14/2019
2010,Crown Point,152203,414,134171,159,91559,225730,03/14/2019
2010,Elizabethtown-Lewis,152401,540,208457,189,135041,343498,03/14/2019
2010,Keene,153001,274,70841,81,39368,110209,03/14/2019
2010,Minerva,153401,218,66862,101,56696,123558,03/14/2019
2010,Moriah,153601,1001,509173,470,406830,916003,03/14/2019
2010,Newcomb,153801,119,7910,66,8294,16204,03/14/2019
2010,Lake Placid,154002,1095,278893,340,156861,435754,03/14/2019
2010,Schroon Lake,154601,484,117080,230,100882,217962,03/14/2019
2010,Ticonderoga,154801,1164,305401,489,237383,542784,03/14/2019
2010,Westport,155001,300,125365,139,101072,226437,03/14/2019
2010,Willsboro,155201,549,194748,281,175972,370720,03/14/2019
2010,Tupper Lake,162001,1303,454165,454,268057,722222,03/14/2019
2010,Chateaugay,163401,750,306269,244,177958,484227,03/14/2019
2010,Salmon River,164201,797,286918,314,204304,491222,03/14/2019
2010,Saranac Lake,164601,2260,659807,614,319586,979393,03/14/2019
2010,Malone,164801,3122,1356300,1084,839433,2195733,03/14/2019
2010,Brushton-Moira,165001,1048,506078,326,283920,789998,03/14/2019
2010,St. Regis Falls,165401,506,264309,173,159794,424103,03/14/2019
2010,Gloversville,170500,3247,1934143,1293,1288218,3222361,03/14/2019
2010,Johnstown,170800,2259,1028184,754,639509,1667693,03/14/2019
2010,Broadalbin-Perth,172201,2384,1167669,785,695579,1863248,03/14/2019
2010,Wheelerville,172401,360,112439,141,80487,192926,03/14/2019
2010,Mayfield,173001,1426,671806,506,417460,1089266,03/14/2019
2010,Northville,173201,645,202722,283,166248,368970,03/14/2019
2010,Oppenheim-Ephratah,173401,662,316001,210,179446,495447,03/14/2019
2010,Batavia,180200,3250,2163339,1076,1368278,3531617,03/14/2019
2010,Alexander,182202,1201,790017,360,462747,1252764,03/14/2019
2010,Byron-Bergen,183001,1573,1127148,461,583725,1710873,03/14/2019
2010,Elba,183401,608,377800,199,239035,616835,03/14/2019
2010,Le Roy,183601,1752,1255922,538,716667,1972589,03/14/2019
2010,Oakfield-Alabama,183801,1109,765141,398,517107,1282248,03/14/2019
2010,Pavilion,184001,1155,750933,283,332887,1083820,03/14/2019
2010,Pembroke,184202,1504,882782,494,542706,1425488,03/14/2019
2010,Cairo-Durham,192401,1827,682787,770,524006,1206793,03/14/2019
2010,Catskill,192601,2231,1031551,734,621829,1653380,03/14/2019
2010,Coxsackie-Athens,192801,2050,888870,609,505729,1394599,03/14/2019
2010,Greenville,193201,2008,996111,636,605719,1601830,03/14/2019
2010,Hunter-Tannersville,193601,691,203201,281,152125,355326,03/14/2019
2010,Windham-Ashland-Jewett,194601,586,134867,271,116018,250885,03/14/2019
2010,Piseco,202001,86,7163,35,5712,12875,03/14/2019
2010,Indian Lake,202601,330,61543,158,58556,120099,03/14/2019
2010,Inlet,202801,81,9459,50,11180,20639,03/14/2019
2010,Lake Pleasant,203001,188,40000,99,41604,81604,03/14/2019
2010,Long Lake,203201,164,19571,98,21643,41214,03/14/2019
2010,Raquette Lake,203202,22,326,13,365,691,03/14/2019
2010,Wells,203601,219,58183,114,60029,118212,03/14/2019
2010,Little Falls,210900,1321,962158,550,700956,1663114,03/14/2019
2010,West Canada Valley,212402,1103,520486,316,288153,808639,03/14/2019
2010,Frankfort-Schuyler,212602,1434,845272,581,650804,1496076,03/14/2019
2010,Ilion,212801,1709,784248,531,462270,1246518,03/14/2019
2010,Mohawk,212802,1079,589307,449,452572,1041879,03/14/2019
2010,Herkimer,213001,1509,856197,724,748344,1604541,03/14/2019
2010,Dolgeville,213602,1125,447170,391,280175,727345,03/14/2019
2010,Poland,213803,990,354964,306,213004,567968,03/14/2019
2010,Van Hornesville-Owen D. Young,215001,322,160049,118,111195,271244,03/14/2019
2010,Town Of Webb,215401,551,56317,289,54270,110587,03/14/2019
2010,Mount Markham,215601,1572,832768,481,464558,1297326,03/14/2019
2010,Watertown,221800,4133,1174782,1162,604648,1779430,03/14/2019
2010,South Jefferson,222001,2414,841883,551,340969,1182852,03/14/2019
2010,Alexandria,222202,909,295966,303,175225,471191,03/14/2019
2010,Indian River,222401,1944,324125,427,124697,448822,03/14/2019
2010,General Brown,222601,2001,591654,541,288667,880321,03/14/2019
2010,Thousand Islands,223201,1624,563699,536,337266,900965,03/14/2019
2010,Belleville-Henderson,223402,760,189708,281,125871,315579,03/14/2019
2010,Sackets Harbor,223801,666,262625,174,126478,389103,03/14/2019
2010,Lyme,224401,598,190017,221,129583,319600,03/14/2019
2010,La Fargeville,224601,674,209541,164,91303,300844,03/14/2019
2010,Carthage,226001,2766,1078722,725,499257,1577979,03/14/2019
2010,Copenhagen,232201,643,193769,145,77270,271039,03/14/2019
2010,Harrisville,232401,546,279833,232,193386,473219,03/14/2019
2010,Lowville,233601,1708,442280,483,225359,667639,03/14/2019
2010,South Lewis,234001,1576,648536,548,385382,1033918,03/14/2019
2010,Beaver River,234401,1269,385112,391,224861,609973,03/14/2019
2010,Avon,242001,1343,927687,330,427250,1354937,03/14/2019
2010,Caledonia-Mumford,242201,1350,743492,394,420414,1163906,03/14/2019
2010,Geneseo,242601,1420,667944,346,318435,986379,03/14/2019
2010,Livonia,243401,2677,1550539,617,679760,2230299,03/14/2019
2010,Mount Morris,243601,625,457299,238,308350,765649,03/14/2019
2010,Dansville,243801,2155,1044982,753,662138,1707120,03/14/2019
2010,Dalton-Nunda,244001,1197,704372,374,381553,1085925,03/14/2019
2010,York,245201,1185,728351,314,355706,1084057,03/14/2019
2010,Oneida,251200,2964,1740624,962,1073758,2814382,03/14/2019
2010,Brookfield,252009,322,131489,97,70390,201879,03/14/2019
2010,Cazenovia,252201,2366,1105345,480,431665,1537010,03/14/2019
2010,De Ruyter,252401,576,301990,170,165121,467111,03/14/2019
2010,Morrisville-Eaton,252601,1072,474477,270,211899,686376,03/14/2019
2010,Hamilton,253201,1010,481559,248,226160,707719,03/14/2019
2010,Canastota,253601,2071,1295813,694,821359,2117172,03/14/2019
2010,Madison,254001,608,346159,217,220756,566915,03/14/2019
2010,Stockbridge Valley,254601,625,355736,169,180074,535810,03/14/2019
2010,Chittenango,254801,3293,2086020,892,1034735,3120755,03/14/2019
2010,Rochester,261400,26468,10455157,4775,3084621,13539778,03/14/2019
2010,Brighton,262001,5524,4020908,945,1328786,5349694,03/14/2019
2010,Gates-Chili,262601,7976,5711722,2815,3840009,9551731,03/14/2019
2010,Greece,262801,18992,12843406,5141,6773071,19616477,03/14/2019
2010,East Irondequoit,263401,6855,5488529,2229,3447764,8936293,03/14/2019
2010,West Irondequoit,263403,6493,4953888,1841,2794925,7748813,03/14/2019
2010,Honeoye Falls-Lima,263601,3360,2188777,598,763881,2952658,03/14/2019
2010,Spencerport,263801,5615,3903579,1344,1842216,5745795,03/14/2019
2010,Hilton,264001,6724,4514006,1506,1959592,6473598,03/14/2019
2010,Penfield,264201,8087,5969032,1630,2326351,8295383,03/14/2019
2010,Fairport,264401,10073,6178385,2249,2668211,8846596,03/14/2019
2010,East Rochester,264413,1858,1369801,609,798689,2168490,03/14/2019
2010,Pittsford,264601,8786,6197178,1125,1567399,7764577,03/14/2019
2010,Churchville-Chili,264801,6065,4137709,1419,1879306,6017015,03/14/2019
2010,Rush-Henrietta,265001,9131,5185698,2201,2426963,7612661,03/14/2019
2010,Brockport,265201,5028,3648889,972,1309670,4958559,03/14/2019
2010,Webster,265401,13471,8103009,3284,3883424,11986433,03/14/2019
2010,Wheatland-Chili,265601,1380,919160,363,441918,1361078,03/14/2019
2010,Amsterdam,270100,4292,2240899,1864,1821843,4062742,03/14/2019
2010,Canajoharie,272201,1321,710978,446,458533,1169511,03/14/2019
2010,Fonda-Fultonville,272801,2040,967159,588,519437,1486596,03/14/2019
2010,Fort Plain,273001,986,754657,410,565861,1320518,03/14/2019
2010,St. Johnsville,273802,613,313412,259,232008,545420,03/14/2019
2010,Glen Cove,280500,3669,3226083,1142,1986051,5212134,03/14/2019
2010,Long Beach,281000,7565,5403460,1077,1550759,6954219,03/14/2019
2010,Hempstead,282001,3252,4132192,477,1241792,5373984,03/14/2019
2010,Uniondale,282002,5502,4766351,845,1503848,6270199,03/14/2019
2010,East Meadow,282003,11212,13897436,2846,5914256,19811692,03/14/2019
2010,North Bellmore,282004,6078,8030691,1151,3082260,11112951,03/14/2019
2010,Levittown,282005,11199,17772982,2285,7347953,25120935,03/14/2019
2010,Seaford,282006,3995,4993916,786,1868087,6862003,03/14/2019
2010,Bellmore,282007,3159,3999392,499,1297276,5296668,03/14/2019
2010,Roosevelt,282008,2392,2654535,353,803524,3458059,03/14/2019
2010,Freeport,282009,6235,7469780,986,2346518,9816298,03/14/2019
2010,Baldwin,282010,7462,10373149,1074,2906074,13279223,03/14/2019
2010,Oceanside,282011,8864,9972437,1630,3554495,13526932,03/14/2019
2010,Malverne,282012,3183,4387317,576,1630455,6017772,03/14/2019
2010,Valley Stream 13,282013,6212,7612002,1350,3221077,10833079,03/14/2019
2010,Hewlett-Woodmere,282014,4884,7440350,626,1919040,9359390,03/14/2019
2010,Lawrence,282015,6401,4538125,856,1211853,5749978,03/14/2019
2010,Elmont,282016,8418,9297288,1494,3392942,12690230,03/14/2019
2010,Franklin Square,282017,5183,5254452,1351,2813574,8068026,03/14/2019
2010,Garden City,282018,5766,4606482,639,1027587,5634069,03/14/2019
2010,East Rockaway,282019,2092,2703871,511,1319253,4023124,03/14/2019
2010,Lynbrook,282020,3917,5057107,733,1893920,6951027,03/14/2019
2010,Rockville Centre,282021,5065,5869060,679,1543812,7412872,03/14/2019
2010,Floral Park-Bellerose,282022,4380,4327828,775,1534766,5862594,03/14/2019
2010,Wantagh,282023,4508,5998466,671,1830126,7828592,03/14/2019
2010,Valley Stream 24,282024,2635,2813034,503,1105609,3918643,03/14/2019
2010,Merrick,282025,4817,6358054,562,1525750,7883804,03/14/2019
2010,Island Trees,282026,3419,4067574,726,1763417,5830991,03/14/2019
2010,West Hempstead,282027,3728,4324986,619,1476405,5801391,03/14/2019
2010,North Merrick,282029,3404,4422217,633,1635569,6057786,03/14/2019
2010,Valley Stream 30,282030,3094,3257003,499,1078695,4335698,03/14/2019
2010,Island Park,282031,1594,1237934,316,504068,1742002,03/14/2019
2010,Westbury,282201,3376,4810881,646,1866696,6677577,03/14/2019
2010,East Williston,282202,2170,2381352,188,423193,2804545,03/14/2019
2010,Roslyn,282203,4351,5016234,308,724695,5740929,03/14/2019
2010,Port Washington,282204,6227,5405606,703,1243248,6648854,03/14/2019
2010,New Hyde Park-Garden City,282205,4891,4834955,1092,2220159,7055114,03/14/2019
2010,Manhasset,282206,3995,2644275,285,387731,3032006,03/14/2019
2010,Great Neck,282207,9996,6495042,1025,1333659,7828701,03/14/2019
2010,Herricks,282209,6308,7015662,911,2084050,9099712,03/14/2019
2010,Mineola,282210,4731,4652897,1049,2114830,6767727,03/14/2019
2010,Carle Place,282211,1981,2131108,401,886937,3018045,03/14/2019
2010,North Shore,282401,3914,3408954,510,911895,4320849,03/14/2019
2010,Syosset,282402,8383,10656603,1076,2193996,12850599,03/14/2019
2010,Locust Valley,282403,3479,2836544,400,670205,3506749,03/14/2019
2010,Plainview-Old Bethpage,282404,7516,10037469,1184,3251219,13288688,03/14/2019
2010,Oyster Bay-East Norwich,282406,2751,1917136,345,483026,2400162,03/14/2019
2010,Jericho,282415,3418,3542222,302,643796,4186018,03/14/2019
2010,Hicksville,282417,7961,7023692,2034,3556301,10579993,03/14/2019
2010,Plainedge,282418,4596,6980228,1082,3377547,10357775,03/14/2019
2010,Bethpage,282421,4141,4480638,1405,2219940,6700578,03/14/2019
2010,Farmingdale,282422,8823,11692364,1928,5231221,16923585,03/14/2019
2010,Massapequa,282423,11826,13887486,2300,5498984,19386470,03/14/2019
2010,Lockport,290900,6508,5045707,1724,2273035,7318742,03/14/2019
2010,Niagara Falls,291100,8284,4187499,3331,2880962,7068461,03/14/2019
2010,North Tonawanda,291200,6680,4054367,2323,2742076,6796443,03/14/2019
2010,Lewiston-Porter,292401,4265,2322859,1436,1558289,3881148,03/14/2019
2010,Newfane,292801,2377,1931399,779,1209719,3141118,03/14/2019
2010,Niagara-Wheatfield,293001,5437,2770869,1769,1646113,4416982,03/14/2019
2010,Starpoint,293201,4284,2795709,961,1234841,4030550,03/14/2019
2010,Royalton-Hartland,293601,2101,1329382,605,744734,2074116,03/14/2019
2010,Barker,293801,1172,557551,332,293783,851334,03/14/2019
2010,Wilson,294201,1935,1326400,536,720675,2047075,03/14/2019
2010,Rome,301300,6518,4055432,2336,2635574,6691006,03/14/2019
2010,Utica,301600,8066,4661226,3207,3316705,7977931,03/14/2019
2010,Adirondack,302601,1992,846404,660,489438,1335842,03/14/2019
2010,Camden,303001,2942,1230520,915,676531,1907051,03/14/2019
2010,Clinton,304001,2081,1440041,596,740970,2181011,03/14/2019
2010,New Hartford,304801,4016,2572135,1191,1429969,4002104,03/14/2019
2010,New York Mills,304804,881,548193,427,520945,1069138,03/14/2019
2010,Sauquoit Valley,305002,1503,817448,415,430339,1247787,03/14/2019
2010,Remsen,305201,758,483667,225,267955,751622,03/14/2019
2010,Waterville,305401,1188,583715,355,330351,914066,03/14/2019
2010,Holland Patent,305801,2276,1271677,638,677564,1949241,03/14/2019
2010,Sherrill,306000,2721,1552440,952,1037704,2590144,03/14/2019
2010,Westmoreland,306801,1550,1098902,502,669474,1768376,03/14/2019
2010,Oriskany,307001,959,658408,307,403963,1062371,03/14/2019
2010,Whitesboro,307002,5259,3045505,1753,1984721,5030226,03/14/2019
2010,Syracuse,311500,16943,7604744,4264,3454349,11059093,03/14/2019
2010,West Genesee,312001,7696,4760066,2623,3122773,7882839,03/14/2019
2010,North Syracuse,312403,14825,9173535,3471,3884800,13058335,03/14/2019
2010,East Syracuse-Minoa,312601,5086,3660830,1827,2312215,5973045,03/14/2019
2010,Jamesville-Dewitt,312611,4358,2736466,789,951305,3687771,03/14/2019
2010,Jordan-Elbridge,312801,1836,1463108,532,713602,2176710,03/14/2019
2010,Fabius-Pompey,313001,1184,905478,294,423455,1328933,03/14/2019
2010,Westhill,313201,2842,2174424,836,1238269,3412693,03/14/2019
2010,Solvay,313202,1910,1388391,852,1191786,2580177,03/14/2019
2010,La Fayette,313407,1130,620497,234,234266,854763,03/14/2019
2010,Baldwinsville,313601,8334,5712074,1862,2414454,8126528,03/14/2019
2010,Fayetteville-Manlius,313801,6469,4716318,1161,1642815,6359133,03/14/2019
2010,Marcellus,314001,2741,1779266,674,850980,2630246,03/14/2019
2010,Onondaga,314201,1567,1314079,410,644769,1958848,03/14/2019
2010,Liverpool,314801,11074,7903733,2984,3963314,11867047,03/14/2019
2010,Lyncourt,314804,852,718851,411,590382,1309233,03/14/2019
2010,Skaneateles,315001,2297,945339,577,455002,1400341,03/14/2019
2010,Tully,315402,1408,765401,292,301041,1066442,03/14/2019
2010,Canandaigua,320200,4789,2537720,1137,1157896,3695616,03/14/2019
2010,Geneva,320500,2759,1718838,1018,1168346,2887184,03/14/2019
2010,East Bloomfield,322601,1416,995584,347,465375,1460959,03/14/2019
2010,Gorham-Middlesex,323201,2274,971205,655,526476,1497681,03/14/2019
2010,Manchester-Shortsville,323601,1195,967963,400,623979,1591942,03/14/2019
2010,Naples,323801,1410,607975,361,296620,904595,03/14/2019
2010,Phelps-Clifton Springs,324001,2355,1652385,634,860896,2513281,03/14/2019
2010,Honeoye,324201,1572,763706,429,391369,1155075,03/14/2019
2010,Victor,324801,5150,2621000,959,919230,3540230,03/14/2019
2010,Middletown,330900,6112,4719612,1184,1753537,6473149,03/14/2019
2010,Newburgh,331100,10494,8835107,2377,3787104,12622211,03/14/2019
2010,Port Jervis,331300,2899,2802001,874,1568086,4370087,03/14/2019
2010,Washingtonville,332002,5645,4995250,721,1314981,6310231,03/14/2019
2010,Chester,332201,1436,1148446,236,365093,1513539,03/14/2019
2010,Cornwall,332401,3709,3229589,536,914859,4144448,03/14/2019
2010,Pine Bush,332601,6363,4524071,998,1358645,5882716,03/14/2019
2010,Goshen,333001,3264,2530010,603,926690,3456700,03/14/2019
2010,Highland Falls,333601,904,676995,225,323058,1000053,03/14/2019
2010,Minisink Valley,333801,4928,3567358,699,991690,4559048,03/14/2019
2010,Monroe-Woodbury,334001,9023,8735968,1045,2026875,10762843,03/14/2019
2010,Kiryas Joel Village,334002,663,330954,30,27262,358216,03/14/2019
2010,Valley,334201,5319,4186720,1089,1665293,5852013,03/14/2019
2010,Tuxedo,335003,577,259752,81,73201,332953,03/14/2019
2010,Warwick Valley,335401,5525,4274202,812,1245438,5519640,03/14/2019
2010,Greenwood Lake,335411,1647,1422876,274,468228,1891104,03/14/2019
2010,Florida,335415,1147,1085566,265,496560,1582126,03/14/2019
2010,Albion,342001,2385,1277506,809,792921,2070427,03/14/2019
2010,Kendall,343007,1267,822170,338,419854,1242024,03/14/2019
2010,Holley,343204,1551,1227353,453,657938,1885291,03/14/2019
2010,Medina,343401,2091,1509521,785,1034299,2543820,03/14/2019
2010,Lyndonville,343801,980,534461,317,329186,863647,03/14/2019
2010,Fulton,350400,3884,2901599,1142,1469972,4371571,03/14/2019
2010,Oswego,351200,5424,3561022,1588,1795140,5356162,03/14/2019
2010,Altmar Parish-Williamstown,352002,1741,1138454,452,519243,1657697,03/14/2019
2010,Hannibal,353001,1814,1233509,431,529199,1762708,03/14/2019
2010,Central Square,353201,5950,3253624,1347,1329589,4583213,03/14/2019
2010,Mexico,353401,3030,1741435,670,712304,2453739,03/14/2019
2010,Pulaski,355001,1253,708384,337,350275,1058659,03/14/2019
2010,Sandy Creek,355201,1246,585674,448,369172,954846,03/14/2019
2010,Phoenix,355401,2830,2284039,715,1058340,3342379,03/14/2019
2010,Oneonta,361200,2687,1438174,789,788897,2227071,03/14/2019
2010,Gilbertsville-Mt Upton,362202,678,231432,280,178416,409848,03/14/2019
2010,Cherry Valley-Springfield,362401,898,313493,368,237403,550896,03/14/2019
2010,Edmeston,362801,627,215947,218,142461,358408,03/14/2019
2010,Laurens,363401,572,257976,214,190482,448458,03/14/2019
2010,Schenevus,363601,577,295489,223,204779,500268,03/14/2019
2010,Milford,364001,627,288879,283,245953,534832,03/14/2019
2010,Morris,364201,580,279274,226,199493,478767,03/14/2019
2010,Otego-Unadilla,364801,1444,746781,526,487717,1234498,03/14/2019
2010,Cooperstown,365001,1338,475661,425,276255,751916,03/14/2019
2010,Richfield Springs,365601,839,244353,399,221466,465819,03/14/2019
2010,Worcester,366606,507,265033,251,240837,505870,03/14/2019
2010,Mahopac,372001,6428,7733374,872,2063194,9796568,03/14/2019
2010,Carmel,372002,7106,8480739,929,2174584,10655323,03/14/2019
2010,Haldane,372601,1176,996320,229,352547,1348867,03/14/2019
2010,Garrison,372604,585,280840,78,75183,356023,03/14/2019
2010,Putnam Valley,372803,2821,4032035,341,943728,4975763,03/14/2019
2010,Brewster,373001,5128,5568636,786,1721078,7289714,03/14/2019
2010,Rensselaer,381400,1378,644363,390,330325,974688,03/14/2019
2010,Troy,381700,4371,2479363,1176,1188613,3667976,03/14/2019
2010,Lansingburgh,381701,2803,1376243,831,747138,2123381,03/14/2019
2010,Berlin,382001,1630,695065,419,335472,1030537,03/14/2019
2010,Brunswick,382202,1884,946353,514,479567,1425920,03/14/2019
2010,East Greenbush,382401,7108,3710213,1552,1534277,5244490,03/14/2019
2010,Hoosick Falls,382801,1705,863309,582,509602,1372911,03/14/2019
2010,North Greenbush,383201,371,70164,119,44801,114965,03/14/2019
2010,Wynantskill,383204,912,524137,272,308949,833086,03/14/2019
2010,Averill Park,384001,4794,2279045,961,889699,3168744,03/14/2019
2010,Hoosic Valley,384201,1616,800549,390,362248,1162797,03/14/2019
2010,Schodack,384401,1531,872124,332,373548,1245672,03/14/2019
2010,Clarkstown,392001,12012,11286734,1786,3349275,14636009,03/14/2019
2010,Nanuet,392008,2486,2475838,570,1104871,3580709,03/14/2019
2010,Haverstraw-Stony Point,392201,8691,14086216,1828,5452576,19538792,03/14/2019
2010,South Orangetown,392401,4580,5053683,944,2077876,7131559,03/14/2019
2010,Nyack,392404,4300,5572194,785,2082635,7654829,03/14/2019
2010,Pearl River,392408,3343,4003668,712,1700945,5704613,03/14/2019
2010,Ramapo,392601,6117,9754846,1131,3397364,13152210,03/14/2019
2010,East Ramapo,392602,12594,13473200,1739,3403022,16876222,03/14/2019
2010,Ogdensburg,401200,2237,1570409,658,676259,2246668,03/14/2019
2010,Brasher Falls,402001,1365,834637,454,479690,1314327,03/14/2019
2010,Canton,402201,1852,992925,475,467268,1460193,03/14/2019
2010,Clifton-Fine,402601,504,165912,226,115462,281374,03/14/2019
2010,Colton-Pierrepont,402801,660,260248,228,160033,420281,03/14/2019
2010,Edwards-Knox,403401,745,238775,228,123882,362657,03/14/2019
2010,Gouverneur,404001,2090,758502,556,350549,1109051,03/14/2019
2010,Hammond,404201,419,168584,164,113751,282335,03/14/2019
2010,Hermon-Dekalb,404401,572,306356,178,166183,472539,03/14/2019
2010,Lisbon,405002,834,421171,231,216277,637448,03/14/2019
2010,Madrid-Waddington,405601,1000,505071,346,320425,825496,03/14/2019
2010,Massena,405801,3555,1911881,1284,1235130,3147011,03/14/2019
2010,Morristown,406001,651,268395,235,182316,450711,03/14/2019
2010,Norwood-Norfolk,406201,1450,1016920,474,586928,1603848,03/14/2019
2010,Heuvelton,406404,885,524804,272,293796,818600,03/14/2019
2010,Parishville-Hopkinton,406601,678,254181,182,119186,373367,03/14/2019
2010,Potsdam,407402,1979,1324699,500,606224,1930923,03/14/2019
2010,Mechanicville,411000,1632,910111,566,628686,1538797,03/14/2019
2010,Saratoga Springs,411500,9877,4384755,1752,1509043,5893798,03/14/2019
2010,Burnt Hills-Ballston Lake,412001,5086,3160747,1175,1422478,4583225,03/14/2019
2010,Shenendehowa,412402,14580,9359263,2031,2577891,11937154,03/14/2019
2010,Corinth,412601,1614,694878,506,393914,1088792,03/14/2019
2010,Edinburg,413001,359,58967,147,46432,105399,03/14/2019
2010,Galway,413201,1695,779254,438,369953,1149207,03/14/2019
2010,Ballston Spa,414201,5669,4171794,1153,1519488,5691282,03/14/2019
2010,South Glens Falls,414401,3930,2478864,1112,1332279,3811143,03/14/2019
2010,Schuylerville,415001,2412,1729470,487,653396,2382866,03/14/2019
2010,Stillwater,415201,1769,795668,377,324368,1120036,03/14/2019
2010,Waterford-Halfmoon,415401,1009,807627,392,563365,1370992,03/14/2019
2010,Schenectady,421500,8576,5461200,2372,2732959,8194159,03/14/2019
2010,Duanesburg,422001,1346,620229,266,226610,846839,03/14/2019
2010,Scotia-Glenville,422202,4326,2304687,1119,1138700,3443387,03/14/2019
2010,Niskayuna,422401,6397,3255459,880,890924,4146383,03/14/2019
2010,Schalmont,422801,3418,1773153,942,946613,2719766,03/14/2019
2010,Rotterdam-Mohonasen,422803,4895,2206167,1895,1637562,3843729,03/14/2019
2010,Cobleskill-Richmondville,432602,2522,1309278,875,819576,2128854,03/14/2019
2010,Gilboa-Conesville,433401,559,217574,268,184774,402348,03/14/2019
2010,Jefferson,433601,446,184511,162,120366,304877,03/14/2019
2010,Middleburgh,433801,1320,735232,466,471828,1207060,03/14/2019
2010,Schoharie,434201,1581,933433,442,500233,1433666,03/14/2019
2010,Sharon Springs,434601,414,247054,172,186914,433968,03/14/2019
2010,Odessa-Montour,442001,1243,684396,416,419603,1103999,03/14/2019
2010,Watkins Glen,442401,1866,673652,669,448457,1122109,03/14/2019
2010,South Seneca,452801,1382,635131,495,415399,1050530,03/14/2019
2010,Romulus,453003,745,419023,230,245039,664062,03/14/2019
2010,Seneca Falls,453201,1978,1454212,697,961073,2415285,03/14/2019
2010,Waterloo,453801,2272,1409741,817,954044,2363785,03/14/2019
2010,Corning,460300,7292,5152103,2107,2647604,7799707,03/14/2019
2010,Hornell,460600,1846,936773,623,550724,1487497,03/14/2019
2010,Addison,462001,1508,911280,435,425616,1336896,03/14/2019
2010,Avoca,462201,807,332032,269,188820,520852,03/14/2019
2010,Bath,462402,1865,1019125,622,657022,1676147,03/14/2019
2010,Bradford,462601,473,259170,157,149547,408717,03/14/2019
2010,Campbell-Savona,463002,1229,732232,386,414793,1147025,03/14/2019
2010,Canisteo-Greenwood,463202,1348,720398,492,453847,1174245,03/14/2019
2010,Arkport,465201,675,403285,299,287117,690402,03/14/2019
2010,Jasper-Troupsburg,465601,653,267296,222,160941,428237,03/14/2019
2010,Prattsburgh,466001,662,283378,214,165930,449308,03/14/2019
2010,Hammondsport,467201,1063,336600,404,231538,568138,03/14/2019
2010,Wayland-Cohocton,467401,2075,1014278,677,578388,1592666,03/14/2019
2010,Babylon,472001,2679,3295945,379,913807,4209752,03/14/2019
2010,West Babylon,472002,5309,5991039,1049,2343692,8334731,03/14/2019
2010,North Babylon,472003,6398,6955732,1432,3101814,10057546,03/14/2019
2010,Lindenhurst,472004,8297,9933388,1738,4131536,14064924,03/14/2019
2010,Copiague,472005,5014,5570276,1118,2354595,7924871,03/14/2019
2010,Amityville,472006,4234,4693739,1021,1683543,6377282,03/14/2019
2010,Deer Park,472007,5124,5808121,1376,3079409,8887530,03/14/2019
2010,Wyandanch,472009,1180,1400150,187,433564,1833714,03/14/2019
2010,Three Village,472201,9458,9872954,1510,3106446,12979400,03/14/2019
2010,Brookhaven-Comsewogue,472203,4522,4547274,880,1696157,6243431,03/14/2019
2010,South Country,472204,5236,4957962,725,1338309,6296271,03/14/2019
2010,Sachem,472205,17628,14829286,2582,4225440,19054726,03/14/2019
2010,Port Jefferson,472206,1633,966019,223,262561,1228580,03/14/2019
2010,Mount Sinai,472207,3216,3491291,521,1117288,4608579,03/14/2019
2010,Miller Place,472208,3803,4098854,398,838061,4936915,03/14/2019
2010,Rocky Point,472209,4067,4767729,491,1126794,5894523,03/14/2019
2010,Middle Country,472211,12198,12606692,2338,4712911,17319603,03/14/2019
2010,Longwood,472212,12598,13474658,3066,5918112,19392770,03/14/2019
2010,Patchogue-Medford,472224,9771,10235032,1615,3211246,13446278,03/14/2019
2010,William Floyd,472232,9708,10990698,1297,2778861,13769559,03/14/2019
2010,Center Moriches,472233,1726,1973759,249,554702,2528461,03/14/2019
2010,East Moriches,472234,1345,1498152,172,383171,1881323,03/14/2019
2010,Eastport- South Manor,472235,4277,4568826,817,1502119,6070945,03/14/2019
2010,East Hampton,472401,1335,274132,339,131065,405197,03/14/2019
2010,Wainscott,472402,116,9331,21,3351,12682,03/14/2019
2010,Amagansett,472403,253,30397,86,20280,50677,03/14/2019
2010,Springs,472404,1011,379210,287,211856,591066,03/14/2019
2010,Sag Harbor,472405,1335,392704,410,239735,632439,03/14/2019
2010,Montauk,472406,678,126202,244,112239,238441,03/14/2019
2010,Elwood,472601,3221,3526292,561,1223418,4749710,03/14/2019
2010,Cold Spring Harbor,472602,2138,2006165,134,254223,2260388,03/14/2019
2010,Huntington,472603,7731,8069708,1142,2326091,10395799,03/14/2019
2010,Northport-East Northport,472604,9074,7515878,1425,2349572,9865450,03/14/2019
2010,Half Hollow Hills,472605,11304,9854810,1727,2826243,12681053,03/14/2019
2010,Harborfields,472606,4741,5122245,692,1488541,6610786,03/14/2019
2010,Commack,472610,9348,10917356,1742,4084400,15001756,03/14/2019
2010,South Huntington,472613,8785,9561295,1660,3590145,13151440,03/14/2019
2010,Bay Shore,472801,5827,6481291,1054,2288090,8769381,03/14/2019
2010,Islip,472802,3972,4714614,683,1463946,6178560,03/14/2019
2010,East Islip,472803,5573,6006507,1048,2487175,8493682,03/14/2019
2010,Sayville,472804,4125,4477619,796,1702366,6179985,03/14/2019
2010,Bayport-Blue Point,472805,3157,3879645,471,1160136,5039781,03/14/2019
2010,Hauppauge,472806,5192,3360179,962,1234738,4594917,03/14/2019
2010,Connetquot,472807,8706,8978705,1635,3249315,12228020,03/14/2019
2010,West Islip,472809,6602,6702543,1251,2543809,9246352,03/14/2019
2010,Brentwood,472812,9912,7199237,1999,2903470,10102707,03/14/2019
2010,Central Islip,472813,5705,7263721,909,2266689,9530410,03/14/2019
2010,Fire Island,472814,107,11199,16,3352,14551,03/14/2019
2010,Shoreham-Wading River,473001,3208,3084618,738,1342878,4427496,03/14/2019
2010,Riverhead,473002,6901,5078139,2518,3053932,8132071,03/14/2019
2010,Shelter Island,473201,608,109819,206,73922,183741,03/14/2019
2010,Smithtown,473401,13932,14401405,2410,4735444,19136849,03/14/2019
2010,Kings Park,473405,5526,5376003,889,1727558,7103561,03/14/2019
2010,Remsenburg-Speonk,473601,452,133222,69,40250,173472,03/14/2019
2010,Westhampton Beach,473602,1042,347290,212,135254,482544,03/14/2019
2010,Quogue,473603,247,28116,33,7555,35671,03/14/2019
2010,Hampton Bays,473605,2263,1516930,662,880463,2397393,03/14/2019
2010,Southhampton,473606,1741,244525,475,132497,377022,03/14/2019
2010,Bridgehampton,473609,292,26478,71,12898,39376,03/14/2019
2010,Sagaponack,473610,72,1731,7,337,2068,03/14/2019
2010,Tuckahoe Common,473613,532,210413,156,122568,332981,03/14/2019
2010,East Quogue,473617,1148,652827,264,285700,938527,03/14/2019
2010,Oysterponds,473802,401,97727,170,82860,180587,03/14/2019
2010,Fishers Island,473804,33,7694,4,1865,9559,03/14/2019
2010,Southold,473805,1579,778165,549,541449,1319614,03/14/2019
2010,Greenport,473810,647,340571,263,278365,618936,03/14/2019
2010,Mattituck-Cutchogue,473812,2258,1192830,603,635959,1828789,03/14/2019
2010,New Suffolk,473815,88,20677,29,13561,34238,03/14/2019
2010,Fallsburg,482801,1281,900744,324,410743,1311487,03/14/2019
2010,Eldred,483401,1108,464130,374,298881,763011,03/14/2019
2010,Liberty,483601,1429,934187,568,704856,1639043,03/14/2019
2010,Tri-Valley,484201,1304,717073,342,326383,1043456,03/14/2019
2010,Roscoe,484401,377,147524,171,128500,276024,03/14/2019
2010,Livingston Manor,484402,631,249983,244,171613,421596,03/14/2019
2010,Monticello,484601,3328,1537784,1001,848194,2385978,03/14/2019
2010,Sullivan West,484802,2210,863660,863,626708,1490368,03/14/2019
2010,Waverly,492001,1858,871645,673,572988,1444633,03/14/2019
2010,Candor,492401,1041,520212,382,365507,885719,03/14/2019
2010,Newark Valley,492602,1730,950127,563,589679,1539806,03/14/2019
2010,Owego-Apalachin,493001,2967,1595471,1044,1063569,2659040,03/14/2019
2010,Spencer-Van Etten,493401,1331,556083,438,337890,893973,03/14/2019
2010,Tioga,493603,1207,325135,377,191845,516980,03/14/2019
2010,Ithaca,500700,8442,4282655,1523,1370460,5653115,03/14/2019
2010,Dryden,502401,2520,1643904,578,632834,2276738,03/14/2019
2010,Groton,502801,1330,783965,337,358574,1142539,03/14/2019
2010,Lansing,503201,1764,977735,347,363906,1341641,03/14/2019
2010,Newfield,503401,1075,558677,301,239390,798067,03/14/2019
2010,Trumansburg,503601,1731,1050808,423,464249,1515057,03/14/2019
2010,Kingston,510800,8808,5468581,2725,3245352,8713933,03/14/2019
2010,Highland,513203,2462,1624972,519,665051,2290023,03/14/2019
2010,Rondout Valley,513401,3807,2163876,1015,1099575,3263451,03/14/2019
2010,Marlboro,513601,2541,1852264,508,711145,2563409,03/14/2019
2010,New Paltz,513801,3294,1957665,634,748150,2705815,03/14/2019
2010,Onteora,514001,3587,1491023,1171,927485,2418508,03/14/2019
2010,Saugerties,514801,4479,2649285,1288,1502831,4152116,03/14/2019
2010,Wallkill,515201,4070,3171208,909,1120870,4292078,03/14/2019
2010,Ellenville,515602,1751,1128836,550,603662,1732498,03/14/2019
2010,Glens Falls,520500,2858,1444937,811,762123,2207060,03/14/2019
2010,Bolton,522001,416,67166,146,44491,111657,03/14/2019
2010,Lake George,522201,1504,286019,454,163337,449356,03/14/2019
2010,North Warren,522402,1064,269115,454,209555,478670,03/14/2019
2010,Johnsburg,523001,563,241756,238,191031,432787,03/14/2019
2010,Hadley-Luzerne,523201,1346,458750,553,354526,813276,03/14/2019
2010,Queensbury,523402,4594,2023044,1133,900136,2923180,03/14/2019
2010,Glens Falls Common,523418,256,91595,89,58178,149773,03/14/2019
2010,Warrensburg,524001,1244,528042,461,366082,894124,03/14/2019
2010,Argyle,532001,928,411291,285,234560,645851,03/14/2019
2010,Fort Ann,532802,841,393737,233,201733,595470,03/14/2019
2010,Fort Edward,533001,550,268222,195,179954,448176,03/14/2019
2010,Granville,533201,1548,682119,510,416285,1098404,03/14/2019
2010,Greenwich,533401,1483,724574,487,443565,1168139,03/14/2019
2010,Hartford,533801,714,354152,198,187234,541386,03/14/2019
2010,Hudson Falls,534401,2691,1166224,982,787720,1953944,03/14/2019
2010,Putnam,534601,165,31768,53,18637,50405,03/14/2019
2010,Salem,534801,887,385242,340,264271,649513,03/14/2019
2010,Cambridge,535010,1356,614629,535,446684,1061313,03/14/2019
2010,Whitehall,535201,931,297075,388,218907,515982,03/14/2019
2010,Newark,542001,2886,1744454,911,1046632,2791086,03/14/2019
2010,Clyde-Savannah,542401,1174,828941,421,532967,1361908,03/14/2019
2010,Lyons,542801,1210,698368,416,428417,1126785,03/14/2019
2010,Gananda,543002,1500,1290229,124,208286,1498515,03/14/2019
2010,Marion,543201,1371,936751,323,421818,1358569,03/14/2019
2010,Wayne,543401,3770,2346589,790,956142,3302731,03/14/2019
2010,Palmyra-Macedon,543601,2650,1937803,755,1045772,2983575,03/14/2019
2010,Sodus,544201,1545,904676,569,585807,1490483,03/14/2019
2010,Williamson,544602,1555,1094138,446,638373,1732511,03/14/2019
2010,North Rose-Wolcott,544801,1899,908778,679,594262,1503040,03/14/2019
2010,Red Creek,544803,1238,518207,379,297543,815750,03/14/2019
2010,Mount Vernon,550800,5591,14356128,1428,6229957,20586085,03/14/2019
2010,New Rochelle,551000,9518,17068055,1514,5064351,22132406,03/14/2019
2010,Peekskill,551200,3526,6734710,557,1867151,8601861,03/14/2019
2010,Rye,551400,2970,3225752,290,669715,3895467,03/14/2019
2010,White Plains,551700,7792,14609462,1090,3618756,18228218,03/14/2019
2010,Yonkers,551800,18626,27384222,4250,10117295,37501517,03/14/2019
2010,Katonah-Lewisboro,552001,5164,7949656,440,1303323,9252979,03/14/2019
2010,Bedford,552002,5244,5927972,668,1408823,7336795,03/14/2019
2010,Croton-Harmon,552202,2398,3996877,285,907917,4904794,03/14/2019
2010,Hendrick Hudson,552203,3558,5248385,491,1297389,6545774,03/14/2019
2010,Eastchester,552401,3185,6586316,611,2269701,8856017,03/14/2019
2010,Tuckahoe,552402,1312,2277364,197,639613,2916977,03/14/2019
2010,Bronxville,552403,1154,2098702,46,289313,2388015,03/14/2019
2010,Tarrytowns,552601,2542,5062260,434,1624852,6687112,03/14/2019
2010,Irvington,552602,1828,3546023,208,821132,4367155,03/14/2019
2010,Dobbs Ferry,552603,1510,3407184,203,915180,4322364,03/14/2019
2010,Hastings On Hudson,552604,1718,4063418,272,1224729,5288147,03/14/2019
2010,Ardsley,552605,2537,4573364,314,1127792,5701156,03/14/2019
2010,Edgemont,552606,1699,3581573,120,523480,4105053,03/14/2019
2010,Greenburgh,552607,4182,6519308,887,2342927,8862235,03/14/2019
2010,Elmsford,552609,1324,1934152,312,902535,2836687,03/14/2019
2010,Harrison,552801,3762,3841356,647,1274268,5115624,03/14/2019
2010,Mamaroneck,553201,5252,7202843,580,1519971,8722814,03/14/2019
2010,Mount Pleasant,553401,2743,3740784,706,1914312,5655096,03/14/2019
2010,Pocantico Hills,553402,469,354183,90,133099,487282,03/14/2019
2010,Valhalla,553405,1849,2922801,406,1257802,4180603,03/14/2019
2010,Pleasantville,553409,1978,3649982,341,1142958,4792940,03/14/2019
2010,Chappaqua,553604,4464,7043970,226,707381,7751351,03/14/2019
2010,Byram Hills,553801,3078,3486800,215,482447,3969247,03/14/2019
2010,North Salem,554001,1910,2380732,242,572704,2953436,03/14/2019
2010,Ossining,554201,5969,11892744,790,3013716,14906460,03/14/2019
2010,Briarcliff Manor,554202,1757,3470300,103,424926,3895226,03/14/2019
2010,Pelham,554401,2530,4231616,320,1009241,5240857,03/14/2019
2010,Rye Neck,554801,1647,2303155,259,684567,2987722,03/14/2019
2010,Port Chester-Rye,554804,2991,4441836,840,2246035,6687871,03/14/2019
2010,Blind Brook-Rye,554805,1721,2332604,155,420865,2753469,03/14/2019
2010,Scarsdale,555001,4709,5972180,194,493450,6465630,03/14/2019
2010,Somers,555201,5264,7645461,1194,3364440,11009901,03/14/2019
2010,Lakeland,555401,8685,16263608,1712,5427500,21691108,03/14/2019
2010,Yorktown,555402,5248,9632500,652,2331709,11964209,03/14/2019
2010,Attica,562201,2355,1171146,643,630593,1801739,03/14/2019
2010,Letchworth,562601,1414,623825,384,311674,935499,03/14/2019
2010,Wyoming,563802,444,241024,100,104170,345194,03/14/2019
2010,Perry,564201,1246,626186,437,422825,1049011,03/14/2019
2010,Warsaw,564801,1382,908268,367,464832,1373100,03/14/2019
2010,Penn Yan,573001,2945,959952,1116,683181,1643133,03/14/2019
2010,Dundee,573401,1176,423004,458,283898,706902,03/14/2019
2010,New York City School,650000,611233,166552595,106018,54022420,220575015,03/14/2019
2009,Albany,010100,10533,6013187,3196,3272571,9285758,03/14/2019
2009,Cohoes,010300,2235,1455122,683,797241,2252363,03/14/2019
2009,Watervliet,011800,1357,568541,464,359321,927862,03/14/2019
2009,Berne-Knox-Westerlo,012001,1750,960463,379,374130,1334593,03/14/2019
2009,Bethlehem,012206,7193,4405402,1080,1242461,5647863,03/14/2019
2009,Ravena-Coeymans-Selkirk,012402,3002,1818273,743,819107,2637380,03/14/2019
2009,South Colonie,012601,9322,4491310,2621,2440544,6931854,03/14/2019
2009,North Colonie,012605,8236,3484154,1690,1401192,4885346,03/14/2019
2009,Menands,012615,418,189737,101,91097,280834,03/14/2019
2009,Green Island,012801,291,176554,127,144715,321269,03/14/2019
2009,Guilderland,013002,7749,3778566,1438,1332979,5111545,03/14/2019
2009,Voorheesville,013403,2081,1091175,365,363278,1454453,03/14/2019
2009,Alfred-Almond,022001,891,586272,269,315771,902043,03/14/2019
2009,Andover,023001,507,397850,162,201939,599789,03/14/2019
2009,Genesee Valley,023202,771,355814,360,267005,622819,03/14/2019
2009,Belfast,023401,464,221948,178,141736,363684,03/14/2019
2009,Canaseraga,024002,399,235169,147,137521,372690,03/14/2019
2009,Cuba-Rushford,024801,1402,654358,544,438498,1092856,03/14/2019
2009,Friendship,025001,401,282043,159,176231,458274,03/14/2019
2009,Fillmore,025801,844,329350,266,181264,510614,03/14/2019
2009,Whitesville,026001,247,158530,91,81576,240106,03/14/2019
2009,Scio,026601,486,337036,198,222809,559845,03/14/2019
2009,Wellsville,027001,1739,1204020,763,840893,2044913,03/14/2019
2009,Bolivar-Richburg,027602,1024,501058,366,272941,773999,03/14/2019
2009,Binghamton,030200,6353,4011490,2409,2642299,6653789,03/14/2019
2009,Chenango Forks,032001,2262,1466601,625,761779,2228380,03/14/2019
2009,South Mountain-Hickory,032201,147,30691,23,9620,40311,03/14/2019
2009,Harpursville,032601,1204,530391,336,260644,791035,03/14/2019
2009,Susquehanna Valley,032801,2561,1962399,807,1184025,3146424,03/14/2019
2009,Chenango Valley,033001,2813,2191332,1086,1625561,3816893,03/14/2019
2009,Maine-Endwell,033801,3706,2953924,1235,1769158,4723082,03/14/2019
2009,Deposit,034201,736,326349,323,269700,596049,03/14/2019
2009,Whitney Point,034401,1896,1067847,516,539886,1607733,03/14/2019
2009,Union-Endicott,034601,5992,4344584,2202,2935451,7280035,03/14/2019
2009,Johnson City,034602,3341,2251743,1422,1671624,3923367,03/14/2019
2009,Vestal,034801,6026,3941723,1741,2115176,6056899,03/14/2019
2009,Windsor,035001,2292,1289217,687,710316,1999533,03/14/2019
2009,Olean,041200,2952,1847937,973,1008446,2856383,03/14/2019
2009,Salamanca,041600,1081,527241,510,371279,898520,03/14/2019
2009,Allegany-Limestone,042001,1660,852603,585,477835,1330438,03/14/2019
2009,West Valley,042204,542,361971,173,212743,574714,03/14/2019
2009,Ellicottville,043601,745,173790,245,106471,280261,03/14/2019
2009,Franklinville,044001,1017,572278,325,309758,882036,03/14/2019
2009,Hinsdale,044601,665,317192,242,192792,509984,03/14/2019
2009,Cattaraugus - Little Valley,046402,1594,787311,473,384283,1171594,03/14/2019
2009,Gowanda,047201,1572,740379,571,490463,1230842,03/14/2019
2009,Portville,047401,1150,684544,394,411070,1095614,03/14/2019
2009,Randolph,047601,1275,516529,426,296961,813490,03/14/2019
2009,Yorkshire-Pioneer,048401,3526,1403478,992,741987,2145465,03/14/2019
2009,Auburn,050100,5601,3001045,2060,2049949,5050994,03/14/2019
2009,Weedsport,052201,1237,764701,326,380484,1145185,03/14/2019
2009,Cato-Meridian,052401,1493,795031,359,342816,1137847,03/14/2019
2009,Southern Cayuga,053001,1346,626707,399,328505,955212,03/14/2019
2009,Port Byron,053801,1396,891849,505,598889,1490738,03/14/2019
2009,Moravia,054201,1467,660294,373,299087,959381,03/14/2019
2009,Union Springs,055401,1325,704309,422,402966,1107275,03/14/2019
2009,Dunkirk,060300,2409,1521431,1146,1167524,2688955,03/14/2019
2009,Jamestown,060800,5031,2715840,1745,1527622,4243462,03/14/2019
2009,Southwestern,062201,2337,1367365,761,816800,2184165,03/14/2019
2009,Frewsburg,062401,1122,786669,364,472482,1259151,03/14/2019
2009,Cassadaga Valley,062601,1545,757057,499,415809,1172866,03/14/2019
2009,Chautauqua Lake,062803,1275,311423,456,205732,517155,03/14/2019
2009,Pine Valley,063001,913,549764,293,302900,852664,03/14/2019
2009,Clymer,063201,641,296293,223,196196,492489,03/14/2019
2009,Bemus Point,063601,1211,500948,415,316799,817747,03/14/2019
2009,Falconer,063801,1606,870556,593,575280,1445836,03/14/2019
2009,Silver Creek,064601,1308,668543,463,426128,1094671,03/14/2019
2009,Forestville,064603,959,500034,297,282343,782377,03/14/2019
2009,Panama,064801,849,496547,248,259530,756077,03/14/2019
2009,Fredonia,065801,2296,1368690,708,857988,2226678,03/14/2019
2009,Brocton,066001,838,596797,296,364108,960905,03/14/2019
2009,Ripley,066201,477,406392,168,238496,644888,03/14/2019
2009,Sherman,066601,595,328482,149,146797,475279,03/14/2019
2009,Westfield,067201,1080,636245,398,427935,1064180,03/14/2019
2009,Elmira,070400,8055,4702762,2857,2942787,7645549,03/14/2019
2009,Horseheads,073401,5907,3219339,1936,2032228,5251567,03/14/2019
2009,Elmira Heights,073402,1348,818361,498,568537,1386898,03/14/2019
2009,Norwich,081100,2410,1279655,801,751932,2031587,03/14/2019
2009,Afton,082001,888,512328,331,353565,865893,03/14/2019
2009,Bainbridge-Guilford,082201,1217,721682,471,499456,1221138,03/14/2019
2009,Greene,083001,1494,722052,533,484015,1206067,03/14/2019
2009,Unadilla Valley,083803,1164,523592,401,328347,851939,03/14/2019
2009,Georgetown-So Otselic Valley,084401,593,303261,160,140920,444181,03/14/2019
2009,Oxford Academy,084601,1159,639871,399,394706,1034577,03/14/2019
2009,Sherburne-Earlville,085601,1764,889539,599,553136,1442675,03/14/2019
2009,Plattsburgh,091300,2200,1364815,696,812696,2177511,03/14/2019
2009,Ausable Valley,092201,2028,1024041,685,562662,1586703,03/14/2019
2009,Beekmantown,092401,2890,1425536,814,701415,2126951,03/14/2019
2009,Northeastern Clinton,092801,2119,1219303,577,591930,1811233,03/14/2019
2009,Chazy,093001,734,396254,200,204559,600813,03/14/2019
2009,Northern Adirondack,093601,1456,455646,437,232802,688448,03/14/2019
2009,Peru,094001,2842,1518180,609,586316,2104496,03/14/2019
2009,Saranac,094401,2508,1298849,650,619297,1918146,03/14/2019
2009,Hudson,100600,2251,1118594,858,725767,1844361,03/14/2019
2009,Taconic Hills,102801,2242,778618,739,473795,1252413,03/14/2019
2009,Germantown,103602,959,430983,349,288750,719733,03/14/2019
2009,Chatham,103801,1975,909463,509,428955,1338418,03/14/2019
2009,Kinderhook,104401,3140,1537723,711,645245,2182968,03/14/2019
2009,New Lebanon,104801,924,388880,247,188205,577085,03/14/2019
2009,Cortland,110200,3226,1599768,1074,1033858,2633626,03/14/2019
2009,Cincinnatus,112001,767,373048,268,228049,601097,03/14/2019
2009,Mc Graw,112204,802,434589,226,223315,657904,03/14/2019
2009,Homer,113001,2870,1632284,759,832242,2464526,03/14/2019
2009,Marathon,113401,979,519500,303,288045,807545,03/14/2019
2009,Andes,122002,265,89042,153,92947,181989,03/14/2019
2009,Downsville,122401,396,124078,231,132509,256587,03/14/2019
2009,Charlotte Valley,122601,615,227713,243,162313,390026,03/14/2019
2009,Delhi,122801,1345,553285,531,406933,960218,03/14/2019
2009,Franklin,123201,472,188062,164,119548,307610,03/14/2019
2009,Hancock,123606,496,246341,231,202605,448946,03/14/2019
2009,Margaretville,124601,719,195894,315,158474,354368,03/14/2019
2009,Roxbury,124802,585,275662,244,205810,481472,03/14/2019
2009,Sidney,125001,1456,767034,638,632834,1399868,03/14/2019
2009,Stamford,125201,558,277328,220,200165,477493,03/14/2019
2009,South Kortright,125202,532,223770,245,191092,414862,03/14/2019
2009,Walton,125601,1272,450864,551,356367,807231,03/14/2019
2009,Beacon,130200,3780,2232257,835,964242,3196499,03/14/2019
2009,Poughkeepsie,131300,3135,1715482,832,855950,2571432,03/14/2019
2009,Dover,132602,1684,1351517,297,510367,1861884,03/14/2019
2009,Hyde Park,133201,5844,4593775,1463,2176711,6770486,03/14/2019
2009,Northeast,133801,1036,615573,300,335276,950849,03/14/2019
2009,Pawling,134001,2010,1515107,320,480538,1995645,03/14/2019
2009,Pine Plains,134201,1973,882587,511,434811,1317398,03/14/2019
2009,Arlington,134601,12064,9684459,1779,2790863,12475322,03/14/2019
2009,Spackenkill,134602,1934,1503902,395,573774,2077676,03/14/2019
2009,Red Hook,134801,2516,1938208,582,885927,2824135,03/14/2019
2009,Rhinebeck,135001,1907,1174268,529,633948,1808216,03/14/2019
2009,Wappingers,135601,16354,8828763,3070,3185716,12014479,03/14/2019
2009,Millbrook,135801,1566,801368,326,329309,1130677,03/14/2019
2009,Buffalo,140200,32267,11861839,8719,4520550,16382389,03/14/2019
2009,Lackawanna,140900,2499,754040,1338,625432,1379472,03/14/2019
2009,Tonawanda,141600,3367,1735366,1311,1300075,3035441,03/14/2019
2009,Alden,142001,2776,1534180,847,895786,2429966,03/14/2019
2009,Amherst,142201,5866,3473006,1328,1522524,4995530,03/14/2019
2009,Williamsville,142203,17341,9553515,3577,3745883,13299398,03/14/2019
2009,Sweet Home,142207,5462,2074625,2057,1550553,3625178,03/14/2019
2009,East Aurora,142401,3092,1388932,832,737049,2125981,03/14/2019
2009,Cheektowaga,143001,3902,1886610,1745,1500955,3387565,03/14/2019
2009,Cheektowaga-Maryvale,143002,3831,1844255,1970,1837355,3681610,03/14/2019
2009,Cleveland Hill,143003,2667,2037058,891,1311486,3348544,03/14/2019
2009,Depew,143007,3354,1998321,1262,1469638,3467959,03/14/2019
2009,Cheektowaga-Sloan,143009,2445,1996998,1318,2096845,4093843,03/14/2019
2009,Clarence,143201,6682,2830799,1421,1072409,3903208,03/14/2019
2009,Springville-Griffith,143801,3060,1583160,907,892702,2475862,03/14/2019
2009,Eden,144001,2505,1378557,678,741519,2120076,03/14/2019
2009,Iroquois,144201,4354,2030445,1269,1172780,3203225,03/14/2019
2009,Evans-Brant,144401,4103,2103190,1112,990596,3093786,03/14/2019
2009,Grand Island,144601,5103,2901246,1096,1217059,4118305,03/14/2019
2009,Hamburg,144801,5787,3025109,1472,1521918,4547027,03/14/2019
2009,Frontier,144804,8332,3704890,2303,1900181,5605071,03/14/2019
2009,Holland,145001,1742,624169,390,276503,900672,03/14/2019
2009,Lancaster,145201,9775,4392004,2705,2304097,6696101,03/14/2019
2009,Akron,145601,2033,962627,619,510762,1473389,03/14/2019
2009,North Collins,145801,1005,589061,293,327074,916135,03/14/2019
2009,Orchard Park,146001,7963,3941845,1749,1712142,5653987,03/14/2019
2009,Kenmore,146401,15169,8946554,5944,6936513,15883067,03/14/2019
2009,West Seneca,146801,11934,5949588,4710,4484086,10433674,03/14/2019
2009,Crown Point,152203,423,149603,155,97319,246922,03/14/2019
2009,Elizabethtown-Lewis,152401,556,230039,179,137898,367937,03/14/2019
2009,Keene,153001,283,79197,79,42159,121356,03/14/2019
2009,Minerva,153401,229,79819,96,54570,134389,03/14/2019
2009,Moriah,153601,1005,511131,471,409724,920855,03/14/2019
2009,Newcomb,153801,122,7738,64,7248,14986,03/14/2019
2009,Lake Placid,154002,1121,299817,344,164949,464766,03/14/2019
2009,Schroon Lake,154601,480,126927,233,109948,236875,03/14/2019
2009,Ticonderoga,154801,1188,330040,482,230860,560900,03/14/2019
2009,Westport,155001,301,134201,145,112719,246920,03/14/2019
2009,Willsboro,155201,547,219134,293,203783,422917,03/14/2019
2009,Tupper Lake,162001,1323,490641,462,278404,769045,03/14/2019
2009,Chateaugay,163401,754,317165,239,174371,491536,03/14/2019
2009,Salmon River,164201,806,290867,318,204765,495632,03/14/2019
2009,Saranac Lake,164601,2320,727540,590,320880,1048420,03/14/2019
2009,Malone,164801,3156,1468708,1084,882370,2351078,03/14/2019
2009,Brushton-Moira,165001,1036,530256,333,295252,825508,03/14/2019
2009,St. Regis Falls,165401,503,256371,168,145026,401397,03/14/2019
2009,Gloversville,170500,3289,1970251,1294,1251574,3221825,03/14/2019
2009,Johnstown,170800,2297,1008609,750,611184,1619793,03/14/2019
2009,Broadalbin-Perth,172201,2401,1140905,785,665154,1806059,03/14/2019
2009,Wheelerville,172401,369,123027,144,87723,210750,03/14/2019
2009,Mayfield,173001,1447,732898,488,430995,1163893,03/14/2019
2009,Northville,173201,655,224079,277,175004,399083,03/14/2019
2009,Oppenheim-Ephratah,173401,669,347763,207,186897,534660,03/14/2019
2009,Batavia,180200,3292,2193578,1055,1332755,3526333,03/14/2019
2009,Alexander,182202,1221,815957,345,446987,1262944,03/14/2019
2009,Byron-Bergen,183001,1605,1140570,441,549950,1690520,03/14/2019
2009,Elba,183401,613,411855,191,247312,659167,03/14/2019
2009,Le Roy,183601,1774,1271796,516,683182,1954978,03/14/2019
2009,Oakfield-Alabama,183801,1126,763805,396,504328,1268133,03/14/2019
2009,Pavilion,184001,1157,735303,287,328288,1063591,03/14/2019
2009,Pembroke,184202,1511,887678,482,527334,1415012,03/14/2019
2009,Cairo-Durham,192401,1870,758841,758,553888,1312729,03/14/2019
2009,Catskill,192601,2233,1137575,754,693149,1830724,03/14/2019
2009,Coxsackie-Athens,192801,2081,976283,605,520811,1497094,03/14/2019
2009,Greenville,193201,2028,1097396,631,625626,1723022,03/14/2019
2009,Hunter-Tannersville,193601,696,230432,296,178578,409010,03/14/2019
2009,Windham-Ashland-Jewett,194601,595,149227,273,126311,275538,03/14/2019
2009,Piseco,202001,89,6423,36,5096,11519,03/14/2019
2009,Indian Lake,202601,335,70688,158,66158,136846,03/14/2019
2009,Inlet,202801,82,10084,50,11642,21726,03/14/2019
2009,Lake Pleasant,203001,182,42500,105,46179,88679,03/14/2019
2009,Long Lake,203201,167,25455,93,25970,51425,03/14/2019
2009,Raquette Lake,203202,23,430,14,495,925,03/14/2019
2009,Wells,203601,226,64573,110,61524,126097,03/14/2019
2009,Little Falls,210900,1321,1008708,561,735793,1744501,03/14/2019
2009,West Canada Valley,212402,1096,553445,317,302223,855668,03/14/2019
2009,Frankfort-Schuyler,212602,1415,842431,589,669150,1511581,03/14/2019
2009,Ilion,212801,1713,807661,546,482423,1290084,03/14/2019
2009,Mohawk,212802,1095,592348,433,440234,1032582,03/14/2019
2009,Herkimer,213001,1529,900378,745,773221,1673599,03/14/2019
2009,Dolgeville,213602,1121,466752,403,296508,763260,03/14/2019
2009,Poland,213803,992,374980,297,212218,587198,03/14/2019
2009,Van Hornesville-Owen D. Young,215001,328,169575,114,111973,281548,03/14/2019
2009,Town Of Webb,215401,568,72047,276,64454,136501,03/14/2019
2009,Mount Markham,215601,1564,838536,469,452866,1291402,03/14/2019
2009,Watertown,221800,4202,1312454,1210,676151,1988605,03/14/2019
2009,South Jefferson,222001,2406,877732,559,356091,1233823,03/14/2019
2009,Alexandria,222202,913,324774,300,186612,511386,03/14/2019
2009,Indian River,222401,1939,355734,428,130906,486640,03/14/2019
2009,General Brown,222601,2011,645061,538,307537,952598,03/14/2019
2009,Thousand Islands,223201,1636,617358,531,355844,973202,03/14/2019
2009,Belleville-Henderson,223402,761,205630,278,128995,334625,03/14/2019
2009,Sackets Harbor,223801,663,288620,180,142122,430742,03/14/2019
2009,Lyme,224401,604,208592,240,151987,360579,03/14/2019
2009,La Fargeville,224601,668,216671,172,97245,313916,03/14/2019
2009,Carthage,226001,2744,1174894,728,538314,1713208,03/14/2019
2009,Copenhagen,232201,650,215417,141,81045,296462,03/14/2019
2009,Harrisville,232401,566,319121,210,186985,506106,03/14/2019
2009,Lowville,233601,1700,487057,501,251973,739030,03/14/2019
2009,South Lewis,234001,1600,682280,535,370161,1052441,03/14/2019
2009,Beaver River,234401,1276,407506,381,222553,630059,03/14/2019
2009,Avon,242001,1350,934290,317,409416,1343706,03/14/2019
2009,Caledonia-Mumford,242201,1347,760915,392,428460,1189375,03/14/2019
2009,Geneseo,242601,1435,699600,336,320259,1019859,03/14/2019
2009,Livonia,243401,2701,1618651,595,681361,2300012,03/14/2019
2009,Mount Morris,243601,630,459972,231,298930,758902,03/14/2019
2009,Dansville,243801,2188,1081734,733,647291,1729025,03/14/2019
2009,Dalton-Nunda,244001,1202,731353,364,383220,1114573,03/14/2019
2009,York,245201,1189,704210,313,338990,1043200,03/14/2019
2009,Oneida,251200,2961,1700811,959,1045287,2746098,03/14/2019
2009,Brookfield,252009,323,150269,94,76066,226335,03/14/2019
2009,Cazenovia,252201,2380,1151615,488,440989,1592604,03/14/2019
2009,De Ruyter,252401,573,329471,174,175259,504730,03/14/2019
2009,Morrisville-Eaton,252601,1072,510464,262,218334,728798,03/14/2019
2009,Hamilton,253201,1015,519182,247,233781,752963,03/14/2019
2009,Canastota,253601,2088,1305918,676,790185,2096103,03/14/2019
2009,Madison,254001,623,392689,200,221054,613743,03/14/2019
2009,Stockbridge Valley,254601,612,356517,172,184223,540740,03/14/2019
2009,Chittenango,254801,3282,2167857,891,1064274,3232131,03/14/2019
2009,Rochester,261400,26701,10606944,4803,3131765,13738709,03/14/2019
2009,Brighton,262001,5567,3995988,905,1254515,5250503,03/14/2019
2009,Gates-Chili,262601,8025,5631905,2813,3770128,9402033,03/14/2019
2009,Greece,262801,19213,12506818,5089,6493536,19000354,03/14/2019
2009,East Irondequoit,263401,6773,5268168,2291,3437841,8706009,03/14/2019
2009,West Irondequoit,263403,6469,4869025,1889,2830668,7699693,03/14/2019
2009,Honeoye Falls-Lima,263601,3364,2154298,590,744918,2899216,03/14/2019
2009,Spencerport,263801,5600,3904957,1311,1801221,5706178,03/14/2019
2009,Hilton,264001,6722,4457181,1462,1880891,6338072,03/14/2019
2009,Penfield,264201,8120,5856154,1592,2220229,8076383,03/14/2019
2009,Fairport,264401,10086,6290761,2221,2676089,8966850,03/14/2019
2009,East Rochester,264413,1853,1366644,621,817082,2183726,03/14/2019
2009,Pittsford,264601,8821,6182552,1095,1499685,7682237,03/14/2019
2009,Churchville-Chili,264801,6051,4042371,1370,1770876,5813247,03/14/2019
2009,Rush-Henrietta,265001,9131,5089338,2185,2363483,7452821,03/14/2019
2009,Brockport,265201,5035,3631785,946,1270200,4901985,03/14/2019
2009,Webster,265401,13488,8075932,3214,3771106,11847038,03/14/2019
2009,Wheatland-Chili,265601,1387,929137,364,447253,1376390,03/14/2019
2009,Amsterdam,270100,4345,2496637,1843,1918474,4415111,03/14/2019
2009,Canajoharie,272201,1334,780965,447,485059,1266024,03/14/2019
2009,Fonda-Fultonville,272801,2022,1031081,580,535018,1566099,03/14/2019
2009,Fort Plain,273001,995,850960,412,606266,1457226,03/14/2019
2009,St. Johnsville,273802,626,325428,260,233817,559245,03/14/2019
2009,Glen Cove,280500,3661,2285891,1132,1667137,3953028,03/14/2019
2009,Long Beach,281000,7575,4684487,1046,1305735,5990222,03/14/2019
2009,Hempstead,282001,3236,3660328,469,1040275,4700603,03/14/2019
2009,Uniondale,282002,5435,4240499,810,1330785,5571284,03/14/2019
2009,East Meadow,282003,11217,11587956,2805,4883971,16471927,03/14/2019
2009,North Bellmore,282004,6064,6542010,1158,2467619,9009629,03/14/2019
2009,Levittown,282005,11222,14529133,2277,5839694,20368827,03/14/2019
2009,Seaford,282006,3983,3920460,797,1449779,5370239,03/14/2019
2009,Bellmore,282007,3189,3290833,466,962221,4253054,03/14/2019
2009,Roosevelt,282008,2372,2412082,343,757220,3169302,03/14/2019
2009,Freeport,282009,6259,5869831,952,1850854,7720685,03/14/2019
2009,Baldwin,282010,7477,8684127,1022,2270179,10954306,03/14/2019
2009,Oceanside,282011,8871,8236021,1617,2851628,11087649,03/14/2019
2009,Malverne,282012,3166,3600401,569,1295452,4895853,03/14/2019
2009,Valley Stream 13,282013,6160,6323018,1374,2675045,8998063,03/14/2019
2009,Hewlett-Woodmere,282014,4933,6271619,597,1509567,7781186,03/14/2019
2009,Lawrence,282015,6431,3649058,846,971912,4620970,03/14/2019
2009,Elmont,282016,8337,7489634,1496,2685206,10174840,03/14/2019
2009,Franklin Square,282017,5171,4283892,1349,2233793,6517685,03/14/2019
2009,Garden City,282018,5776,3960897,625,852743,4813640,03/14/2019
2009,East Rockaway,282019,2115,2251690,506,1068136,3319826,03/14/2019
2009,Lynbrook,282020,3936,4135639,736,1525957,5661596,03/14/2019
2009,Rockville Centre,282021,5083,4903333,658,1248315,6151648,03/14/2019
2009,Floral Park-Bellerose,282022,4405,3534130,764,1199228,4733358,03/14/2019
2009,Wantagh,282023,4532,4890730,653,1409074,6299804,03/14/2019
2009,Valley Stream 24,282024,2608,2144630,519,828644,2973274,03/14/2019
2009,Merrick,282025,4837,5192614,543,1167233,6359847,03/14/2019
2009,Island Trees,282026,3434,3283839,725,1383665,4667504,03/14/2019
2009,West Hempstead,282027,3720,3451013,628,1163588,4614601,03/14/2019
2009,North Merrick,282029,3418,3634862,617,1277132,4911994,03/14/2019
2009,Valley Stream 30,282030,3044,2400461,514,810941,3211402,03/14/2019
2009,Island Park,282031,1594,1023989,302,388072,1412061,03/14/2019
2009,Westbury,282201,3352,3857120,633,1416168,5273288,03/14/2019
2009,East Williston,282202,2162,1937690,195,339227,2276917,03/14/2019
2009,Roslyn,282203,4333,4451048,312,637563,5088611,03/14/2019
2009,Port Washington,282204,6258,4775612,692,1051981,5827593,03/14/2019
2009,New Hyde Park-Garden City,282205,4842,3858171,1120,1786055,5644226,03/14/2019
2009,Manhasset,282206,3999,2273108,296,336598,2609706,03/14/2019
2009,Great Neck,282207,9998,5420842,963,1008602,6429444,03/14/2019
2009,Herricks,282209,6299,5748573,931,1700811,7449384,03/14/2019
2009,Mineola,282210,4727,3817821,1055,1706390,5524211,03/14/2019
2009,Carle Place,282211,1963,1747855,411,732117,2479972,03/14/2019
2009,North Shore,282401,3883,2773759,522,725019,3498778,03/14/2019
2009,Syosset,282402,8369,9125646,1062,1801693,10927339,03/14/2019
2009,Locust Valley,282403,3486,2291896,396,505397,2797293,03/14/2019
2009,Plainview-Old Bethpage,282404,7513,8238001,1184,2598022,10836023,03/14/2019
2009,Oyster Bay-East Norwich,282406,2753,1520490,345,385484,1905974,03/14/2019
2009,Jericho,282415,3409,2856742,288,467798,3324540,03/14/2019
2009,Hicksville,282417,7975,5595932,1993,2707907,8303839,03/14/2019
2009,Plainedge,282418,4593,5712119,1103,2744256,8456375,03/14/2019
2009,Bethpage,282421,4177,3559439,1371,1674563,5234002,03/14/2019
2009,Farmingdale,282422,8802,9681864,1956,4288218,13970082,03/14/2019
2009,Massapequa,282423,11884,11471053,2287,4382981,15854034,03/14/2019
2009,Lockport,290900,6493,4832379,1750,2185741,7018120,03/14/2019
2009,Niagara Falls,291100,8217,4248395,3395,2966502,7214897,03/14/2019
2009,North Tonawanda,291200,6721,4073990,2315,2722595,6796585,03/14/2019
2009,Lewiston-Porter,292401,4300,2478696,1426,1627368,4106064,03/14/2019
2009,Newfane,292801,2403,2016383,752,1198035,3214418,03/14/2019
2009,Niagara-Wheatfield,293001,5442,2791071,1742,1633687,4424758,03/14/2019
2009,Starpoint,293201,4269,2713263,941,1175209,3888472,03/14/2019
2009,Royalton-Hartland,293601,2106,1279942,617,727517,2007459,03/14/2019
2009,Barker,293801,1182,608514,333,315365,923879,03/14/2019
2009,Wilson,294201,1954,1332254,537,715482,2047736,03/14/2019
2009,Rome,301300,6548,4077577,2370,2660126,6737703,03/14/2019
2009,Utica,301600,8142,5169974,3259,3539120,8709094,03/14/2019
2009,Adirondack,302601,2015,897229,644,491606,1388835,03/14/2019
2009,Camden,303001,2950,1340216,920,690252,2030468,03/14/2019
2009,Clinton,304001,2062,1596909,598,754621,2351530,03/14/2019
2009,New Hartford,304801,4017,2516530,1176,1368155,3884685,03/14/2019
2009,New York Mills,304804,862,535231,446,540638,1075869,03/14/2019
2009,Sauquoit Valley,305002,1500,861072,415,446118,1307190,03/14/2019
2009,Remsen,305201,773,490694,217,255120,745814,03/14/2019
2009,Waterville,305401,1185,617279,346,334413,951692,03/14/2019
2009,Holland Patent,305801,2296,1333352,621,668902,2002254,03/14/2019
2009,Sherrill,306000,2765,1583746,915,994199,2577945,03/14/2019
2009,Westmoreland,306801,1561,1186227,495,665050,1851277,03/14/2019
2009,Oriskany,307001,972,678615,305,405133,1083748,03/14/2019
2009,Whitesboro,307002,5236,3018689,1780,1997604,5016293,03/14/2019
2009,Syracuse,311500,16914,7593654,4462,3562043,11155697,03/14/2019
2009,West Genesee,312001,7673,4670362,2625,3071479,7741841,03/14/2019
2009,North Syracuse,312403,14778,8934223,3439,3759939,12694162,03/14/2019
2009,East Syracuse-Minoa,312601,5067,3617100,1855,2329929,5947029,03/14/2019
2009,Jamesville-Dewitt,312611,4355,2685899,774,914383,3600282,03/14/2019
2009,Jordan-Elbridge,312801,1850,1451126,523,695200,2146326,03/14/2019
2009,Fabius-Pompey,313001,1191,891687,289,409300,1300987,03/14/2019
2009,Westhill,313201,2852,2148426,823,1209197,3357623,03/14/2019
2009,Solvay,313202,1911,1385795,865,1199216,2585011,03/14/2019
2009,La Fayette,313407,1126,584231,246,234930,819161,03/14/2019
2009,Baldwinsville,313601,8368,5753893,1789,2311569,8065462,03/14/2019
2009,Fayetteville-Manlius,313801,6509,4662932,1143,1588245,6251177,03/14/2019
2009,Marcellus,314001,2743,1788762,670,847766,2636528,03/14/2019
2009,Onondaga,314201,1572,1317222,420,657640,1974862,03/14/2019
2009,Liverpool,314801,11185,7870165,2914,3799371,11669536,03/14/2019
2009,Lyncourt,314804,843,696320,424,595539,1291859,03/14/2019
2009,Skaneateles,315001,2312,1037743,564,472208,1509951,03/14/2019
2009,Tully,315402,1418,830005,284,299942,1129947,03/14/2019
2009,Canandaigua,320200,4827,2467807,1092,1061415,3529222,03/14/2019
2009,Geneva,320500,2757,1724218,1050,1203008,2927226,03/14/2019
2009,East Bloomfield,322601,1438,1013030,329,445625,1458655,03/14/2019
2009,Gorham-Middlesex,323201,2291,991244,644,518165,1509409,03/14/2019
2009,Manchester-Shortsville,323601,1215,958829,387,589486,1548315,03/14/2019
2009,Naples,323801,1400,635335,383,328084,963419,03/14/2019
2009,Phelps-Clifton Springs,324001,2377,1638619,631,842905,2481524,03/14/2019
2009,Honeoye,324201,1604,806247,415,391926,1198173,03/14/2019
2009,Victor,324801,5130,2653292,888,859221,3512513,03/14/2019
2009,Middletown,330900,6078,4264887,1192,1567741,5832628,03/14/2019
2009,Newburgh,331100,10561,8507852,2319,3527896,12035748,03/14/2019
2009,Port Jervis,331300,2895,2632944,870,1457704,4090648,03/14/2019
2009,Washingtonville,332002,5720,4609108,695,1161132,5770240,03/14/2019
2009,Chester,332201,1444,1100550,229,340197,1440747,03/14/2019
2009,Cornwall,332401,3740,2879914,539,803367,3683281,03/14/2019
2009,Pine Bush,332601,6394,4124354,981,1211496,5335850,03/14/2019
2009,Goshen,333001,3282,2216000,585,785318,3001318,03/14/2019
2009,Highland Falls,333601,894,547056,220,257961,805017,03/14/2019
2009,Minisink Valley,333801,4944,3303758,672,880987,4184745,03/14/2019
2009,Monroe-Woodbury,334001,9123,8134694,1009,1820300,9954994,03/14/2019
2009,Kiryas Joel Village,334002,982,449483,29,24295,473778,03/14/2019
2009,Valley,334201,5389,3630313,1024,1351534,4981847,03/14/2019
2009,Tuxedo,335003,578,236099,83,67873,303972,03/14/2019
2009,Warwick Valley,335401,5518,3935547,802,1132132,5067679,03/14/2019
2009,Greenwood Lake,335411,1674,1373312,260,423508,1796820,03/14/2019
2009,Florida,335415,1154,1000543,263,453780,1454323,03/14/2019
2009,Albion,342001,2422,1292433,810,783282,2075715,03/14/2019
2009,Kendall,343007,1278,843439,327,402732,1246171,03/14/2019
2009,Holley,343204,1545,1241290,464,673535,1914825,03/14/2019
2009,Medina,343401,2124,1554650,776,1015077,2569727,03/14/2019
2009,Lyndonville,343801,1001,587525,313,348156,935681,03/14/2019
2009,Fulton,350400,3883,2899166,1170,1480280,4379446,03/14/2019
2009,Oswego,351200,5431,3731544,1596,1867660,5599204,03/14/2019
2009,Altmar Parish-Williamstown,352002,1742,1196854,451,534846,1731700,03/14/2019
2009,Hannibal,353001,1808,1204270,442,532241,1736511,03/14/2019
2009,Central Square,353201,5960,3203642,1331,1276376,4480018,03/14/2019
2009,Mexico,353401,3065,1778980,657,701011,2479991,03/14/2019
2009,Pulaski,355001,1255,773926,335,373597,1147523,03/14/2019
2009,Sandy Creek,355201,1268,637309,435,374547,1011856,03/14/2019
2009,Phoenix,355401,2887,2323601,683,1000129,3323730,03/14/2019
2009,Oneonta,361200,2718,1581236,776,833967,2415203,03/14/2019
2009,Gilbertsville-Mt Upton,362202,698,265587,272,186760,452347,03/14/2019
2009,Cherry Valley-Springfield,362401,900,342924,366,250814,593738,03/14/2019
2009,Edmeston,362801,628,237323,213,151363,388686,03/14/2019
2009,Laurens,363401,571,280633,205,190254,470887,03/14/2019
2009,Schenevus,363601,579,328844,225,220994,549838,03/14/2019
2009,Milford,364001,636,328901,282,271328,600229,03/14/2019
2009,Morris,364201,583,298356,221,206338,504694,03/14/2019
2009,Otego-Unadilla,364801,1461,808427,521,498233,1306660,03/14/2019
2009,Cooperstown,365001,1347,506603,423,290381,796984,03/14/2019
2009,Richfield Springs,365601,874,273059,374,213419,486478,03/14/2019
2009,Worcester,366606,514,259413,245,222916,482329,03/14/2019
2009,Mahopac,372001,6450,7097909,841,1832246,8930155,03/14/2019
2009,Carmel,372002,7105,7528158,907,1881397,9409555,03/14/2019
2009,Haldane,372601,1165,1001360,229,354962,1356322,03/14/2019
2009,Garrison,372604,592,282252,77,73503,355755,03/14/2019
2009,Putnam Valley,372803,2846,3871824,322,849055,4720879,03/14/2019
2009,Brewster,373001,5112,5187829,801,1652913,6840742,03/14/2019
2009,Rensselaer,381400,1383,718508,381,335356,1053864,03/14/2019
2009,Troy,381700,4412,2754775,1183,1269485,4024260,03/14/2019
2009,Lansingburgh,381701,2811,1519651,833,799951,2319602,03/14/2019
2009,Berlin,382001,1639,778425,399,340005,1118430,03/14/2019
2009,Brunswick,382202,1892,999892,495,462320,1462212,03/14/2019
2009,East Greenbush,382401,7155,4034426,1505,1569981,5604407,03/14/2019
2009,Hoosick Falls,382801,1728,937601,561,522929,1460530,03/14/2019
2009,North Greenbush,383201,374,66070,120,41032,107102,03/14/2019
2009,Wynantskill,383204,923,525951,260,283834,809785,03/14/2019
2009,Averill Park,384001,4812,2505634,943,907742,3413376,03/14/2019
2009,Hoosic Valley,384201,1613,841043,391,371525,1212568,03/14/2019
2009,Schodack,384401,1556,954704,313,358438,1313142,03/14/2019
2009,Clarkstown,392001,12061,10586271,1713,3003280,13589551,03/14/2019
2009,Nanuet,392008,2465,2231906,564,1008990,3240896,03/14/2019
2009,Haverstraw-Stony Point,392201,8744,12402471,1836,4837162,17239633,03/14/2019
2009,South Orangetown,392401,4596,4886904,939,1995403,6882307,03/14/2019
2009,Nyack,392404,4308,5272570,776,1968620,7241190,03/14/2019
2009,Pearl River,392408,3313,3799019,722,1654553,5453572,03/14/2019
2009,Ramapo,392601,6122,9023559,1104,3121379,12144938,03/14/2019
2009,East Ramapo,392602,12592,12586735,1681,3076426,15663161,03/14/2019
2009,Ogdensburg,401200,2217,1518695,676,666778,2185473,03/14/2019
2009,Brasher Falls,402001,1354,808756,452,457751,1266507,03/14/2019
2009,Canton,402201,1849,991297,475,465053,1456350,03/14/2019
2009,Clifton-Fine,402601,509,183604,241,130163,313767,03/14/2019
2009,Colton-Pierrepont,402801,650,267858,226,159752,427610,03/14/2019
2009,Edwards-Knox,403401,746,245251,227,124491,369742,03/14/2019
2009,Gouverneur,404001,2076,805361,567,373069,1178430,03/14/2019
2009,Hammond,404201,425,182183,162,114430,296613,03/14/2019
2009,Hermon-Dekalb,404401,578,308365,178,164822,473187,03/14/2019
2009,Lisbon,405002,848,440399,241,225883,666282,03/14/2019
2009,Madrid-Waddington,405601,1004,567711,346,344401,912112,03/14/2019
2009,Massena,405801,3530,2009132,1320,1333481,3342613,03/14/2019
2009,Morristown,406001,653,288377,236,181740,470117,03/14/2019
2009,Norwood-Norfolk,406201,1456,1089627,492,626521,1716148,03/14/2019
2009,Heuvelton,406404,874,537169,272,300613,837782,03/14/2019
2009,Parishville-Hopkinton,406601,683,265884,181,116520,382404,03/14/2019
2009,Potsdam,407402,1973,1308311,501,595007,1903318,03/14/2019
2009,Mechanicville,411000,1631,844594,555,568306,1412900,03/14/2019
2009,Saratoga Springs,411500,9929,4194102,1689,1348185,5542287,03/14/2019
2009,Burnt Hills-Ballston Lake,412001,5104,3137016,1138,1356399,4493415,03/14/2019
2009,Shenendehowa,412402,14542,8225719,1932,2182580,10408299,03/14/2019
2009,Corinth,412601,1613,641070,496,360919,1001989,03/14/2019
2009,Edinburg,413001,371,61395,135,41675,103070,03/14/2019
2009,Galway,413201,1709,755416,418,340951,1096367,03/14/2019
2009,Ballston Spa,414201,5690,3914906,1097,1347488,5262394,03/14/2019
2009,South Glens Falls,414401,3939,2544853,1084,1304984,3849837,03/14/2019
2009,Schuylerville,415001,2424,1771570,467,616797,2388367,03/14/2019
2009,Stillwater,415201,1779,707723,366,277267,984990,03/14/2019
2009,Waterford-Halfmoon,415401,1029,713228,390,496284,1209512,03/14/2019
2009,Schenectady,421500,8537,5956406,2437,2893235,8849641,03/14/2019
2009,Duanesburg,422001,1350,682658,251,239516,922174,03/14/2019
2009,Scotia-Glenville,422202,4369,2599028,1101,1218712,3817740,03/14/2019
2009,Niskayuna,422401,6470,3524123,848,878685,4402808,03/14/2019
2009,Schalmont,422801,3434,2004104,918,1000019,3004123,03/14/2019
2009,Rotterdam-Mohonasen,422803,4951,2450548,1855,1711782,4162330,03/14/2019
2009,Cobleskill-Richmondville,432602,2533,1396237,867,833493,2229730,03/14/2019
2009,Gilboa-Conesville,433401,574,243624,258,188850,432474,03/14/2019
2009,Jefferson,433601,455,201290,160,127557,328847,03/14/2019
2009,Middleburgh,433801,1333,775165,469,474887,1250052,03/14/2019
2009,Schoharie,434201,1582,862869,446,446263,1309132,03/14/2019
2009,Sharon Springs,434601,427,276097,159,182741,458838,03/14/2019
2009,Odessa-Montour,442001,1259,731341,413,434412,1165753,03/14/2019
2009,Watkins Glen,442401,1853,697452,687,468642,1166094,03/14/2019
2009,South Seneca,452801,1390,670799,499,430515,1101314,03/14/2019
2009,Romulus,453003,760,443607,222,246304,689911,03/14/2019
2009,Seneca Falls,453201,1993,1553261,707,1017371,2570632,03/14/2019
2009,Waterloo,453801,2285,1484223,823,981504,2465727,03/14/2019
2009,Corning,460300,7317,5062031,2095,2528166,7590197,03/14/2019
2009,Hornell,460600,1858,979118,628,545000,1524118,03/14/2019
2009,Addison,462001,1494,880897,435,410108,1291005,03/14/2019
2009,Avoca,462201,815,362056,254,187976,550032,03/14/2019
2009,Bath,462402,1865,1027598,637,679696,1707294,03/14/2019
2009,Bradford,462601,469,275304,157,160352,435656,03/14/2019
2009,Campbell-Savona,463002,1246,734385,376,398689,1133074,03/14/2019
2009,Canisteo-Greenwood,463202,1308,744684,533,495645,1240329,03/14/2019
2009,Arkport,465201,677,422935,294,282945,705880,03/14/2019
2009,Jasper-Troupsburg,465601,641,266118,212,152070,418188,03/14/2019
2009,Prattsburgh,466001,661,297794,210,169009,466803,03/14/2019
2009,Hammondsport,467201,1082,376963,396,242022,618985,03/14/2019
2009,Wayland-Cohocton,467401,2103,1027104,668,569489,1596593,03/14/2019
2009,Babylon,472001,2691,3053075,381,833858,3886933,03/14/2019
2009,West Babylon,472002,5326,5383764,1066,2105885,7489649,03/14/2019
2009,North Babylon,472003,6412,6364401,1442,2816692,9181093,03/14/2019
2009,Lindenhurst,472004,8275,8941535,1743,3713142,12654677,03/14/2019
2009,Copiague,472005,5044,5120856,1105,2118718,7239574,03/14/2019
2009,Amityville,472006,4138,4118011,832,1464158,5582169,03/14/2019
2009,Deer Park,472007,5113,5290948,1383,2799104,8090052,03/14/2019
2009,Wyandanch,472009,1181,1260618,190,392266,1652884,03/14/2019
2009,Three Village,472201,9590,8995829,1446,2680296,11676125,03/14/2019
2009,Brookhaven-Comsewogue,472203,4567,4099915,833,1442546,5542461,03/14/2019
2009,South Country,472204,5230,4500837,717,1207739,5708576,03/14/2019
2009,Sachem,472205,17691,13777411,2534,3856398,17633809,03/14/2019
2009,Port Jefferson,472206,1633,881541,215,231291,1112832,03/14/2019
2009,Mount Sinai,472207,3253,3193795,478,928992,4122787,03/14/2019
2009,Miller Place,472208,3803,3734702,380,730652,4465354,03/14/2019
2009,Rocky Point,472209,4058,4301776,491,1021309,5323085,03/14/2019
2009,Middle Country,472211,12237,11346552,2307,4196099,15542651,03/14/2019
2009,Longwood,472212,12669,12266436,3089,5455162,17721598,03/14/2019
2009,Patchogue-Medford,472224,9686,9256989,1640,3002728,12259717,03/14/2019
2009,William Floyd,472232,9701,9500489,1293,2419143,11919632,03/14/2019
2009,Center Moriches,472233,1717,1777144,247,498225,2275369,03/14/2019
2009,East Moriches,472234,1355,1379550,159,323761,1703311,03/14/2019
2009,Eastport- South Manor,472235,4269,4038545,841,1421053,5459598,03/14/2019
2009,East Hampton,472401,1352,265350,333,137039,402389,03/14/2019
2009,Wainscott,472402,118,8206,23,3556,11762,03/14/2019
2009,Amagansett,472403,261,24687,84,17472,42159,03/14/2019
2009,Springs,472404,1014,303782,278,183367,487149,03/14/2019
2009,Sag Harbor,472405,1317,341986,476,255265,597251,03/14/2019
2009,Montauk,472406,694,102610,237,96772,199382,03/14/2019
2009,Elwood,472601,3232,3110648,559,1073175,4183823,03/14/2019
2009,Cold Spring Harbor,472602,2163,1767681,126,206623,1974304,03/14/2019
2009,Huntington,472603,7776,7232346,1152,2099787,9332133,03/14/2019
2009,Northport-East Northport,472604,9115,6863988,1423,2135874,8999862,03/14/2019
2009,Half Hollow Hills,472605,11353,8764774,1606,2333408,11098182,03/14/2019
2009,Harborfields,472606,4789,4624864,672,1294154,5919018,03/14/2019
2009,Commack,472610,9341,9601221,1722,3552455,13153676,03/14/2019
2009,South Huntington,472613,8868,8561180,1647,3163284,11724464,03/14/2019
2009,Bay Shore,472801,5832,5844523,1039,2035854,7880377,03/14/2019
2009,Islip,472802,3962,4146728,670,1278666,5425394,03/14/2019
2009,East Islip,472803,5592,5490527,1041,2263578,7754105,03/14/2019
2009,Sayville,472804,4106,3987173,802,1535931,5523104,03/14/2019
2009,Bayport-Blue Point,472805,3169,3498457,460,1019538,4517995,03/14/2019
2009,Hauppauge,472806,5177,2956340,949,1075651,4031991,03/14/2019
2009,Connetquot,472807,8754,8033408,1578,2821316,10854724,03/14/2019
2009,West Islip,472809,6624,5848174,1252,2214377,8062551,03/14/2019
2009,Brentwood,472812,9894,6353550,1971,2532907,8886457,03/14/2019
2009,Central Islip,472813,5692,6350364,915,2005036,8355400,03/14/2019
2009,Fire Island,472814,111,10818,15,2924,13742,03/14/2019
2009,Shoreham-Wading River,473001,3244,2771237,724,1144762,3915999,03/14/2019
2009,Riverhead,473002,6941,4686533,2594,2807962,7494495,03/14/2019
2009,Shelter Island,473201,627,117129,196,69792,186921,03/14/2019
2009,Smithtown,473401,13864,13025453,2368,4268482,17293935,03/14/2019
2009,Kings Park,473405,5489,4797099,890,1562412,6359511,03/14/2019
2009,Remsenburg-Speonk,473601,442,125132,87,49419,174551,03/14/2019
2009,Westhampton Beach,473602,1047,338255,242,153910,492165,03/14/2019
2009,Quogue,473603,251,27319,41,8971,36290,03/14/2019
2009,Hampton Bays,473605,2219,1268765,736,854589,2123354,03/14/2019
2009,Southhampton,473606,1736,248316,561,163553,411869,03/14/2019
2009,Bridgehampton,473609,289,26872,93,17670,44542,03/14/2019
2009,Sagaponack,473610,71,2086,9,541,2627,03/14/2019
2009,Tuckahoe Common,473613,537,203748,181,139768,343516,03/14/2019
2009,East Quogue,473617,1156,603750,299,296584,900334,03/14/2019
2009,Oysterponds,473802,410,98767,164,79014,177781,03/14/2019
2009,Fishers Island,473804,34,8066,5,2013,10079,03/14/2019
2009,Southold,473805,1601,766826,542,519394,1286220,03/14/2019
2009,Greenport,473810,650,318400,270,255397,573797,03/14/2019
2009,Mattituck-Cutchogue,473812,2284,1146797,595,597182,1743979,03/14/2019
2009,New Suffolk,473815,93,15555,29,9628,25183,03/14/2019
2009,Fallsburg,482801,1307,1006525,317,433665,1440190,03/14/2019
2009,Eldred,483401,1130,558694,376,347889,906583,03/14/2019
2009,Liberty,483601,1501,1014660,549,679811,1694471,03/14/2019
2009,Tri-Valley,484201,1315,776550,340,350600,1127150,03/14/2019
2009,Roscoe,484401,379,162775,179,141004,303779,03/14/2019
2009,Livingston Manor,484402,639,273615,243,182651,456266,03/14/2019
2009,Monticello,484601,3361,1700627,1012,926549,2627176,03/14/2019
2009,Sullivan West,484802,2187,948741,894,706405,1655146,03/14/2019
2009,Waverly,492001,1865,973736,657,583869,1557605,03/14/2019
2009,Candor,492401,1073,559296,341,334489,893785,03/14/2019
2009,Newark Valley,492602,1765,1046461,537,591038,1637499,03/14/2019
2009,Owego-Apalachin,493001,3035,1772748,986,1071296,2844044,03/14/2019
2009,Spencer-Van Etten,493401,1361,627227,418,350654,977881,03/14/2019
2009,Tioga,493603,1228,346036,364,187158,533194,03/14/2019
2009,Ithaca,500700,8468,4168996,1549,1344121,5513117,03/14/2019
2009,Dryden,502401,2550,1610504,570,599251,2209755,03/14/2019
2009,Groton,502801,1348,776315,321,330068,1106383,03/14/2019
2009,Lansing,503201,1776,938010,322,322468,1260478,03/14/2019
2009,Newfield,503401,1070,533452,298,225033,758485,03/14/2019
2009,Trumansburg,503601,1758,1101715,401,441156,1542871,03/14/2019
2009,Kingston,510800,8955,5509660,2662,3051543,8561203,03/14/2019
2009,Highland,513203,2494,1448918,501,544177,1993095,03/14/2019
2009,Rondout Valley,513401,3870,2408761,979,1102578,3511339,03/14/2019
2009,Marlboro,513601,2529,1772462,502,673119,2445581,03/14/2019
2009,New Paltz,513801,3296,1966308,638,726304,2692612,03/14/2019
2009,Onteora,514001,3610,1510943,1164,904381,2415324,03/14/2019
2009,Saugerties,514801,4521,2461417,1244,1254565,3715982,03/14/2019
2009,Wallkill,515201,4078,2856540,891,968427,3824967,03/14/2019
2009,Ellenville,515602,1771,1171289,545,587671,1758960,03/14/2019
2009,Glens Falls,520500,2923,1598605,801,798892,2397497,03/14/2019
2009,Bolton,522001,417,74804,148,49554,124358,03/14/2019
2009,Lake George,522201,1531,321611,433,171822,493433,03/14/2019
2009,North Warren,522402,1071,299822,438,221508,521330,03/14/2019
2009,Johnsburg,523001,587,274353,222,191444,465797,03/14/2019
2009,Hadley-Luzerne,523201,1370,475006,535,340253,815259,03/14/2019
2009,Queensbury,523402,4649,2289107,1068,941889,3230996,03/14/2019
2009,Glens Falls Common,523418,274,108800,86,61432,170232,03/14/2019
2009,Warrensburg,524001,1285,612558,431,372040,984598,03/14/2019
2009,Argyle,532001,948,473939,267,241285,715224,03/14/2019
2009,Fort Ann,532802,834,479145,234,244397,723542,03/14/2019
2009,Fort Edward,533001,568,311227,193,198159,509386,03/14/2019
2009,Granville,533201,1568,789335,494,434064,1223399,03/14/2019
2009,Greenwich,533401,1480,812400,476,480259,1292659,03/14/2019
2009,Hartford,533801,724,384030,188,181058,565088,03/14/2019
2009,Hudson Falls,534401,2709,1335461,987,886078,2221539,03/14/2019
2009,Putnam,534601,164,34719,56,20466,55185,03/14/2019
2009,Salem,534801,905,442713,323,276210,718923,03/14/2019
2009,Cambridge,535010,1371,680177,505,452982,1133159,03/14/2019
2009,Whitehall,535201,952,357443,379,242569,600012,03/14/2019
2009,Newark,542001,2874,1767327,918,1066216,2833543,03/14/2019
2009,Clyde-Savannah,542401,1197,855046,436,550937,1405983,03/14/2019
2009,Lyons,542801,1212,699003,418,422009,1121012,03/14/2019
2009,Gananda,543002,1484,1276409,122,206588,1482997,03/14/2019
2009,Marion,543201,1378,923001,313,398500,1321501,03/14/2019
2009,Wayne,543401,3784,2362512,746,902587,3265099,03/14/2019
2009,Palmyra-Macedon,543601,2669,1940943,723,979773,2920716,03/14/2019
2009,Sodus,544201,1552,886508,549,558867,1445375,03/14/2019
2009,Williamson,544602,1555,1077247,440,615816,1693063,03/14/2019
2009,North Rose-Wolcott,544801,1907,870897,667,547516,1418413,03/14/2019
2009,Red Creek,544803,1234,508195,394,299768,807963,03/14/2019
2009,Mount Vernon,550800,5569,14271275,1430,5917387,20188662,03/14/2019
2009,New Rochelle,551000,9511,18272553,1500,5316864,23589417,03/14/2019
2009,Peekskill,551200,3549,7256310,534,1863520,9119830,03/14/2019
2009,Rye,551400,2956,3270115,289,679317,3949432,03/14/2019
2009,White Plains,551700,7790,15132835,1088,3614726,18747561,03/14/2019
2009,Yonkers,551800,18527,27686491,4191,10014619,37701110,03/14/2019
2009,Katonah-Lewisboro,552001,5171,7242139,437,1187233,8429372,03/14/2019
2009,Bedford,552002,5280,5680843,657,1323619,7004462,03/14/2019
2009,Croton-Harmon,552202,2394,4521773,276,936104,5457877,03/14/2019
2009,Hendrick Hudson,552203,3544,5620777,485,1280416,6901193,03/14/2019
2009,Eastchester,552401,3163,6747582,635,2309699,9057281,03/14/2019
2009,Tuckahoe,552402,1283,2318542,208,653662,2972204,03/14/2019
2009,Bronxville,552403,1147,2329232,49,319905,2649137,03/14/2019
2009,Tarrytowns,552601,2536,5043729,438,1572941,6616670,03/14/2019
2009,Irvington,552602,1833,3643738,205,835672,4479410,03/14/2019
2009,Dobbs Ferry,552603,1518,3464039,196,882057,4346096,03/14/2019
2009,Hastings On Hudson,552604,1733,4153094,267,1155803,5308897,03/14/2019
2009,Ardsley,552605,2568,4530176,306,1018297,5548473,03/14/2019
2009,Edgemont,552606,1727,3652599,116,477334,4129933,03/14/2019
2009,Greenburgh,552607,4317,5934533,851,2123657,8058190,03/14/2019
2009,Elmsford,552609,1339,1945132,314,854035,2799167,03/14/2019
2009,Harrison,552801,3788,3317733,629,1076635,4394368,03/14/2019
2009,Mamaroneck,553201,5251,7039404,579,1507731,8547135,03/14/2019
2009,Mount Pleasant,553401,2756,3705839,673,1733227,5439066,03/14/2019
2009,Pocantico Hills,553402,473,389392,92,140274,529666,03/14/2019
2009,Valhalla,553405,1858,2910693,403,1214959,4125652,03/14/2019
2009,Pleasantville,553409,2002,3577996,313,1001917,4579913,03/14/2019
2009,Chappaqua,553604,4504,6308554,220,609564,6918118,03/14/2019
2009,Byram Hills,553801,3089,3304503,216,504317,3808820,03/14/2019
2009,North Salem,554001,1923,2177141,221,474704,2651845,03/14/2019
2009,Ossining,554201,5937,10726605,789,2689369,13415974,03/14/2019
2009,Briarcliff Manor,554202,1747,3277779,104,396568,3674347,03/14/2019
2009,Pelham,554401,2536,3937390,307,910980,4848370,03/14/2019
2009,Rye Neck,554801,1619,2227108,272,673581,2900689,03/14/2019
2009,Port Chester-Rye,554804,2963,4255915,863,2173854,6429769,03/14/2019
2009,Blind Brook-Rye,554805,1712,2252689,159,395142,2647831,03/14/2019
2009,Scarsdale,555001,4720,5338703,179,410404,5749107,03/14/2019
2009,Somers,555201,5342,6809978,1118,2791044,9601022,03/14/2019
2009,Lakeland,555401,8734,16392745,1675,5092220,21484965,03/14/2019
2009,Yorktown,555402,5275,8968656,633,1982396,10951052,03/14/2019
2009,Attica,562201,2376,1181105,649,636582,1817687,03/14/2019
2009,Letchworth,562601,1426,617866,375,296564,914430,03/14/2019
2009,Wyoming,563802,447,241074,99,100717,341791,03/14/2019
2009,Perry,564201,1255,624211,433,412695,1036906,03/14/2019
2009,Warsaw,564801,1387,910666,366,463302,1373968,03/14/2019
2009,Penn Yan,573001,2948,978128,1108,681637,1659765,03/14/2019
2009,Dundee,573401,1228,478380,418,272892,751272,03/14/2019
2009,New York City School,650000,616034,141318791,103456,44600531,185919322,03/14/2019
2008,Albany,010100,10489,6226608,3293,3457186,9683794,03/15/2016
2008,Cohoes,010300,2190,1543515,719,883733,2427248,03/15/2016
2008,Watervliet,011800,1341,620906,479,401181,1022087,03/15/2016
2008,Berne-Knox-Westerlo,012001,1744,1081050,368,406221,1487271,03/15/2016
2008,Bethlehem,012206,7138,4824189,1127,1427908,6252097,03/15/2016
2008,Ravena-Coeymans-Selkirk,012402,2984,1973854,771,916281,2890135,03/15/2016
2008,South Colonie,012601,9260,4457830,2684,2365806,6823636,03/15/2016
2008,North Colonie,012605,8144,3493715,1727,1372988,4866703,03/15/2016
2008,Menands,012615,406,184867,107,91592,276459,03/15/2016
2008,Green Island,012801,285,193955,133,169440,363395,03/15/2016
2008,Guilderland,013002,7639,4194370,1465,1511053,5705423,03/15/2016
2008,Voorheesville,013403,2059,1196037,372,407626,1603663,03/15/2016
2008,Alfred-Almond,022001,891,586963,264,300643,887606,03/15/2016
2008,Andover,023001,511,388592,162,194589,583181,03/15/2016
2008,Genesee Valley,023202,769,358240,354,257697,615937,03/15/2016
2008,Belfast,023401,466,222879,173,128877,351756,03/15/2016
2008,Canaseraga,024002,405,234724,146,132034,366758,03/15/2016
2008,Cuba-Rushford,024801,1411,677418,528,422692,1100110,03/15/2016
2008,Friendship,025001,393,290104,158,173321,463425,03/15/2016
2008,Fillmore,025801,829,343584,268,181738,525322,03/15/2016
2008,Whitesville,026001,238,149129,94,82565,231694,03/15/2016
2008,Scio,026601,490,350485,191,211411,561896,03/15/2016
2008,Wellsville,027001,1724,1194853,775,817853,2012706,03/15/2016
2008,Bolivar-Richburg,027602,1032,515477,354,260823,776300,03/15/2016
2008,Binghamton,030200,6246,4143160,2446,2654933,6798093,03/15/2016
2008,Chenango Forks,032001,2242,1524787,628,767534,2292321,03/15/2016
2008,South Mountain-Hickory,032201,147,34038,20,8769,42807,03/15/2016
2008,Harpursville,032601,1212,572868,327,256399,829267,03/15/2016
2008,Susquehanna Valley,032801,2565,2104420,794,1178448,3282868,03/15/2016
2008,Chenango Valley,033001,2831,2282312,1117,1675599,3957911,03/15/2016
2008,Maine-Endwell,033801,3666,2997229,1241,1775049,4772278,03/15/2016
2008,Deposit,034201,738,344415,322,267973,612388,03/15/2016
2008,Whitney Point,034401,1867,1043461,506,497021,1540482,03/15/2016
2008,Union-Endicott,034601,5881,4327228,2275,3048461,7375689,03/15/2016
2008,Johnson City,034602,3314,2218621,1435,1664520,3883141,03/15/2016
2008,Vestal,034801,6021,4442743,1775,2420975,6863718,03/15/2016
2008,Windsor,035001,2258,1416777,708,774852,2191629,03/15/2016
2008,Olean,041200,2882,1776918,1015,949890,2726808,03/15/2016
2008,Salamanca,041600,1098,536749,511,350179,886928,03/15/2016
2008,Allegany-Limestone,042001,1651,922337,598,499929,1422266,03/15/2016
2008,West Valley,042204,528,365802,168,204613,570415,03/15/2016
2008,Ellicottville,043601,736,196338,242,114592,310930,03/15/2016
2008,Franklinville,044001,1023,581302,323,290471,871773,03/15/2016
2008,Hinsdale,044601,648,324854,229,182464,507318,03/15/2016
2008,Cattaraugus - Little Valley,046402,1555,808608,488,388246,1196854,03/15/2016
2008,Gowanda,047201,1572,790241,582,503278,1293519,03/15/2016
2008,Portville,047401,1139,700295,400,407128,1107423,03/15/2016
2008,Randolph,047601,1250,528454,429,294615,823069,03/15/2016
2008,Yorkshire-Pioneer,048401,3512,1496736,971,742010,2238746,03/15/2016
2008,Auburn,050100,5550,3154150,2139,2148250,5302400,03/15/2016
2008,Weedsport,052201,1243,820078,323,380797,1200875,03/15/2016
2008,Cato-Meridian,052401,1488,797104,353,319209,1116313,03/15/2016
2008,Southern Cayuga,053001,1354,689925,385,348064,1037989,03/15/2016
2008,Port Byron,053801,1408,961728,490,611481,1573209,03/15/2016
2008,Moravia,054201,1458,715367,365,316580,1031947,03/15/2016
2008,Union Springs,055401,1306,792045,428,460307,1252352,03/15/2016
2008,Dunkirk,060300,2409,1526118,1175,1153901,2680019,03/15/2016
2008,Jamestown,060800,5009,2709550,1817,1551990,4261540,03/15/2016
2008,Southwestern,062201,2318,1433816,787,850365,2284181,03/15/2016
2008,Frewsburg,062401,1103,752972,377,450860,1203832,03/15/2016
2008,Cassadaga Valley,062601,1547,767347,499,408621,1175968,03/15/2016
2008,Chautauqua Lake,062803,1247,353710,444,217854,571564,03/15/2016
2008,Pine Valley,063001,897,555975,303,310225,866200,03/15/2016
2008,Clymer,063201,655,297950,217,177868,475818,03/15/2016
2008,Bemus Point,063601,1218,559461,420,337342,896803,03/15/2016
2008,Falconer,063801,1599,914687,588,584624,1499311,03/15/2016
2008,Silver Creek,064601,1311,671315,457,405844,1077159,03/15/2016
2008,Forestville,064603,952,509273,304,284595,793868,03/15/2016
2008,Panama,064801,834,531997,266,282759,814756,03/15/2016
2008,Fredonia,065801,2264,1339143,725,831073,2170216,03/15/2016
2008,Brocton,066001,841,588648,292,336495,925143,03/15/2016
2008,Ripley,066201,473,394447,172,226999,621446,03/15/2016
2008,Sherman,066601,584,337007,144,143087,480094,03/15/2016
2008,Westfield,067201,1050,638622,406,433205,1071827,03/15/2016
2008,Elmira,070400,8016,4870524,2947,3011307,7881831,03/15/2016
2008,Horseheads,073401,5874,3215890,1953,1955440,5171330,03/15/2016
2008,Elmira Heights,073402,1341,853375,530,591050,1444425,03/15/2016
2008,Norwich,081100,2410,1410154,809,795367,2205521,03/15/2016
2008,Afton,082001,897,566572,317,344949,911521,03/15/2016
2008,Bainbridge-Guilford,082201,1214,794138,455,512961,1307099,03/15/2016
2008,Greene,083001,1499,804463,512,484312,1288775,03/15/2016
2008,Unadilla Valley,083803,1163,553766,402,330287,884053,03/15/2016
2008,Georgetown-So Otselic Valley,084401,570,309224,161,146642,455866,03/15/2016
2008,Oxford Academy,084601,1141,681765,408,414423,1096188,03/15/2016
2008,Sherburne-Earlville,085601,1763,951443,603,561084,1512527,03/15/2016
2008,Plattsburgh,091300,2171,1366950,727,823420,2190370,03/15/2016
2008,Ausable Valley,092201,2044,1114963,681,578385,1693348,03/15/2016
2008,Beekmantown,092401,2877,1531828,792,699279,2231107,03/15/2016
2008,Northeastern Clinton,092801,2108,1278683,584,583909,1862592,03/15/2016
2008,Chazy,093001,730,406772,204,203106,609878,03/15/2016
2008,Northern Adirondack,093601,1473,485603,433,232885,718488,03/15/2016
2008,Peru,094001,2837,1558541,613,573740,2132281,03/15/2016
2008,Saranac,094401,2484,1328888,653,609388,1938276,03/15/2016
2008,Hudson,100600,2197,1185434,889,810371,1995805,03/15/2016
2008,Taconic Hills,102801,2238,854736,759,530498,1385234,03/15/2016
2008,Germantown,103602,939,459226,349,312543,771769,03/15/2016
2008,Chatham,103801,2009,1010369,493,444949,1455318,03/15/2016
2008,Kinderhook,104401,3124,1672117,729,713808,2385925,03/15/2016
2008,New Lebanon,104801,927,432768,240,201268,634036,03/15/2016
2008,Cortland,110200,3236,1720489,1071,1050079,2770568,03/15/2016
2008,Cincinnatus,112001,745,385905,269,230611,616516,03/15/2016
2008,Mc Graw,112204,779,453126,234,234174,687300,03/15/2016
2008,Homer,113001,2877,1794305,755,852939,2647244,03/15/2016
2008,Marathon,113401,965,555947,295,292746,848693,03/15/2016
2008,Andes,122002,254,92995,157,101679,194674,03/15/2016
2008,Downsville,122401,395,140508,231,141737,282245,03/15/2016
2008,Charlotte Valley,122601,623,254328,243,174962,429290,03/15/2016
2008,Delhi,122801,1344,613301,527,442098,1055399,03/15/2016
2008,Franklin,123201,467,200251,162,125663,325914,03/15/2016
2008,Hancock,123606,481,264022,229,214097,478119,03/15/2016
2008,Margaretville,124601,716,214605,325,179123,393728,03/15/2016
2008,Roxbury,124802,575,302109,256,243569,545678,03/15/2016
2008,Sidney,125001,1454,763677,647,605763,1369440,03/15/2016
2008,Stamford,125201,561,308035,223,222230,530265,03/15/2016
2008,South Kortright,125202,516,222968,253,199475,422443,03/15/2016
2008,Walton,125601,1264,494083,553,389129,883212,03/15/2016
2008,Beacon,130200,3776,2430782,847,1008864,3439646,03/15/2016
2008,Poughkeepsie,131300,3107,1896043,867,983330,2879373,03/15/2016
2008,Dover,132602,1653,1397074,308,505834,1902908,03/15/2016
2008,Hyde Park,133201,5807,4505825,1456,2037341,6543166,03/15/2016
2008,Northeast,133801,1023,680518,299,360791,1041309,03/15/2016
2008,Pawling,134001,2007,1485212,304,423364,1908576,03/15/2016
2008,Pine Plains,134201,1953,920938,511,441436,1362374,03/15/2016
2008,Arlington,134601,11974,8982017,1826,2537405,11519422,03/15/2016
2008,Spackenkill,134602,1933,1458438,409,548322,2006760,03/15/2016
2008,Red Hook,134801,2464,1994447,621,940372,2934819,03/15/2016
2008,Rhinebeck,135001,1889,1202685,534,638550,1841235,03/15/2016
2008,Wappingers,135601,15994,8911228,3135,3139555,12050783,03/15/2016
2008,Millbrook,135801,1556,809644,327,330646,1140290,03/15/2016
2008,Buffalo,140200,30939,11612470,8935,4538537,16151007,03/15/2016
2008,Lackawanna,140900,2478,783572,1367,647021,1430593,03/15/2016
2008,Tonawanda,141600,3350,1759280,1335,1281813,3041093,03/15/2016
2008,Alden,142001,2762,1500025,851,842283,2342308,03/15/2016
2008,Amherst,142201,5845,3300400,1382,1439335,4739735,03/15/2016
2008,Williamsville,142203,17259,9396500,3638,3577846,12974346,03/15/2016
2008,Sweet Home,142207,5425,2144951,2090,1552894,3697845,03/15/2016
2008,East Aurora,142401,3005,1377755,830,698914,2076669,03/15/2016
2008,Cheektowaga,143001,3775,1833328,1848,1531556,3364884,03/15/2016
2008,Cheektowaga-Maryvale,143002,3752,1802923,2051,1815642,3618565,03/15/2016
2008,Cleveland Hill,143003,2616,1936617,942,1284935,3221552,03/15/2016
2008,Depew,143007,3345,2003253,1267,1402859,3406112,03/15/2016
2008,Cheektowaga-Sloan,143009,2396,1917827,1383,2051787,3969614,03/15/2016
2008,Clarence,143201,6638,2899989,1401,1038451,3938440,03/15/2016
2008,Springville-Griffith,143801,3068,1679747,900,884642,2564389,03/15/2016
2008,Eden,144001,2512,1319053,671,662237,1981290,03/15/2016
2008,Iroquois,144201,4336,2002733,1257,1088085,3090818,03/15/2016
2008,Evans-Brant,144401,4172,2321682,1066,976181,3297863,03/15/2016
2008,Grand Island,144601,5088,2982171,1061,1151367,4133538,03/15/2016
2008,Hamburg,144801,5793,3033394,1452,1426616,4460010,03/15/2016
2008,Frontier,144804,8234,3731222,2261,1801043,5532265,03/15/2016
2008,Holland,145001,1752,862358,386,356350,1218708,03/15/2016
2008,Lancaster,145201,9703,4443749,2695,2211668,6655417,03/15/2016
2008,Akron,145601,2011,949920,612,472358,1422278,03/15/2016
2008,North Collins,145801,1010,661998,282,336435,998433,03/15/2016
2008,Orchard Park,146001,7925,3744131,1710,1514130,5258261,03/15/2016
2008,Kenmore,146401,15189,9089613,5912,6632831,15722444,03/15/2016
2008,West Seneca,146801,11817,6087917,4701,4389344,10477261,03/15/2016
2008,Crown Point,152203,436,169398,151,101683,271081,03/15/2016
2008,Elizabethtown-Lewis,152401,562,261092,185,153850,414942,03/15/2016
2008,Keene,153001,288,94831,80,48885,143716,03/15/2016
2008,Minerva,153401,226,95171,104,71803,166974,03/15/2016
2008,Moriah,153601,1009,577630,465,419730,997360,03/15/2016
2008,Newcomb,153801,118,8568,69,8846,17414,03/15/2016
2008,Lake Placid,154002,1113,343133,340,183242,526375,03/15/2016
2008,Schroon Lake,154601,478,130889,228,108239,239128,03/15/2016
2008,Ticonderoga,154801,1190,362472,464,238177,600649,03/15/2016
2008,Westport,155001,300,145605,147,126371,271976,03/15/2016
2008,Willsboro,155201,558,254925,288,223046,477971,03/15/2016
2008,Tupper Lake,162001,1316,528038,473,295668,823706,03/15/2016
2008,Chateaugay,163401,769,352966,238,183244,536210,03/15/2016
2008,Salmon River,164201,813,313384,320,208775,522159,03/15/2016
2008,Saranac Lake,164601,2306,842962,597,357208,1200170,03/15/2016
2008,Malone,164801,3161,1598185,1071,887500,2485685,03/15/2016
2008,Brushton-Moira,165001,1018,521103,329,281494,802597,03/15/2016
2008,St. Regis Falls,165401,494,258282,169,144791,403073,03/15/2016
2008,Gloversville,170500,3280,2158901,1333,1312174,3471075,03/15/2016
2008,Johnstown,170800,2319,1140533,759,649107,1789640,03/15/2016
2008,Broadalbin-Perth,172201,2378,1114754,774,634726,1749480,03/15/2016
2008,Wheelerville,172401,394,158309,134,96344,254653,03/15/2016
2008,Mayfield,173001,1459,800726,486,454654,1255380,03/15/2016
2008,Northville,173201,658,267682,280,208206,475888,03/15/2016
2008,Oppenheim-Ephratah,173401,673,372489,193,179321,551810,03/15/2016
2008,Batavia,180200,3269,2224515,1079,1310871,3535386,03/15/2016
2008,Alexander,182202,1217,834105,343,433322,1267427,03/15/2016
2008,Byron-Bergen,183001,1609,1134758,440,516962,1651720,03/15/2016
2008,Elba,183401,618,468762,189,263060,731822,03/15/2016
2008,Le Roy,183601,1774,1281857,524,665341,1947198,03/15/2016
2008,Oakfield-Alabama,183801,1112,750371,401,480259,1230630,03/15/2016
2008,Pavilion,184001,1160,763723,290,327934,1091657,03/15/2016
2008,Pembroke,184202,1496,909172,480,517340,1426512,03/15/2016
2008,Cairo-Durham,192401,1889,867396,735,600051,1467447,03/15/2016
2008,Catskill,192601,2232,1277321,740,757908,2035229,03/15/2016
2008,Coxsackie-Athens,192801,2035,1066778,612,579582,1646360,03/15/2016
2008,Greenville,193201,2001,1185230,643,690575,1875805,03/15/2016
2008,Hunter-Tannersville,193601,701,254165,288,188943,443108,03/15/2016
2008,Windham-Ashland-Jewett,194601,612,172126,267,138490,310616,03/15/2016
2008,Piseco,202001,95,7866,36,5510,13376,03/15/2016
2008,Indian Lake,202601,331,77875,159,70286,148161,03/15/2016
2008,Inlet,202801,83,10805,48,11831,22636,03/15/2016
2008,Lake Pleasant,203001,189,47009,104,48376,95385,03/15/2016
2008,Long Lake,203201,167,26941,91,26256,53197,03/15/2016
2008,Raquette Lake,203202,24,620,15,749,1369,03/15/2016
2008,Wells,203601,230,61636,113,56724,118360,03/15/2016
2008,Little Falls,210900,1321,1042072,591,765955,1808027,03/15/2016
2008,West Canada Valley,212402,1083,588380,321,317287,905667,03/15/2016
2008,Frankfort-Schuyler,212602,1412,881581,608,683292,1564873,03/15/2016
2008,Ilion,212801,1688,814130,560,480542,1294672,03/15/2016
2008,Mohawk,212802,1085,589545,435,424156,1013701,03/15/2016
2008,Herkimer,213001,1525,987762,776,825972,1813734,03/15/2016
2008,Dolgeville,213602,1109,504251,399,303976,808227,03/15/2016
2008,Poland,213803,973,409141,306,228729,637870,03/15/2016
2008,Van Hornesville-Owen D. Young,215001,323,185291,120,124849,310140,03/15/2016
2008,Town Of Webb,215401,572,93371,278,83388,176759,03/15/2016
2008,Mount Markham,215601,1559,882499,478,465001,1347500,03/15/2016
2008,Watertown,221800,4104,1447355,1248,765514,2212869,03/15/2016
2008,South Jefferson,222001,2361,973262,568,388832,1362094,03/15/2016
2008,Alexandria,222202,901,350439,301,199444,549883,03/15/2016
2008,Indian River,222401,1882,370244,425,134397,504641,03/15/2016
2008,General Brown,222601,1969,691184,535,329616,1020800,03/15/2016
2008,Thousand Islands,223201,1597,689991,546,406129,1096120,03/15/2016
2008,Belleville-Henderson,223402,745,229856,288,148120,377976,03/15/2016
2008,Sackets Harbor,223801,648,325474,176,155967,481441,03/15/2016
2008,Lyme,224401,585,224866,238,165034,389900,03/15/2016
2008,La Fargeville,224601,659,235357,176,107130,342487,03/15/2016
2008,Carthage,226001,2702,1325140,748,616249,1941389,03/15/2016
2008,Copenhagen,232201,631,238336,147,94447,332783,03/15/2016
2008,Harrisville,232401,556,340082,221,203707,543789,03/15/2016
2008,Lowville,233601,1691,569138,507,293675,862813,03/15/2016
2008,South Lewis,234001,1570,721277,558,397785,1119062,03/15/2016
2008,Beaver River,234401,1263,448372,397,248293,696665,03/15/2016
2008,Avon,242001,1327,947564,325,406023,1353587,03/15/2016
2008,Caledonia-Mumford,242201,1344,772692,385,405364,1178056,03/15/2016
2008,Geneseo,242601,1422,729233,338,321015,1050248,03/15/2016
2008,Livonia,243401,2703,1704212,590,669993,2374205,03/15/2016
2008,Mount Morris,243601,635,474887,239,301178,776065,03/15/2016
2008,Dansville,243801,2192,1111616,735,632951,1744567,03/15/2016
2008,Dalton-Nunda,244001,1204,752405,357,368298,1120703,03/15/2016
2008,York,245201,1185,694553,322,330190,1024743,03/15/2016
2008,Oneida,251200,2956,1701607,946,980298,2681905,03/15/2016
2008,Brookfield,252009,320,166693,93,81285,247978,03/15/2016
2008,Cazenovia,252201,2373,1278857,509,503020,1781877,03/15/2016
2008,De Ruyter,252401,582,372663,175,191315,563978,03/15/2016
2008,Morrisville-Eaton,252601,1060,549029,263,228550,777579,03/15/2016
2008,Hamilton,253201,998,537902,250,240181,778083,03/15/2016
2008,Canastota,253601,2081,1270043,670,726314,1996357,03/15/2016
2008,Madison,254001,621,402904,196,211371,614275,03/15/2016
2008,Stockbridge Valley,254601,595,358075,178,184258,542333,03/15/2016
2008,Chittenango,254801,3280,2232863,872,1012863,3245726,03/15/2016
2008,Rochester,261400,26428,10993946,4885,3205849,14199795,03/15/2016
2008,Brighton,262001,5530,3911210,902,1171431,5082641,03/15/2016
2008,Gates-Chili,262601,8006,5677678,2863,3682042,9359720,03/15/2016
2008,Greece,262801,19262,12920500,5258,6546020,19466520,03/15/2016
2008,East Irondequoit,263401,6764,5541641,2342,3473252,9014893,03/15/2016
2008,West Irondequoit,263403,6466,5027759,1912,2795378,7823137,03/15/2016
2008,Honeoye Falls-Lima,263601,3382,2237828,576,704111,2941939,03/15/2016
2008,Spencerport,263801,5535,4077098,1343,1836978,5914076,03/15/2016
2008,Hilton,264001,6713,4638232,1393,1768358,6406590,03/15/2016
2008,Penfield,264201,8105,6039393,1578,2151875,8191268,03/15/2016
2008,Fairport,264401,10071,6399272,2211,2568057,8967329,03/15/2016
2008,East Rochester,264413,1819,1386995,620,795143,2182138,03/15/2016
2008,Pittsford,264601,8788,6116313,1088,1412849,7529162,03/15/2016
2008,Churchville-Chili,264801,6002,4201309,1359,1736894,5938203,03/15/2016
2008,Rush-Henrietta,265001,9014,5158858,2187,2314475,7473333,03/15/2016
2008,Brockport,265201,5038,3688336,920,1195332,4883668,03/15/2016
2008,Webster,265401,13292,8322353,3203,3720759,12043112,03/15/2016
2008,Wheatland-Chili,265601,1401,1054227,367,479454,1533681,03/15/2016
2008,Amsterdam,270100,4285,2666273,1908,2075312,4741585,03/15/2016
2008,Canajoharie,272201,1350,854015,459,513136,1367151,03/15/2016
2008,Fonda-Fultonville,272801,1995,1110884,585,569651,1680535,03/15/2016
2008,Fort Plain,273001,999,919552,398,629987,1549539,03/15/2016
2008,St. Johnsville,273802,620,337725,271,243381,581106,03/15/2016
2008,Glen Cove,280500,3654,2805617,1152,1670604,4476221,03/15/2016
2008,Long Beach,281000,7464,4987393,1096,1505176,6492569,03/15/2016
2008,Hempstead,282001,3148,3926548,455,1129252,5055800,03/15/2016
2008,Uniondale,282002,5249,4505849,806,1485899,5991748,03/15/2016
2008,East Meadow,282003,11076,10903280,2888,5074317,15977597,03/15/2016
2008,North Bellmore,282004,5952,6087996,1200,2488326,8576322,03/15/2016
2008,Levittown,282005,11084,13894992,2363,6199015,20094007,03/15/2016
2008,Seaford,282006,3958,3479115,807,1429510,4908625,03/15/2016
2008,Bellmore,282007,3151,3077579,488,952851,4030430,03/15/2016
2008,Roosevelt,282008,2327,2576930,334,787863,3364793,03/15/2016
2008,Freeport,282009,6183,6687510,934,2110311,8797821,03/15/2016
2008,Baldwin,282010,7391,8423670,1046,2354522,10778192,03/15/2016
2008,Oceanside,282011,8686,7360281,1674,2863514,10223795,03/15/2016
2008,Malverne,282012,3108,3409596,579,1373763,4783359,03/15/2016
2008,Valley Stream 13,282013,6069,5878029,1428,2713332,8591361,03/15/2016
2008,Hewlett-Woodmere,282014,4859,5853419,618,1416151,7269570,03/15/2016
2008,Lawrence,282015,6324,3541169,887,1105987,4647156,03/15/2016
2008,Elmont,282016,8116,7200576,1563,2923974,10124550,03/15/2016
2008,Franklin Square,282017,5082,4056003,1401,2295915,6351918,03/15/2016
2008,Garden City,282018,5694,3555884,687,846191,4402075,03/15/2016
2008,East Rockaway,282019,2089,2272353,512,1095341,3367694,03/15/2016
2008,Lynbrook,282020,3891,3714711,755,1507677,5222388,03/15/2016
2008,Rockville Centre,282021,4976,4342827,696,1233682,5576509,03/15/2016
2008,Floral Park-Bellerose,282022,4300,3143690,815,1228304,4371994,03/15/2016
2008,Wantagh,282023,4438,4551216,685,1480485,6031701,03/15/2016
2008,Valley Stream 24,282024,2532,2356124,551,997995,3354119,03/15/2016
2008,Merrick,282025,4782,4526404,554,1049149,5575553,03/15/2016
2008,Island Trees,282026,3381,3266052,737,1497523,4763575,03/15/2016
2008,West Hempstead,282027,3632,3345332,672,1302252,4647584,03/15/2016
2008,North Merrick,282029,3358,3598391,643,1409339,5007730,03/15/2016
2008,Valley Stream 30,282030,2972,2493999,549,972931,3466930,03/15/2016
2008,Island Park,282031,1551,1091001,312,428125,1519126,03/15/2016
2008,Westbury,282201,3249,4052132,637,1528735,5580867,03/15/2016
2008,East Williston,282202,2156,1866736,195,356031,2222767,03/15/2016
2008,Roslyn,282203,4297,3988406,329,623738,4612144,03/15/2016
2008,Port Washington,282204,6211,4316834,728,1004180,5321014,03/15/2016
2008,New Hyde Park-Garden City,282205,4755,3428155,1169,1736153,5164308,03/15/2016
2008,Manhasset,282206,3968,2224119,314,381677,2605796,03/15/2016
2008,Great Neck,282207,9817,5145357,1037,1054796,6200153,03/15/2016
2008,Herricks,282209,6225,5207162,977,1731419,6938581,03/15/2016
2008,Mineola,282210,4624,3390213,1115,1719448,5109661,03/15/2016
2008,Carle Place,282211,1917,1537721,450,764588,2302309,03/15/2016
2008,North Shore,282401,3809,2659384,546,741035,3400419,03/15/2016
2008,Syosset,282402,8254,7969040,1124,1727700,9696740,03/15/2016
2008,Locust Valley,282403,3425,2146495,417,553516,2700011,03/15/2016
2008,Plainview-Old Bethpage,282404,7385,7328040,1249,2554665,9882705,03/15/2016
2008,Oyster Bay-East Norwich,282406,2712,1541235,374,452135,1993370,03/15/2016
2008,Jericho,282415,3391,2779784,293,480698,3260482,03/15/2016
2008,Hicksville,282417,7762,5303413,2084,2911179,8214592,03/15/2016
2008,Plainedge,282418,4556,5109235,1125,2672076,7781311,03/15/2016
2008,Bethpage,282421,4090,3122619,1434,1649885,4772504,03/15/2016
2008,Farmingdale,282422,8640,9250460,2031,4319727,13570187,03/15/2016
2008,Massapequa,282423,11719,10069783,2387,4436628,14506411,03/15/2016
2008,Lockport,290900,6485,4756483,1786,2099230,6855713,03/15/2016
2008,Niagara Falls,291100,8178,4259864,3473,2924914,7184778,03/15/2016
2008,North Tonawanda,291200,6655,4208329,2343,2727561,6935890,03/15/2016
2008,Lewiston-Porter,292401,4310,2683522,1419,1653760,4337282,03/15/2016
2008,Newfane,292801,2435,2053799,735,1127900,3181699,03/15/2016
2008,Niagara-Wheatfield,293001,5396,2919212,1740,1643425,4562637,03/15/2016
2008,Starpoint,293201,4194,2641535,954,1114479,3756014,03/15/2016
2008,Royalton-Hartland,293601,2104,1320464,603,694100,2014564,03/15/2016
2008,Barker,293801,1174,656606,345,343370,999976,03/15/2016
2008,Wilson,294201,1934,1355160,541,699174,2054334,03/15/2016
2008,Rome,301300,6502,4417183,2410,2749527,7166710,03/15/2016
2008,Utica,301600,8088,5484739,3408,3662320,9147059,03/15/2016
2008,Adirondack,302601,1987,950903,650,509943,1460846,03/15/2016
2008,Camden,303001,2947,1468728,919,739214,2207942,03/15/2016
2008,Clinton,304001,2040,1742738,608,840161,2582899,03/15/2016
2008,New Hartford,304801,3977,2614227,1194,1370355,3984582,03/15/2016
2008,New York Mills,304804,866,549946,450,529612,1079558,03/15/2016
2008,Sauquoit Valley,305002,1478,890812,418,451868,1342680,03/15/2016
2008,Remsen,305201,770,502304,221,252959,755263,03/15/2016
2008,Waterville,305401,1172,668016,353,355716,1023732,03/15/2016
2008,Holland Patent,305801,2283,1445164,621,689895,2135059,03/15/2016
2008,Sherrill,306000,2722,1679832,941,1043126,2722958,03/15/2016
2008,Westmoreland,306801,1556,1312643,504,718225,2030868,03/15/2016
2008,Oriskany,307001,978,727334,312,418774,1146108,03/15/2016
2008,Whitesboro,307002,5205,3228960,1789,2030686,5259646,03/15/2016
2008,Syracuse,311500,16741,7637278,4647,3616300,11253578,03/15/2016
2008,West Genesee,312001,7570,4721928,2678,3066683,7788611,03/15/2016
2008,North Syracuse,312403,14668,8958548,3410,3577887,12536435,03/15/2016
2008,East Syracuse-Minoa,312601,5131,3666334,1816,2185768,5852102,03/15/2016
2008,Jamesville-Dewitt,312611,4325,2660868,811,909175,3570043,03/15/2016
2008,Jordan-Elbridge,312801,1849,1548051,519,705219,2253270,03/15/2016
2008,Fabius-Pompey,313001,1188,938370,282,398180,1336550,03/15/2016
2008,Westhill,313201,2847,2169543,829,1174518,3344061,03/15/2016
2008,Solvay,313202,1958,1500089,865,1194452,2694541,03/15/2016
2008,La Fayette,313407,1107,595099,249,234000,829099,03/15/2016
2008,Baldwinsville,313601,8299,5893602,1781,2252282,8145884,03/15/2016
2008,Fayetteville-Manlius,313801,6559,4667597,1095,1429861,6097458,03/15/2016
2008,Marcellus,314001,2704,1795734,681,831627,2627361,03/15/2016
2008,Onondaga,314201,1573,1319999,418,596127,1916126,03/15/2016
2008,Liverpool,314801,11118,8110488,2926,3790261,11900749,03/15/2016
2008,Lyncourt,314804,852,702240,420,563151,1265391,03/15/2016
2008,Skaneateles,315001,2288,1137991,570,522808,1660799,03/15/2016
2008,Tully,315402,1424,911779,285,327610,1239389,03/15/2016
2008,Canandaigua,320200,4758,2555473,1078,1039435,3594908,03/15/2016
2008,Geneva,320500,2736,1718946,1064,1158301,2877247,03/15/2016
2008,East Bloomfield,322601,1445,1095008,329,434073,1529081,03/15/2016
2008,Gorham-Middlesex,323201,2268,1086674,628,532337,1619011,03/15/2016
2008,Manchester-Shortsville,323601,1223,984214,382,564615,1548829,03/15/2016
2008,Naples,323801,1406,681487,364,318987,1000474,03/15/2016
2008,Phelps-Clifton Springs,324001,2392,1727089,602,796111,2523200,03/15/2016
2008,Honeoye,324201,1600,879235,425,417128,1296363,03/15/2016
2008,Victor,324801,5043,2848562,865,868938,3717500,03/15/2016
2008,Middletown,330900,5870,4444577,1197,1642146,6086723,03/15/2016
2008,Newburgh,331100,10377,8310520,2374,3420619,11731139,03/15/2016
2008,Port Jervis,331300,2888,2823704,878,1513521,4337225,03/15/2016
2008,Washingtonville,332002,5679,4209982,694,1016648,5226630,03/15/2016
2008,Chester,332201,1427,1035424,239,322461,1357885,03/15/2016
2008,Cornwall,332401,3713,2592864,562,723552,3316416,03/15/2016
2008,Pine Bush,332601,6322,4084589,956,1136047,5220636,03/15/2016
2008,Goshen,333001,3254,2034092,574,681190,2715282,03/15/2016
2008,Highland Falls,333601,859,504208,228,244292,748500,03/15/2016
2008,Minisink Valley,333801,4920,3332797,642,811700,4144497,03/15/2016
2008,Monroe-Woodbury,334001,9078,6944123,1028,1548564,8492687,03/15/2016
2008,Kiryas Joel Village,334002,985,355053,29,19724,374777,03/15/2016
2008,Valley,334201,5395,3751184,1036,1326072,5077256,03/15/2016
2008,Tuxedo,335003,578,207580,84,61941,269521,03/15/2016
2008,Warwick Valley,335401,5512,3402937,806,932553,4335490,03/15/2016
2008,Greenwood Lake,335411,1674,1204187,256,347490,1551677,03/15/2016
2008,Florida,335415,1158,839638,252,345154,1184792,03/15/2016
2008,Albion,342001,2423,1393152,837,822914,2216066,03/15/2016
2008,Kendall,343007,1281,858430,318,391213,1249643,03/15/2016
2008,Holley,343204,1544,1276316,465,665495,1941811,03/15/2016
2008,Medina,343401,2141,1602107,772,977111,2579218,03/15/2016
2008,Lyndonville,343801,991,583929,319,332120,916049,03/15/2016
2008,Fulton,350400,3845,3033932,1175,1479001,4512933,03/15/2016
2008,Oswego,351200,5386,3848026,1609,1935436,5783462,03/15/2016
2008,Altmar Parish-Williamstown,352002,1727,1230246,428,494201,1724447,03/15/2016
2008,Hannibal,353001,1796,1251565,449,534591,1786156,03/15/2016
2008,Central Square,353201,5977,3286573,1325,1228548,4515121,03/15/2016
2008,Mexico,353401,3035,1871916,649,698107,2570023,03/15/2016
2008,Pulaski,355001,1248,765339,328,343273,1108612,03/15/2016
2008,Sandy Creek,355201,1266,698828,439,395984,1094812,03/15/2016
2008,Phoenix,355401,2896,2294700,697,954357,3249057,03/15/2016
2008,Oneonta,361200,2697,1747086,798,931812,2678898,03/15/2016
2008,Gilbertsville-Mt Upton,362202,701,296089,263,189146,485235,03/15/2016
2008,Cherry Valley-Springfield,362401,909,382457,365,269913,652370,03/15/2016
2008,Edmeston,362801,623,263121,214,163974,427095,03/15/2016
2008,Laurens,363401,566,308272,197,197637,505909,03/15/2016
2008,Schenevus,363601,574,356356,227,239683,596039,03/15/2016
2008,Milford,364001,631,353926,270,272714,626640,03/15/2016
2008,Morris,364201,577,333965,230,235966,569931,03/15/2016
2008,Otego-Unadilla,364801,1450,880219,537,554136,1434355,03/15/2016
2008,Cooperstown,365001,1360,567424,432,324472,891896,03/15/2016
2008,Richfield Springs,365601,862,291493,379,228760,520253,03/15/2016
2008,Worcester,366606,507,274941,240,233557,508498,03/15/2016
2008,Mahopac,372001,6401,6295317,841,1554392,7849709,03/15/2016
2008,Carmel,372002,7087,7553283,894,1786172,9339455,03/15/2016
2008,Haldane,372601,1141,987101,243,362536,1349637,03/15/2016
2008,Garrison,372604,580,282854,78,72041,354895,03/15/2016
2008,Putnam Valley,372803,2851,3393717,316,691333,4085050,03/15/2016
2008,Brewster,373001,5114,4805453,784,1421847,6227300,03/15/2016
2008,Rensselaer,381400,1354,777645,382,356298,1133943,03/15/2016
2008,Troy,381700,4422,2995209,1231,1395742,4390951,03/15/2016
2008,Lansingburgh,381701,2800,1677886,837,865422,2543308,03/15/2016
2008,Berlin,382001,1629,875352,406,383715,1259067,03/15/2016
2008,Brunswick,382202,1881,1134303,499,523172,1657475,03/15/2016
2008,East Greenbush,382401,7131,4458408,1502,1715992,6174400,03/15/2016
2008,Hoosick Falls,382801,1716,1034462,574,578056,1612518,03/15/2016
2008,North Greenbush,383201,374,80957,118,47923,128880,03/15/2016
2008,Wynantskill,383204,903,575251,274,323703,898954,03/15/2016
2008,Averill Park,384001,4790,2824769,926,992345,3817114,03/15/2016
2008,Hoosic Valley,384201,1593,943417,398,419197,1362614,03/15/2016
2008,Schodack,384401,1567,1079699,308,394419,1474118,03/15/2016
2008,Clarkstown,392001,12043,9912198,1740,2716475,12628673,03/15/2016
2008,Nanuet,392008,2465,2097042,566,904035,3001077,03/15/2016
2008,Haverstraw-Stony Point,392201,8681,11667939,1857,4398961,16066900,03/15/2016
2008,South Orangetown,392401,4552,4422373,973,1786534,6208907,03/15/2016
2008,Nyack,392404,4271,4820477,804,1812087,6632564,03/15/2016
2008,Pearl River,392408,3276,3447562,722,1436355,4883917,03/15/2016
2008,Ramapo,392601,6070,9507726,1123,3207077,12714803,03/15/2016
2008,East Ramapo,392602,12488,13105415,1685,3081562,16186977,03/15/2016
2008,Ogdensburg,401200,2207,1522886,680,660681,2183567,03/15/2016
2008,Brasher Falls,402001,1358,839349,453,448941,1288290,03/15/2016
2008,Canton,402201,1846,1080204,483,486163,1566367,03/15/2016
2008,Clifton-Fine,402601,503,192113,257,139485,331598,03/15/2016
2008,Colton-Pierrepont,402801,654,296349,228,164634,460983,03/15/2016
2008,Edwards-Knox,403401,738,261992,227,124439,386431,03/15/2016
2008,Gouverneur,404001,2053,868153,570,383908,1252061,03/15/2016
2008,Hammond,404201,417,194323,158,118952,313275,03/15/2016
2008,Hermon-Dekalb,404401,588,342398,173,160047,502445,03/15/2016
2008,Lisbon,405002,851,478630,237,224456,703086,03/15/2016
2008,Madrid-Waddington,405601,1026,630910,342,345745,976655,03/15/2016
2008,Massena,405801,3545,2026247,1327,1280901,3307148,03/15/2016
2008,Morristown,406001,656,307443,231,186437,493880,03/15/2016
2008,Norwood-Norfolk,406201,1469,1149632,499,626983,1776615,03/15/2016
2008,Heuvelton,406404,877,548931,266,285422,834353,03/15/2016
2008,Parishville-Hopkinton,406601,683,289525,178,115856,405381,03/15/2016
2008,Potsdam,407402,1963,1469366,509,639973,2109339,03/15/2016
2008,Mechanicville,411000,1619,845167,557,539270,1384437,03/15/2016
2008,Saratoga Springs,411500,9874,4638752,1683,1474197,6112949,03/15/2016
2008,Burnt Hills-Ballston Lake,412001,5074,3327958,1144,1409010,4736968,03/15/2016
2008,Shenendehowa,412402,14325,8187550,1941,2086637,10274187,03/15/2016
2008,Corinth,412601,1608,741365,499,393295,1134660,03/15/2016
2008,Edinburg,413001,368,67738,142,47201,114939,03/15/2016
2008,Galway,413201,1694,799500,406,334014,1133514,03/15/2016
2008,Ballston Spa,414201,5654,4033540,1063,1273642,5307182,03/15/2016
2008,South Glens Falls,414401,3926,2601904,1065,1240151,3842055,03/15/2016
2008,Schuylerville,415001,2382,1922930,473,667124,2590054,03/15/2016
2008,Stillwater,415201,1762,785937,370,299276,1085213,03/15/2016
2008,Waterford-Halfmoon,415401,1011,678787,410,482111,1160898,03/15/2016
2008,Schenectady,421500,8525,7082764,2621,3598496,10681260,03/15/2016
2008,Duanesburg,422001,1351,754694,239,249852,1004546,03/15/2016
2008,Scotia-Glenville,422202,4367,2963240,1116,1403561,4366801,03/15/2016
2008,Niskayuna,422401,6405,3809661,886,996502,4806163,03/15/2016
2008,Schalmont,422801,3453,2291339,913,1118325,3409664,03/15/2016
2008,Rotterdam-Mohonasen,422803,4880,2720097,1900,1956416,4676513,03/15/2016
2008,Cobleskill-Richmondville,432602,2522,1565516,868,917234,2482750,03/15/2016
2008,Gilboa-Conesville,433401,564,256566,255,191630,448196,03/15/2016
2008,Jefferson,433601,443,213939,158,135251,349190,03/15/2016
2008,Middleburgh,433801,1319,866512,478,527713,1394225,03/15/2016
2008,Schoharie,434201,1556,936934,438,468323,1405257,03/15/2016
2008,Sharon Springs,434601,431,314063,161,204602,518665,03/15/2016
2008,Odessa-Montour,442001,1260,791434,400,434284,1225718,03/15/2016
2008,Watkins Glen,442401,1856,804136,691,515327,1319463,03/15/2016
2008,South Seneca,452801,1386,738092,497,440720,1178812,03/15/2016
2008,Romulus,453003,761,483975,213,242979,726954,03/15/2016
2008,Seneca Falls,453201,1984,1597751,732,1026905,2624656,03/15/2016
2008,Waterloo,453801,2256,1528966,848,1010361,2539327,03/15/2016
2008,Corning,460300,7295,5202525,2095,2466926,7669451,03/15/2016
2008,Hornell,460600,1818,1018121,653,567682,1585803,03/15/2016
2008,Addison,462001,1489,953672,428,410770,1364442,03/15/2016
2008,Avoca,462201,823,358645,259,177887,536532,03/15/2016
2008,Bath,462402,1870,1039367,646,659941,1699308,03/15/2016
2008,Bradford,462601,455,290233,164,176764,466997,03/15/2016
2008,Campbell-Savona,463002,1242,827678,372,422325,1250003,03/15/2016
2008,Canisteo-Greenwood,463202,1323,822536,511,496022,1318558,03/15/2016
2008,Arkport,465201,673,446767,284,293234,740001,03/15/2016
2008,Jasper-Troupsburg,465601,631,275503,210,152650,428153,03/15/2016
2008,Prattsburgh,466001,665,314749,205,167405,482154,03/15/2016
2008,Hammondsport,467201,1070,419154,396,259659,678813,03/15/2016
2008,Wayland-Cohocton,467401,2113,1048411,667,549451,1597862,03/15/2016
2008,Babylon,472001,2692,3103527,375,796075,3899602,03/15/2016
2008,West Babylon,472002,5336,5361330,1037,1923831,7285161,03/15/2016
2008,North Babylon,472003,6370,6341829,1464,2713820,9055649,03/15/2016
2008,Lindenhurst,472004,8218,8960734,1740,3536671,12497405,03/15/2016
2008,Copiague,472005,5041,5144240,1083,1999200,7143440,03/15/2016
2008,Amityville,472006,4051,4080674,802,1403356,5484030,03/15/2016
2008,Deer Park,472007,5089,5404995,1397,2761062,8166057,03/15/2016
2008,Wyandanch,472009,1161,1187174,184,345720,1532894,03/15/2016
2008,Three Village,472201,9502,9341981,1447,2667820,12009801,03/15/2016
2008,Brookhaven-Comsewogue,472203,4516,4300324,821,1419370,5719694,03/15/2016
2008,South Country,472204,5120,4696464,721,1226133,5922597,03/15/2016
2008,Sachem,472205,17557,14620657,2499,3846727,18467384,03/15/2016
2008,Port Jefferson,472206,1613,913328,211,225677,1139005,03/15/2016
2008,Mount Sinai,472207,3138,3252971,469,913173,4166144,03/15/2016
2008,Miller Place,472208,3758,3791098,385,720352,4511450,03/15/2016
2008,Rocky Point,472209,3980,4404790,494,1012114,5416904,03/15/2016
2008,Middle Country,472211,12096,12007675,2247,4130286,16137961,03/15/2016
2008,Longwood,472212,12517,12785183,3117,5477729,18262912,03/15/2016
2008,Patchogue-Medford,472224,9454,9429082,1629,2929565,12358647,03/15/2016
2008,William Floyd,472232,9557,9993249,1266,2382382,12375631,03/15/2016
2008,Center Moriches,472233,1670,1814928,251,504044,2318972,03/15/2016
2008,East Moriches,472234,1324,1411795,170,338133,1749928,03/15/2016
2008,Eastport- South Manor,472235,4220,4161986,841,1423921,5585907,03/15/2016
2008,East Hampton,472401,1328,281459,353,154098,435557,03/15/2016
2008,Wainscott,472402,117,8809,24,4000,12809,03/15/2016
2008,Amagansett,472403,253,26261,90,20500,46761,03/15/2016
2008,Springs,472404,991,318029,276,194574,512603,03/15/2016
2008,Sag Harbor,472405,1311,372451,478,283267,655718,03/15/2016
2008,Montauk,472406,688,110043,238,105421,215464,03/15/2016
2008,Elwood,472601,3239,2853056,571,949618,3802674,03/15/2016
2008,Cold Spring Harbor,472602,2163,1701550,124,185147,1886697,03/15/2016
2008,Huntington,472603,7737,6778359,1190,1944421,8722780,03/15/2016
2008,Northport-East Northport,472604,9058,6407229,1470,1963950,8371179,03/15/2016
2008,Half Hollow Hills,472605,11285,8232450,1630,2125808,10358258,03/15/2016
2008,Harborfields,472606,4769,4247701,687,1155632,5403333,03/15/2016
2008,Commack,472610,9291,8716248,1762,3109516,11825764,03/15/2016
2008,South Huntington,472613,8835,7941572,1683,2853043,10794615,03/15/2016
2008,Bay Shore,472801,5785,5993722,1061,2043702,8037424,03/15/2016
2008,Islip,472802,3955,4101109,664,1219486,5320595,03/15/2016
2008,East Islip,472803,5595,5805740,1029,2208764,8014504,03/15/2016
2008,Sayville,472804,4102,4178253,801,1523549,5701802,03/15/2016
2008,Bayport-Blue Point,472805,3118,3559754,468,1019387,4579141,03/15/2016
2008,Hauppauge,472806,5147,2814787,960,972759,3787546,03/15/2016
2008,Connetquot,472807,8730,8287257,1575,2753545,11040802,03/15/2016
2008,West Islip,472809,6583,6198190,1250,2231227,8429417,03/15/2016
2008,Brentwood,472812,9762,6472078,1960,2461513,8933591,03/15/2016
2008,Central Islip,472813,5582,6311117,886,1879743,8190860,03/15/2016
2008,Fire Island,472814,102,10601,19,3740,14341,03/15/2016
2008,Shoreham-Wading River,473001,3209,2381934,737,951823,3333757,03/15/2016
2008,Riverhead,473002,6910,5075238,2594,2970028,8045266,03/15/2016
2008,Shelter Island,473201,598,122256,210,81818,204074,03/15/2016
2008,Smithtown,473401,13832,12461919,2390,3880143,16342062,03/15/2016
2008,Kings Park,473405,5480,4431529,892,1352751,5784280,03/15/2016
2008,Remsenburg-Speonk,473601,447,139118,88,56942,196060,03/15/2016
2008,Westhampton Beach,473602,1037,343424,241,158251,501675,03/15/2016
2008,Quogue,473603,253,30142,44,10543,40685,03/15/2016
2008,Hampton Bays,473605,2232,1433549,724,951498,2385047,03/15/2016
2008,Southhampton,473606,1758,285627,557,186189,471816,03/15/2016
2008,Bridgehampton,473609,300,29097,93,18533,47630,03/15/2016
2008,Sagaponack,473610,76,2236,10,605,2841,03/15/2016
2008,Tuckahoe Common,473613,545,216063,178,144407,360470,03/15/2016
2008,East Quogue,473617,1158,659716,295,319723,979439,03/15/2016
2008,Oysterponds,473802,404,118138,172,94217,212355,03/15/2016
2008,Fishers Island,473804,36,8898,5,2315,11213,03/15/2016
2008,Southold,473805,1595,806474,559,527674,1334148,03/15/2016
2008,Greenport,473810,650,346254,291,281797,628051,03/15/2016
2008,Mattituck-Cutchogue,473812,2266,1219311,634,638485,1857796,03/15/2016
2008,New Suffolk,473815,90,15970,30,9894,25864,03/15/2016
2008,Fallsburg,482801,1291,1082373,322,469543,1551916,03/15/2016
2008,Eldred,483401,1112,606449,388,390052,996501,03/15/2016
2008,Liberty,483601,1499,1155528,547,756273,1911801,03/15/2016
2008,Tri-Valley,484201,1324,871838,334,373329,1245167,03/15/2016
2008,Roscoe,484401,367,177132,184,159628,336760,03/15/2016
2008,Livingston Manor,484402,637,297760,247,199684,497444,03/15/2016
2008,Monticello,484601,3398,1892588,1008,1001670,2894258,03/15/2016
2008,Sullivan West,484802,2183,1063255,889,777578,1840833,03/15/2016
2008,Waverly,492001,1850,1098548,660,646597,1745145,03/15/2016
2008,Candor,492401,1067,611181,345,351171,962352,03/15/2016
2008,Newark Valley,492602,1746,1133078,529,613287,1746365,03/15/2016
2008,Owego-Apalachin,493001,3013,1973173,1008,1155503,3128676,03/15/2016
2008,Spencer-Van Etten,493401,1352,697662,413,367117,1064779,03/15/2016
2008,Tioga,493603,1212,394989,380,213057,608046,03/15/2016
2008,Ithaca,500700,8437,4159210,1558,1292512,5451722,03/15/2016
2008,Dryden,502401,2496,1596111,585,589929,2186040,03/15/2016
2008,Groton,502801,1345,748797,323,312448,1061245,03/15/2016
2008,Lansing,503201,1753,933557,322,311365,1244922,03/15/2016
2008,Newfield,503401,1058,536323,296,225233,761556,03/15/2016
2008,Trumansburg,503601,1767,1164608,386,423698,1588306,03/15/2016
2008,Kingston,510800,8813,5562199,2727,3153806,8716005,03/15/2016
2008,Highland,513203,2476,1522161,524,593024,2115185,03/15/2016
2008,Rondout Valley,513401,3867,2735522,956,1206715,3942237,03/15/2016
2008,Marlboro,513601,2456,1771525,505,669251,2440776,03/15/2016
2008,New Paltz,513801,3300,2122706,635,769553,2892259,03/15/2016
2008,Onteora,514001,3482,1561703,1175,946785,2508488,03/15/2016
2008,Saugerties,514801,4486,2571664,1266,1326762,3898426,03/15/2016
2008,Wallkill,515201,4055,2885446,870,936952,3822398,03/15/2016
2008,Ellenville,515602,1760,1311164,554,639402,1950566,03/15/2016
2008,Glens Falls,520500,2902,1780565,804,887812,2668377,03/15/2016
2008,Bolton,522001,405,80433,149,54061,134494,03/15/2016
2008,Lake George,522201,1545,348871,435,182590,531461,03/15/2016
2008,North Warren,522402,1060,330728,444,247282,578010,03/15/2016
2008,Johnsburg,523001,574,271012,226,192794,463806,03/15/2016
2008,Hadley-Luzerne,523201,1362,518924,528,360934,879858,03/15/2016
2008,Queensbury,523402,4634,2558392,1053,1032594,3590986,03/15/2016
2008,Glens Falls Common,523418,277,148877,87,81361,230238,03/15/2016
2008,Warrensburg,524001,1281,700523,443,428522,1129045,03/15/2016
2008,Argyle,532001,927,526204,263,265913,792117,03/15/2016
2008,Fort Ann,532802,832,672239,236,344335,1016574,03/15/2016
2008,Fort Edward,533001,566,446974,201,291073,738047,03/15/2016
2008,Granville,533201,1594,915641,478,469535,1385176,03/15/2016
2008,Greenwich,533401,1489,932015,474,540807,1472822,03/15/2016
2008,Hartford,533801,724,442463,183,200596,643059,03/15/2016
2008,Hudson Falls,534401,2698,1609286,984,1053579,2662865,03/15/2016
2008,Putnam,534601,163,38440,57,23957,62397,03/15/2016
2008,Salem,534801,897,486265,323,311703,797968,03/15/2016
2008,Cambridge,535010,1342,750368,526,519805,1270173,03/15/2016
2008,Whitehall,535201,926,386960,392,267496,654456,03/15/2016
2008,Newark,542001,2857,1976623,930,1157179,3133802,03/15/2016
2008,Clyde-Savannah,542401,1187,882644,425,533618,1416262,03/15/2016
2008,Lyons,542801,1209,744898,427,430526,1175424,03/15/2016
2008,Gananda,543002,1463,1226110,115,179272,1405382,03/15/2016
2008,Marion,543201,1386,962257,313,391676,1353933,03/15/2016
2008,Wayne,543401,3769,2406969,740,869401,3276370,03/15/2016
2008,Palmyra-Macedon,543601,2656,1965877,726,957519,2923396,03/15/2016
2008,Sodus,544201,1547,953373,551,560472,1513845,03/15/2016
2008,Williamson,544602,1552,1116737,434,589260,1705997,03/15/2016
2008,North Rose-Wolcott,544801,1928,929553,664,541809,1471362,03/15/2016
2008,Red Creek,544803,1209,528284,394,295497,823781,03/15/2016
2008,Mount Vernon,550800,5485,14441641,1447,6179637,20621278,03/15/2016
2008,New Rochelle,551000,9472,19386462,1481,5560533,24946995,03/15/2016
2008,Peekskill,551200,3520,7986951,556,2050383,10037334,03/15/2016
2008,Rye,551400,2944,3570174,298,778210,4348384,03/15/2016
2008,White Plains,551700,7610,16193862,1136,4059761,20253623,03/15/2016
2008,Yonkers,551800,18225,28602432,4275,10559008,39161440,03/15/2016
2008,Katonah-Lewisboro,552001,5151,7554428,439,1254684,8809112,03/15/2016
2008,Bedford,552002,5266,6185722,675,1475117,7660839,03/15/2016
2008,Croton-Harmon,552202,2385,5065627,281,1046378,6112005,03/15/2016
2008,Hendrick Hudson,552203,3542,6118766,487,1374110,7492876,03/15/2016
2008,Eastchester,552401,3134,6994502,632,2407810,9402312,03/15/2016
2008,Tuckahoe,552402,1244,2475726,220,733090,3208816,03/15/2016
2008,Bronxville,552403,1159,2396470,49,323730,2720200,03/15/2016
2008,Tarrytowns,552601,2542,5515665,437,1696760,7212425,03/15/2016
2008,Irvington,552602,1841,4058543,202,909280,4967823,03/15/2016
2008,Dobbs Ferry,552603,1544,3902330,196,954013,4856343,03/15/2016
2008,Hastings On Hudson,552604,1724,4562739,276,1298788,5861527,03/15/2016
2008,Ardsley,552605,2556,4910154,316,1143492,6053646,03/15/2016
2008,Edgemont,552606,1721,3987820,116,523685,4511505,03/15/2016
2008,Greenburgh,552607,4307,6965274,845,2218204,9183478,03/15/2016
2008,Elmsford,552609,1337,2115508,309,908565,3024073,03/15/2016
2008,Harrison,552801,3765,3791295,661,1352957,5144252,03/15/2016
2008,Mamaroneck,553201,5127,7277897,605,1657953,8935850,03/15/2016
2008,Mount Pleasant,553401,2742,4066229,669,1901952,5968181,03/15/2016
2008,Pocantico Hills,553402,471,418330,95,154683,573013,03/15/2016
2008,Valhalla,553405,1854,3133306,399,1295348,4428654,03/15/2016
2008,Pleasantville,553409,1999,3913771,318,1113525,5027296,03/15/2016
2008,Chappaqua,553604,4530,6862989,226,698086,7561075,03/15/2016
2008,Byram Hills,553801,3077,3595686,207,525340,4121026,03/15/2016
2008,North Salem,554001,1947,2351557,220,479545,2831102,03/15/2016
2008,Ossining,554201,5931,11954792,784,2894768,14849560,03/15/2016
2008,Briarcliff Manor,554202,1736,3647084,111,459319,4106403,03/15/2016
2008,Pelham,554401,2546,3944053,306,869114,4813167,03/15/2016
2008,Rye Neck,554801,1586,2348804,284,754060,3102864,03/15/2016
2008,Port Chester-Rye,554804,2874,4393427,875,2322136,6715563,03/15/2016
2008,Blind Brook-Rye,554805,1704,2366713,160,419723,2786436,03/15/2016
2008,Scarsdale,555001,4688,5846597,208,525185,6371782,03/15/2016
2008,Somers,555201,5313,7125391,1134,2818748,9944139,03/15/2016
2008,Lakeland,555401,8715,17809431,1687,5332846,23142277,03/15/2016
2008,Yorktown,555402,5254,9748652,630,2138649,11887301,03/15/2016
2008,Attica,562201,2358,1210494,651,623353,1833847,03/15/2016
2008,Letchworth,562601,1419,686154,387,312791,998945,03/15/2016
2008,Wyoming,563802,453,254781,95,95470,350251,03/15/2016
2008,Perry,564201,1259,688937,435,429313,1118250,03/15/2016
2008,Warsaw,564801,1397,910355,382,450919,1361274,03/15/2016
2008,Penn Yan,573001,2982,1126183,1128,753677,1879860,03/15/2016
2008,Dundee,573401,1218,508530,434,292183,800713,03/15/2016
2008,New York City School,650000,606485,114803497,101297,33948657,148752154,03/15/2016
2007,Albany,010100,10314,6407189,3373,3647525,10054714,03/15/2016
2007,Cohoes,010300,2125,1681916,745,993841,2675757,03/15/2016
2007,Watervliet,011800,1320,668115,485,426344,1094459,03/15/2016
2007,Berne-Knox-Westerlo,012001,1704,1157965,355,416595,1574560,03/15/2016
2007,Bethlehem,012206,7028,5082474,1208,1633091,6715565,03/15/2016
2007,Ravena-Coeymans-Selkirk,012402,2908,2084840,773,982578,3067418,03/15/2016
2007,South Colonie,012601,9034,4504351,2735,2482157,6986508,03/15/2016
2007,North Colonie,012605,7874,3616793,1729,1467338,5084131,03/15/2016
2007,Menands,012615,404,195142,106,94951,290093,03/15/2016
2007,Maplewood,012622,104,69143,59,69467,138610,03/15/2016
2007,Green Island,012801,277,208980,140,196110,405090,03/15/2016
2007,Guilderland,013002,7574,4570907,1459,1647782,6218689,03/15/2016
2007,Voorheesville,013403,2029,1300731,370,445192,1745923,03/15/2016
2007,Alfred-Almond,022001,879,607947,271,310567,918514,03/15/2016
2007,Andover,023001,483,417352,173,227468,644820,03/15/2016
2007,Genesee Valley,023202,758,346112,360,253847,599959,03/15/2016
2007,Belfast,023401,456,246190,166,132770,378960,03/15/2016
2007,Canaseraga,024002,411,242678,145,129195,371873,03/15/2016
2007,Cuba-Rushford,024801,1396,788754,524,474514,1263268,03/15/2016
2007,Friendship,025001,389,315643,155,178942,494585,03/15/2016
2007,Fillmore,025801,817,357895,268,189603,547498,03/15/2016
2007,Whitesville,026001,237,160113,99,88362,248475,03/15/2016
2007,Scio,026601,489,361875,195,217739,579614,03/15/2016
2007,Wellsville,027001,1716,1165416,795,819855,1985271,03/15/2016
2007,Bolivar-Richburg,027602,1008,478518,351,238987,717505,03/15/2016
2007,Binghamton,030200,6219,4457272,2466,2747499,7204771,03/15/2016
2007,Chenango Forks,032001,2218,1589394,623,781454,2370848,03/15/2016
2007,South Mountain-Hickory,032201,145,41591,21,11406,52997,03/15/2016
2007,Harpursville,032601,1179,595429,323,265696,861125,03/15/2016
2007,Susquehanna Valley,032801,2519,2205319,794,1237799,3443118,03/15/2016
2007,Chenango Valley,033001,2746,2190229,1147,1640140,3830369,03/15/2016
2007,Maine-Endwell,033801,3602,3277769,1305,2051088,5328857,03/15/2016
2007,Deposit,034201,729,366809,313,275374,642183,03/15/2016
2007,Whitney Point,034401,1809,1033736,499,495229,1528965,03/15/2016
2007,Union-Endicott,034601,5752,4717486,2368,3443266,8160752,03/15/2016
2007,Johnson City,034602,3233,2386262,1447,1769531,4155793,03/15/2016
2007,Vestal,034801,5941,4835311,1821,2644634,7479945,03/15/2016
2007,Windsor,035001,2220,1541792,690,821034,2362826,03/15/2016
2007,Olean,041200,2863,1795463,1066,986875,2782338,03/15/2016
2007,Salamanca,041600,1101,539689,515,334767,874456,03/15/2016
2007,Allegany-Limestone,042001,1673,1034241,587,515248,1549489,03/15/2016
2007,West Valley,042204,521,388142,166,215052,603194,03/15/2016
2007,Ellicottville,043601,727,204684,241,121559,326243,03/15/2016
2007,Franklinville,044001,995,588618,310,276830,865448,03/15/2016
2007,Hinsdale,044601,629,336084,234,191942,528026,03/15/2016
2007,Cattaraugus - Little Valley,046402,1535,826167,498,409095,1235262,03/15/2016
2007,Gowanda,047201,1557,864892,608,571276,1436168,03/15/2016
2007,Portville,047401,1137,728811,387,404481,1133292,03/15/2016
2007,Randolph,047601,1260,551218,420,294752,845970,03/15/2016
2007,Yorkshire-Pioneer,048401,3500,1628004,938,754708,2382712,03/15/2016
2007,Auburn,050100,5472,3316457,2176,2284967,5601424,03/15/2016
2007,Weedsport,052201,1224,858363,329,407832,1266195,03/15/2016
2007,Cato-Meridian,052401,1466,833963,354,339460,1173423,03/15/2016
2007,Southern Cayuga,053001,1330,725730,391,368071,1093801,03/15/2016
2007,Port Byron,053801,1427,991261,479,594359,1585620,03/15/2016
2007,Moravia,054201,1447,750305,372,333416,1083721,03/15/2016
2007,Union Springs,055401,1310,879912,416,486459,1366371,03/15/2016
2007,Dunkirk,060300,2383,1616865,1174,1252505,2869370,03/15/2016
2007,Jamestown,060800,4973,2698520,1823,1575202,4273722,03/15/2016
2007,Southwestern,062201,2283,1477096,775,881021,2358117,03/15/2016
2007,Frewsburg,062401,1085,743901,372,448818,1192719,03/15/2016
2007,Cassadaga Valley,062601,1536,792583,498,424996,1217579,03/15/2016
2007,Chautauqua Lake,062803,1236,354317,451,228705,583022,03/15/2016
2007,Pine Valley,063001,877,584669,305,322473,907142,03/15/2016
2007,Clymer,063201,666,313186,219,186982,500168,03/15/2016
2007,Bemus Point,063601,1208,615455,422,373953,989408,03/15/2016
2007,Falconer,063801,1591,981011,568,602415,1583426,03/15/2016
2007,Silver Creek,064601,1287,721284,466,459437,1180721,03/15/2016
2007,Forestville,064603,937,531796,289,287278,819074,03/15/2016
2007,Panama,064801,827,551658,256,282864,834522,03/15/2016
2007,Fredonia,065801,2229,1401125,739,895570,2296695,03/15/2016
2007,Brocton,066001,860,647064,283,350124,997188,03/15/2016
2007,Ripley,066201,458,390122,175,228295,618417,03/15/2016
2007,Sherman,066601,573,343782,152,154467,498249,03/15/2016
2007,Westfield,067201,1045,719244,397,477480,1196724,03/15/2016
2007,Elmira,070400,7875,5136826,3041,3256293,8393119,03/15/2016
2007,Horseheads,073401,5781,3331440,1965,2034366,5365806,03/15/2016
2007,Elmira Heights,073402,1319,854043,531,595456,1449499,03/15/2016
2007,Norwich,081100,2384,1529295,817,850377,2379672,03/15/2016
2007,Afton,082001,867,577399,327,363547,940946,03/15/2016
2007,Bainbridge-Guilford,082201,1216,870151,444,532621,1402772,03/15/2016
2007,Greene,083001,1484,880041,503,520133,1400174,03/15/2016
2007,Unadilla Valley,083803,1155,583921,388,332603,916524,03/15/2016
2007,Georgetown-So Otselic Valley,084401,558,325735,155,143035,468770,03/15/2016
2007,Oxford Academy,084601,1122,710931,413,429268,1140199,03/15/2016
2007,Sherburne-Earlville,085601,1742,1006681,586,573789,1580470,03/15/2016
2007,Plattsburgh,091300,2196,1564198,712,891202,2455400,03/15/2016
2007,Ausable Valley,092201,2012,1183070,675,609419,1792489,03/15/2016
2007,Beekmantown,092401,2829,1629482,774,721743,2351225,03/15/2016
2007,Northeastern Clinton,092801,2111,1413236,561,618337,2031573,03/15/2016
2007,Chazy,093001,740,487415,194,221824,709239,03/15/2016
2007,Northern Adirondack,093601,1474,537369,416,240345,777714,03/15/2016
2007,Peru,094001,2804,1714342,616,625308,2339650,03/15/2016
2007,Saranac,094401,2450,1457879,640,649447,2107326,03/15/2016
2007,Hudson,100600,2152,1273670,938,945260,2218930,03/15/2016
2007,Taconic Hills,102801,2171,884145,760,559601,1443746,03/15/2016
2007,Germantown,103602,933,491417,328,313875,805292,03/15/2016
2007,Chatham,103801,1991,1048035,511,474464,1522499,03/15/2016
2007,Kinderhook,104401,3080,1816872,729,770379,2587251,03/15/2016
2007,New Lebanon,104801,925,453302,247,217444,670746,03/15/2016
2007,Cortland,110200,3299,1887231,1051,1091253,2978484,03/15/2016
2007,Cincinnatus,112001,746,408919,269,233892,642811,03/15/2016
2007,Mc Graw,112204,765,459375,239,243733,703108,03/15/2016
2007,Homer,113001,2830,1854030,770,898146,2752176,03/15/2016
2007,Marathon,113401,944,593489,299,313865,907354,03/15/2016
2007,Andes,122002,241,90894,151,103574,194468,03/15/2016
2007,Downsville,122401,390,149907,233,149305,299212,03/15/2016
2007,Charlotte Valley,122601,626,271497,243,185041,456538,03/15/2016
2007,Delhi,122801,1313,654467,517,470188,1124655,03/15/2016
2007,Franklin,123201,460,213608,161,134113,347721,03/15/2016
2007,Hancock,123606,472,273501,238,231267,504768,03/15/2016
2007,Margaretville,124601,703,223917,325,190357,414274,03/15/2016
2007,Roxbury,124802,577,328642,257,261151,589793,03/15/2016
2007,Sidney,125001,1441,813324,664,649922,1463246,03/15/2016
2007,Stamford,125201,554,343058,225,248159,591217,03/15/2016
2007,South Kortright,125202,522,242352,242,204263,446615,03/15/2016
2007,Walton,125601,1241,528639,546,407965,936604,03/15/2016
2007,Beacon,130200,3733,2595592,819,1052976,3648568,03/15/2016
2007,Poughkeepsie,131300,2981,1893153,894,1042975,2936128,03/15/2016
2007,Dover,132602,1615,1441182,284,489421,1930603,03/15/2016
2007,Hyde Park,133201,5684,4877835,1398,2140650,7018485,03/15/2016
2007,Northeast,133801,1008,704956,301,373146,1078102,03/15/2016
2007,Pawling,134001,1942,1519212,327,479716,1998928,03/15/2016
2007,Pine Plains,134201,1900,906751,491,421992,1328743,03/15/2016
2007,Arlington,134601,11643,9307215,1831,2698617,12005832,03/15/2016
2007,Spackenkill,134602,1929,1631686,409,608927,2240613,03/15/2016
2007,Red Hook,134801,2343,1940868,649,998106,2938974,03/15/2016
2007,Rhinebeck,135001,1836,1272771,523,676201,1948972,03/15/2016
2007,Wappingers,135601,15646,9419996,3039,3290548,12710544,03/15/2016
2007,Millbrook,135801,1519,833516,315,332586,1166102,03/15/2016
2007,Buffalo,140200,30954,12954602,9247,5148359,18102961,03/15/2016
2007,Lackawanna,140900,2410,721156,1405,613282,1334438,03/15/2016
2007,Tonawanda,141600,3275,1909221,1357,1421739,3330960,03/15/2016
2007,Alden,142001,2769,1563403,828,845444,2408847,03/15/2016
2007,Amherst,142201,5785,3409398,1434,1544527,4953925,03/15/2016
2007,Williamsville,142203,17032,9970684,3652,3812869,13783553,03/15/2016
2007,Sweet Home,142207,5374,2299435,2139,1694915,3994350,03/15/2016
2007,East Aurora,142401,3001,1366490,817,691758,2058248,03/15/2016
2007,Cheektowaga,143001,3713,1921038,1919,1672673,3593711,03/15/2016
2007,Cheektowaga-Maryvale,143002,3687,1780026,2091,1850291,3630317,03/15/2016
2007,Cleveland Hill,143003,2562,1862159,976,1295650,3157809,03/15/2016
2007,Depew,143007,3369,2032049,1244,1380657,3412706,03/15/2016
2007,Cheektowaga-Sloan,143009,2328,1942633,1415,2180090,4122723,03/15/2016
2007,Clarence,143201,6521,3089196,1423,1129403,4218599,03/15/2016
2007,Springville-Griffith,143801,3038,1735105,891,900750,2635855,03/15/2016
2007,Eden,144001,2454,1271619,684,664631,1936250,03/15/2016
2007,Iroquois,144201,4290,2000252,1259,1097915,3098167,03/15/2016
2007,Evans-Brant,144401,4149,2473126,1088,1060104,3533230,03/15/2016
2007,Grand Island,144601,5021,3075451,1057,1184265,4259716,03/15/2016
2007,Hamburg,144801,5709,2888973,1448,1372591,4261564,03/15/2016
2007,Frontier,144804,8065,3703281,2244,1797286,5500567,03/15/2016
2007,Holland,145001,1710,878280,385,372496,1250776,03/15/2016
2007,Lancaster,145201,9544,4519011,2715,2272536,6791547,03/15/2016
2007,Akron,145601,1995,1000221,603,497528,1497749,03/15/2016
2007,North Collins,145801,986,581333,300,318497,899830,03/15/2016
2007,Orchard Park,146001,7797,3790245,1724,1567318,5357563,03/15/2016
2007,Kenmore,146401,14945,9132908,6073,6902287,16035195,03/15/2016
2007,West Seneca,146801,11787,6111757,4738,4424181,10535938,03/15/2016
2007,Crown Point,152203,434,179435,147,103209,282644,03/15/2016
2007,Elizabethtown-Lewis,152401,559,268916,178,152169,421085,03/15/2016
2007,Keene,153001,279,90615,80,48341,138956,03/15/2016
2007,Minerva,153401,222,111184,97,77871,189055,03/15/2016
2007,Moriah,153601,983,599138,465,435868,1035006,03/15/2016
2007,Newcomb,153801,125,9534,68,9039,18573,03/15/2016
2007,Lake Placid,154002,1102,358541,339,189472,548013,03/15/2016
2007,Schroon Lake,154601,479,136235,225,109366,245601,03/15/2016
2007,Ticonderoga,154801,1162,366608,469,243138,609746,03/15/2016
2007,Westport,155001,298,157847,138,129204,287051,03/15/2016
2007,Willsboro,155201,550,282193,289,252606,534799,03/15/2016
2007,Tupper Lake,162001,1307,554598,487,319733,874331,03/15/2016
2007,Chateaugay,163401,761,443672,234,220254,663926,03/15/2016
2007,Salmon River,164201,822,353787,310,218937,572724,03/15/2016
2007,Saranac Lake,164601,2282,831579,604,363219,1194798,03/15/2016
2007,Malone,164801,3124,1749324,1059,932441,2681765,03/15/2016
2007,Brushton-Moira,165001,993,529526,332,288050,817576,03/15/2016
2007,St. Regis Falls,165401,479,249611,159,130239,379850,03/15/2016
2007,Gloversville,170500,3243,2196806,1311,1225616,3422422,03/15/2016
2007,Johnstown,170800,2288,1224814,739,658210,1883024,03/15/2016
2007,Broadalbin-Perth,172201,2363,1107452,709,567607,1675059,03/15/2016
2007,Wheelerville,172401,372,173336,139,112818,286154,03/15/2016
2007,Mayfield,173001,1450,857374,482,468620,1325994,03/15/2016
2007,Northville,173201,651,278458,275,211376,489834,03/15/2016
2007,Oppenheim-Ephratah,173401,655,398374,186,179392,577766,03/15/2016
2007,Batavia,180200,3225,2309989,1091,1384966,3694955,03/15/2016
2007,Alexander,182202,1201,892293,341,462556,1354849,03/15/2016
2007,Byron-Bergen,183001,1596,1142895,450,503617,1646512,03/15/2016
2007,Elba,183401,625,516639,179,270138,786777,03/15/2016
2007,Le Roy,183601,1752,1336867,528,710512,2047379,03/15/2016
2007,Oakfield-Alabama,183801,1109,777768,391,480737,1258505,03/15/2016
2007,Pavilion,184001,1167,827347,277,334999,1162346,03/15/2016
2007,Pembroke,184202,1486,1024212,463,558908,1583120,03/15/2016
2007,Cairo-Durham,192401,1870,960614,723,648602,1609216,03/15/2016
2007,Catskill,192601,2200,1369087,750,817039,2186126,03/15/2016
2007,Coxsackie-Athens,192801,2000,1146295,598,607895,1754190,03/15/2016
2007,Greenville,193201,1965,1266824,636,729789,1996613,03/15/2016
2007,Hunter-Tannersville,193601,695,264176,279,188797,452973,03/15/2016
2007,Windham-Ashland-Jewett,194601,599,185582,270,151540,337122,03/15/2016
2007,Piseco,202001,94,8179,33,5306,13485,03/15/2016
2007,Indian Lake,202601,338,92895,152,77209,170104,03/15/2016
2007,Inlet,202801,93,13106,44,11741,24847,03/15/2016
2007,Lake Pleasant,203001,188,52119,105,54175,106294,03/15/2016
2007,Long Lake,203201,162,34022,94,34612,68634,03/15/2016
2007,Raquette Lake,203202,28,907,13,820,1727,03/15/2016
2007,Wells,203601,227,66834,111,60683,127517,03/15/2016
2007,Little Falls,210900,1281,1017194,602,772093,1789287,03/15/2016
2007,West Canada Valley,212402,1086,649390,303,317217,966607,03/15/2016
2007,Frankfort-Schuyler,212602,1394,945298,618,740616,1685914,03/15/2016
2007,Ilion,212801,1668,864215,568,506354,1370569,03/15/2016
2007,Mohawk,212802,1089,640307,432,443099,1083406,03/15/2016
2007,Herkimer,213001,1491,1041479,797,876175,1917654,03/15/2016
2007,Dolgeville,213602,1080,534530,415,322363,856893,03/15/2016
2007,Poland,213803,940,449794,306,256111,705905,03/15/2016
2007,Van Hornesville-Owen D. Young,215001,323,187412,119,122774,310186,03/15/2016
2007,Town Of Webb,215401,540,104244,272,96158,200402,03/15/2016
2007,Mount Markham,215601,1543,967022,471,500374,1467396,03/15/2016
2007,Watertown,221800,3909,1516957,1298,845282,2362239,03/15/2016
2007,South Jefferson,222001,2300,1020412,548,395235,1415647,03/15/2016
2007,Alexandria,222202,880,365281,291,198770,564051,03/15/2016
2007,Indian River,222401,1804,392099,423,138846,530945,03/15/2016
2007,General Brown,222601,1916,743744,517,342610,1086354,03/15/2016
2007,Thousand Islands,223201,1555,689863,557,430532,1120395,03/15/2016
2007,Belleville-Henderson,223402,749,249360,281,152351,401711,03/15/2016
2007,Sackets Harbor,223801,640,340927,178,162240,503167,03/15/2016
2007,Lyme,224401,584,234254,253,178615,412869,03/15/2016
2007,La Fargeville,224601,640,230178,159,97251,327429,03/15/2016
2007,Carthage,226001,2631,1403489,734,628276,2031765,03/15/2016
2007,Copenhagen,232201,619,257303,147,99952,357255,03/15/2016
2007,Harrisville,232401,559,359994,206,193965,553959,03/15/2016
2007,Lowville,233601,1663,638150,506,326503,964653,03/15/2016
2007,South Lewis,234001,1543,772229,563,432540,1204769,03/15/2016
2007,Beaver River,234401,1248,462253,383,244466,706719,03/15/2016
2007,Avon,242001,1286,924899,328,416297,1341196,03/15/2016
2007,Caledonia-Mumford,242201,1342,824223,378,424827,1249050,03/15/2016
2007,Geneseo,242601,1429,776324,336,337343,1113667,03/15/2016
2007,Livonia,243401,2659,1739400,595,693629,2433029,03/15/2016
2007,Mount Morris,243601,639,490541,237,306419,796960,03/15/2016
2007,Dansville,243801,2179,1155888,727,646496,1802384,03/15/2016
2007,Dalton-Nunda,244001,1210,808883,350,384357,1193240,03/15/2016
2007,York,245201,1177,680772,309,311263,992035,03/15/2016
2007,Oneida,251200,2915,1697690,945,973462,2671152,03/15/2016
2007,Brookfield,252009,311,153789,96,78160,231949,03/15/2016
2007,Cazenovia,252201,2381,1395659,501,531679,1927338,03/15/2016
2007,De Ruyter,252401,577,396801,175,201540,598341,03/15/2016
2007,Morrisville-Eaton,252601,1035,551528,253,226263,777791,03/15/2016
2007,Hamilton,253201,988,559334,257,255804,815138,03/15/2016
2007,Canastota,253601,2048,1339618,678,774280,2113898,03/15/2016
2007,Madison,254001,625,436461,197,221769,658230,03/15/2016
2007,Stockbridge Valley,254601,579,380409,177,198061,578470,03/15/2016
2007,Chittenango,254801,3271,2417733,868,1063419,3481152,03/15/2016
2007,Rochester,261400,25918,11375190,4874,3265035,14640225,03/15/2016
2007,Brighton,262001,5445,3997999,932,1254875,5252874,03/15/2016
2007,Gates-Chili,262601,7915,5634980,2871,3707438,9342418,03/15/2016
2007,Greece,262801,19152,13326085,5279,6796308,20122393,03/15/2016
2007,East Irondequoit,263401,6685,5589446,2391,3595871,9185317,03/15/2016
2007,West Irondequoit,263403,6428,5255518,1924,2930245,8185763,03/15/2016
2007,Honeoye Falls-Lima,263601,3344,2219652,561,687077,2906729,03/15/2016
2007,Spencerport,263801,5448,4078941,1333,1847347,5926288,03/15/2016
2007,Hilton,264001,6614,4582229,1336,1693979,6276208,03/15/2016
2007,Penfield,264201,8055,6313018,1561,2229333,8542351,03/15/2016
2007,Fairport,264401,9984,6844702,2210,2750521,9595223,03/15/2016
2007,East Rochester,264413,1798,1400011,639,833174,2233185,03/15/2016
2007,Pittsford,264601,8670,6040996,1091,1419636,7460632,03/15/2016
2007,Churchville-Chili,264801,5962,4330026,1318,1739764,6069790,03/15/2016
2007,Rush-Henrietta,265001,8768,5009376,2166,2284921,7294297,03/15/2016
2007,Brockport,265201,4974,3752430,902,1202027,4954457,03/15/2016
2007,Webster,265401,13083,8684798,3169,3884232,12569030,03/15/2016
2007,Wheatland-Chili,265601,1404,1064953,375,485999,1550952,03/15/2016
2007,Amsterdam,270100,4195,2859261,1924,2236820,5096081,03/15/2016
2007,Canajoharie,272201,1347,925383,455,537337,1462720,03/15/2016
2007,Fonda-Fultonville,272801,1978,1264087,572,621668,1885755,03/15/2016
2007,Fort Plain,273001,1009,1004643,375,619087,1623730,03/15/2016
2007,St. Johnsville,273802,607,366516,273,266175,632691,03/15/2016
2007,Glen Cove,280500,3580,3025547,1151,1818823,4844370,03/15/2016
2007,Long Beach,281000,7277,5074752,1120,1639685,6714437,03/15/2016
2007,Hempstead,282001,3019,4003906,469,1211336,5215242,03/15/2016
2007,Uniondale,282002,4923,4672841,782,1538943,6211784,03/15/2016
2007,East Meadow,282003,10897,11836245,2921,5571770,17408015,03/15/2016
2007,North Bellmore,282004,5876,6603233,1207,2744939,9348172,03/15/2016
2007,Levittown,282005,10960,15258147,2386,6910864,22169011,03/15/2016
2007,Seaford,282006,3914,3795523,828,1618076,5413599,03/15/2016
2007,Bellmore,282007,3113,3286422,491,1036129,4322551,03/15/2016
2007,Roosevelt,282008,2202,2647027,316,790255,3437282,03/15/2016
2007,Freeport,282009,5959,7362625,952,2418559,9781184,03/15/2016
2007,Baldwin,282010,7286,9501262,1041,2669970,12171232,03/15/2016
2007,Oceanside,282011,8596,8112884,1675,3199966,11312850,03/15/2016
2007,Malverne,282012,3029,3660687,606,1568541,5229228,03/15/2016
2007,Valley Stream 13,282013,5943,6474587,1457,3116380,9590967,03/15/2016
2007,Hewlett-Woodmere,282014,4784,6131130,646,1605823,7736953,03/15/2016
2007,Lawrence,282015,6192,3998171,907,1298014,5296185,03/15/2016
2007,Elmont,282016,7879,7599943,1579,3206204,10806147,03/15/2016
2007,Franklin Square,282017,4991,4355111,1434,2562798,6917909,03/15/2016
2007,Garden City,282018,5602,3566481,725,951159,4517640,03/15/2016
2007,East Rockaway,282019,2061,2397522,516,1181606,3579128,03/15/2016
2007,Lynbrook,282020,3852,4081115,759,1685106,5766221,03/15/2016
2007,Rockville Centre,282021,4886,4489957,696,1383627,5873584,03/15/2016
2007,Floral Park-Bellerose,282022,4223,3438045,827,1379479,4817524,03/15/2016
2007,Wantagh,282023,4346,4720939,722,1645179,6366118,03/15/2016
2007,Valley Stream 24,282024,2496,2521268,566,1113782,3635050,03/15/2016
2007,Merrick,282025,4750,4801454,535,1081598,5883052,03/15/2016
2007,Island Trees,282026,3315,3467771,755,1654423,5122194,03/15/2016
2007,West Hempstead,282027,3533,3662873,679,1472848,5135721,03/15/2016
2007,North Merrick,282029,3284,3665425,665,1517476,5182901,03/15/2016
2007,Valley Stream 30,282030,2913,2641360,560,1068779,3710139,03/15/2016
2007,Island Park,282031,1528,1153948,311,457183,1611131,03/15/2016
2007,Westbury,282201,3110,4293541,637,1692636,5986177,03/15/2016
2007,East Williston,282202,2090,1989581,205,408471,2398052,03/15/2016
2007,Roslyn,282203,4173,3950006,373,761671,4711677,03/15/2016
2007,Port Washington,282204,5987,4483663,755,1116601,5600264,03/15/2016
2007,New Hyde Park-Garden City,282205,4602,3753834,1228,2057307,5811141,03/15/2016
2007,Manhasset,282206,3848,2263141,335,423876,2687017,03/15/2016
2007,Great Neck,282207,9472,5281707,1093,1184487,6466194,03/15/2016
2007,Herricks,282209,6001,5147659,1047,1996847,7144506,03/15/2016
2007,Mineola,282210,4472,3672648,1167,2016127,5688775,03/15/2016
2007,Carle Place,282211,1869,1658010,465,868632,2526642,03/15/2016
2007,North Shore,282401,3715,2660086,575,846799,3506885,03/15/2016
2007,Syosset,282402,8133,8061243,1159,1918795,9980038,03/15/2016
2007,Locust Valley,282403,3329,2170025,446,645298,2815323,03/15/2016
2007,Plainview-Old Bethpage,282404,7256,7449617,1290,2873436,10323053,03/15/2016
2007,Oyster Bay-East Norwich,282406,2668,1648359,380,500317,2148676,03/15/2016
2007,Jericho,282415,3311,2852815,311,536175,3388990,03/15/2016
2007,Hicksville,282417,7688,5619744,2118,3156193,8775937,03/15/2016
2007,Plainedge,282418,4498,5603109,1139,2987517,8590626,03/15/2016
2007,Bethpage,282421,4032,3396767,1434,1833801,5230568,03/15/2016
2007,Farmingdale,282422,8515,10245913,2079,4975432,15221345,03/15/2016
2007,Massapequa,282423,11557,10819296,2407,4828867,15648163,03/15/2016
2007,Lockport,290900,6398,4900976,1804,2196269,7097245,03/15/2016
2007,Niagara Falls,291100,8061,4358161,3608,3032070,7390231,03/15/2016
2007,North Tonawanda,291200,6580,4363110,2364,2854465,7217575,03/15/2016
2007,Lewiston-Porter,292401,4239,2791821,1391,1713194,4505015,03/15/2016
2007,Newfane,292801,2408,2102685,733,1076403,3179088,03/15/2016
2007,Niagara-Wheatfield,293001,5214,3111249,1718,1781344,4892593,03/15/2016
2007,Starpoint,293201,4092,2621501,951,1133823,3755324,03/15/2016
2007,Royalton-Hartland,293601,2077,1399510,594,727754,2127264,03/15/2016
2007,Barker,293801,1172,665273,328,327452,992725,03/15/2016
2007,Wilson,294201,1910,1437496,559,768534,2206030,03/15/2016
2007,Rome,301300,6326,4783411,2482,3025265,7808676,03/15/2016
2007,Utica,301600,8004,5538023,3524,3776451,9314474,03/15/2016
2007,Adirondack,302601,1968,1006550,629,508614,1515164,03/15/2016
2007,Camden,303001,2951,1556922,886,729183,2286105,03/15/2016
2007,Clinton,304001,2041,1829801,626,852442,2682243,03/15/2016
2007,New Hartford,304801,3890,2629320,1226,1424189,4053509,03/15/2016
2007,New York Mills,304804,847,558209,470,565893,1124102,03/15/2016
2007,Sauquoit Valley,305002,1460,920443,407,463599,1384042,03/15/2016
2007,Remsen,305201,759,511750,221,257912,769662,03/15/2016
2007,Waterville,305401,1157,696105,362,375578,1071683,03/15/2016
2007,Holland Patent,305801,2264,1520922,628,729508,2250430,03/15/2016
2007,Sherrill,306000,2722,1764548,923,1068253,2832801,03/15/2016
2007,Westmoreland,306801,1524,1389126,520,770323,2159449,03/15/2016
2007,Oriskany,307001,956,756846,328,455937,1212783,03/15/2016
2007,Whitesboro,307002,5111,3336715,1821,2144152,5480867,03/15/2016
2007,Syracuse,311500,16371,7718010,4867,3792225,11510235,03/15/2016
2007,West Genesee,312001,7432,5144050,2673,3299332,8443382,03/15/2016
2007,North Syracuse,312403,14408,9589109,3425,3771894,13361003,03/15/2016
2007,East Syracuse-Minoa,312601,5088,3835912,1845,2313540,6149452,03/15/2016
2007,Jamesville-Dewitt,312611,4254,2656889,843,958962,3615851,03/15/2016
2007,Jordan-Elbridge,312801,1811,1625180,531,768781,2393961,03/15/2016
2007,Fabius-Pompey,313001,1166,989108,285,428623,1417731,03/15/2016
2007,Westhill,313201,2789,2205253,870,1274115,3479368,03/15/2016
2007,Solvay,313202,1924,1578735,891,1291343,2870078,03/15/2016
2007,La Fayette,313407,1101,647195,255,257970,905165,03/15/2016
2007,Baldwinsville,313601,8095,6016401,1785,2303914,8320315,03/15/2016
2007,Fayetteville-Manlius,313801,6485,4915123,1147,1585388,6500511,03/15/2016
2007,Marcellus,314001,2686,1826357,683,844034,2670391,03/15/2016
2007,Onondaga,314201,1535,1305979,428,629460,1935439,03/15/2016
2007,Liverpool,314801,11031,8810225,2900,3956317,12766542,03/15/2016
2007,Lyncourt,314804,827,750572,443,609810,1360382,03/15/2016
2007,Skaneateles,315001,2284,1221041,578,565157,1786198,03/15/2016
2007,Tully,315402,1396,960669,292,357861,1318530,03/15/2016
2007,Canandaigua,320200,4602,2702759,1072,1122796,3825555,03/15/2016
2007,Geneva,320500,2693,1816359,1101,1262039,3078398,03/15/2016
2007,East Bloomfield,322601,1431,1089808,313,410031,1499839,03/15/2016
2007,Gorham-Middlesex,323201,2231,1143188,628,566785,1709973,03/15/2016
2007,Manchester-Shortsville,323601,1203,1033362,380,590816,1624178,03/15/2016
2007,Naples,323801,1391,693973,350,308420,1002393,03/15/2016
2007,Phelps-Clifton Springs,324001,2381,1841667,596,837851,2679518,03/15/2016
2007,Honeoye,324201,1584,865957,402,392874,1258831,03/15/2016
2007,Victor,324801,4893,2856697,829,835017,3691714,03/15/2016
2007,Middletown,330900,5621,4716050,1213,1799235,6515285,03/15/2016
2007,Newburgh,331100,10049,9140703,2397,3827719,12968422,03/15/2016
2007,Port Jervis,331300,2845,2997949,855,1543394,4541343,03/15/2016
2007,Washingtonville,332002,5569,4439243,665,1027753,5466996,03/15/2016
2007,Chester,332201,1404,1103340,235,340480,1443820,03/15/2016
2007,Cornwall,332401,3707,2823785,564,784481,3608266,03/15/2016
2007,Pine Bush,332601,6179,4182705,942,1172875,5355580,03/15/2016
2007,Goshen,333001,3157,2097811,571,716785,2814596,03/15/2016
2007,Highland Falls,333601,938,581836,234,270323,852159,03/15/2016
2007,Minisink Valley,333801,4801,3575984,631,866521,4442505,03/15/2016
2007,Monroe-Woodbury,334001,8993,7241187,1013,1604557,8845744,03/15/2016
2007,Kiryas Joel Village,334002,944,343725,31,21060,364785,03/15/2016
2007,Valley,334201,5345,3956977,1034,1401340,5358317,03/15/2016
2007,Tuxedo,335003,573,211513,83,65734,277247,03/15/2016
2007,Warwick Valley,335401,5430,3743304,767,992588,4735892,03/15/2016
2007,Greenwood Lake,335411,1651,1319071,246,369360,1688431,03/15/2016
2007,Florida,335415,1126,901378,253,380693,1282071,03/15/2016
2007,Albion,342001,2390,1432909,829,810937,2243846,03/15/2016
2007,Kendall,343007,1252,872415,321,403487,1275902,03/15/2016
2007,Holley,343204,1534,1329277,453,675656,2004933,03/15/2016
2007,Medina,343401,2104,1555994,749,969350,2525344,03/15/2016
2007,Lyndonville,343801,965,587971,338,359899,947870,03/15/2016
2007,Fulton,350400,3760,3033827,1213,1521390,4555217,03/15/2016
2007,Oswego,351200,5320,3811624,1640,1893966,5705590,03/15/2016
2007,Altmar Parish-Williamstown,352002,1716,1052966,406,388184,1441150,03/15/2016
2007,Hannibal,353001,1799,1304161,418,519636,1823797,03/15/2016
2007,Central Square,353201,5902,3364164,1300,1206945,4571109,03/15/2016
2007,Mexico,353401,2988,1990252,654,742925,2733177,03/15/2016
2007,Pulaski,355001,1241,788354,327,349289,1137643,03/15/2016
2007,Sandy Creek,355201,1267,828362,412,433216,1261578,03/15/2016
2007,Phoenix,355401,2859,2353025,678,942399,3295424,03/15/2016
2007,Oneonta,361200,2684,1874000,802,998272,2872272,03/15/2016
2007,Gilbertsville-Mt Upton,362202,681,312107,259,199716,511823,03/15/2016
2007,Cherry Valley-Springfield,362401,887,427875,359,295366,723241,03/15/2016
2007,Edmeston,362801,617,283753,212,174425,458178,03/15/2016
2007,Laurens,363401,574,339485,184,192006,531491,03/15/2016
2007,Schenevus,363601,567,379753,223,250481,630234,03/15/2016
2007,Milford,364001,629,385865,258,282118,667983,03/15/2016
2007,Morris,364201,572,365085,224,253368,618453,03/15/2016
2007,Otego-Unadilla,364801,1428,924700,539,585892,1510592,03/15/2016
2007,Cooperstown,365001,1316,607337,468,385819,993156,03/15/2016
2007,Richfield Springs,365601,848,328571,381,262544,591115,03/15/2016
2007,Worcester,366606,501,289515,224,229047,518562,03/15/2016
2007,Mahopac,372001,6336,6661705,808,1592407,8254112,03/15/2016
2007,Carmel,372002,6950,8125897,884,1921431,10047328,03/15/2016
2007,Haldane,372601,1115,1048865,241,393527,1442392,03/15/2016
2007,Garrison,372604,575,300312,73,72252,372564,03/15/2016
2007,Putnam Valley,372803,2816,3659185,322,761066,4420251,03/15/2016
2007,Brewster,373001,5081,5170842,767,1502340,6673182,03/15/2016
2007,Rensselaer,381400,1317,870627,391,399364,1269991,03/15/2016
2007,Troy,381700,4330,3145283,1272,1476287,4621570,03/15/2016
2007,Lansingburgh,381701,2747,1829432,837,917251,2746683,03/15/2016
2007,Berlin,382001,1601,930819,406,398375,1329194,03/15/2016
2007,Brunswick,382202,1862,1220545,477,536564,1757109,03/15/2016
2007,East Greenbush,382401,7011,5013833,1466,1881283,6895116,03/15/2016
2007,Hoosick Falls,382801,1696,1108547,591,612543,1721090,03/15/2016
2007,North Greenbush,383201,360,92704,126,60164,152868,03/15/2016
2007,Wynantskill,383204,854,600204,282,361369,961573,03/15/2016
2007,Averill Park,384001,4705,3047757,929,1072887,4120644,03/15/2016
2007,Hoosic Valley,384201,1577,1042047,385,443467,1485514,03/15/2016
2007,Schodack,384401,1542,1135671,309,411256,1546927,03/15/2016
2007,Clarkstown,392001,11929,10192746,1754,2842067,13034813,03/15/2016
2007,Nanuet,392008,2437,2210871,569,963221,3174092,03/15/2016
2007,Haverstraw-Stony Point,392201,8618,13011779,1801,4762147,17773926,03/15/2016
2007,South Orangetown,392401,4474,4573728,956,1846220,6419948,03/15/2016
2007,Nyack,392404,4194,5013308,806,1918569,6931877,03/15/2016
2007,Pearl River,392408,3207,3590982,710,1502851,5093833,03/15/2016
2007,Ramapo,392601,6051,9852266,1114,3246836,13099102,03/15/2016
2007,East Ramapo,392602,12369,13497820,1675,3163191,16661011,03/15/2016
2007,Ogdensburg,401200,2202,1447617,674,621803,2069420,03/15/2016
2007,Brasher Falls,402001,1351,872090,439,433106,1305196,03/15/2016
2007,Canton,402201,1827,1138315,476,501533,1639848,03/15/2016
2007,Clifton-Fine,402601,486,198740,265,146927,345667,03/15/2016
2007,Colton-Pierrepont,402801,636,282129,229,159472,441601,03/15/2016
2007,Edwards-Knox,403401,751,275604,224,123467,399071,03/15/2016
2007,Gouverneur,404001,2015,910460,598,410067,1320527,03/15/2016
2007,Hammond,404201,405,196708,153,115867,312575,03/15/2016
2007,Hermon-Dekalb,404401,571,343327,178,164561,507888,03/15/2016
2007,Lisbon,405002,843,488156,247,235172,723328,03/15/2016
2007,Madrid-Waddington,405601,1015,629697,326,328300,957997,03/15/2016
2007,Massena,405801,3539,2143613,1292,1311195,3454808,03/15/2016
2007,Morristown,406001,649,357468,215,201949,559417,03/15/2016
2007,Norwood-Norfolk,406201,1456,1178724,475,597471,1776195,03/15/2016
2007,Heuvelton,406404,878,574497,256,279639,854136,03/15/2016
2007,Parishville-Hopkinton,406601,684,309909,169,111103,421012,03/15/2016
2007,Potsdam,407402,1957,1507409,512,642293,2149702,03/15/2016
2007,Mechanicville,411000,1578,902881,554,587668,1490549,03/15/2016
2007,Saratoga Springs,411500,9684,4951438,1656,1567706,6519144,03/15/2016
2007,Burnt Hills-Ballston Lake,412001,4991,3488039,1140,1489417,4977456,03/15/2016
2007,Shenendehowa,412402,13922,8577817,1946,2245675,10823492,03/15/2016
2007,Corinth,412601,1603,863208,484,430172,1293380,03/15/2016
2007,Edinburg,413001,369,74535,146,51585,126120,03/15/2016
2007,Galway,413201,1681,850959,378,327950,1178909,03/15/2016
2007,Ballston Spa,414201,5575,4336437,1039,1356414,5692851,03/15/2016
2007,South Glens Falls,414401,3846,2883459,1052,1332595,4216054,03/15/2016
2007,Schuylerville,415001,2322,1993532,463,674084,2667616,03/15/2016
2007,Stillwater,415201,1729,840173,372,326311,1166484,03/15/2016
2007,Waterford-Halfmoon,415401,1005,742815,409,521209,1264024,03/15/2016
2007,Schenectady,421500,8437,7212631,2498,3545079,10757710,03/15/2016
2007,Duanesburg,422001,1357,816744,219,246225,1062969,03/15/2016
2007,Scotia-Glenville,422202,4331,3156817,1083,1445791,4602608,03/15/2016
2007,Niskayuna,422401,6297,4002581,875,1047258,5049839,03/15/2016
2007,Schalmont,422801,3396,2397631,889,1156842,3554473,03/15/2016
2007,Rotterdam-Mohonasen,422803,4836,2934594,1894,2089414,5024008,03/15/2016
2007,Cobleskill-Richmondville,432602,2484,1650162,856,959427,2609589,03/15/2016
2007,Gilboa-Conesville,433401,554,271823,258,200191,472014,03/15/2016
2007,Jefferson,433601,432,228070,153,134900,362970,03/15/2016
2007,Middleburgh,433801,1296,905981,470,539997,1445978,03/15/2016
2007,Schoharie,434201,1505,987666,466,533488,1521154,03/15/2016
2007,Sharon Springs,434601,432,341898,157,209364,551262,03/15/2016
2007,Odessa-Montour,442001,1240,829040,402,452078,1281118,03/15/2016
2007,Watkins Glen,442401,1827,865265,685,540505,1405770,03/15/2016
2007,South Seneca,452801,1363,802758,501,475343,1278101,03/15/2016
2007,Romulus,453003,751,518156,225,273205,791361,03/15/2016
2007,Seneca Falls,453201,1976,1647127,739,1055220,2702347,03/15/2016
2007,Waterloo,453801,2226,1573368,828,1008839,2582207,03/15/2016
2007,Corning,460300,7237,5267554,2108,2462576,7730130,03/15/2016
2007,Hornell,460600,1778,1073322,666,588067,1661389,03/15/2016
2007,Addison,462001,1456,959985,434,395641,1355626,03/15/2016
2007,Avoca,462201,786,388903,262,200647,589550,03/15/2016
2007,Bath,462402,1838,980483,642,623106,1603589,03/15/2016
2007,Bradford,462601,449,284103,156,164831,448934,03/15/2016
2007,Campbell-Savona,463002,1212,832238,358,411016,1243254,03/15/2016
2007,Canisteo-Greenwood,463202,1327,695769,504,396087,1091856,03/15/2016
2007,Arkport,465201,667,455331,273,307946,763277,03/15/2016
2007,Jasper-Troupsburg,465601,622,285038,205,153510,438548,03/15/2016
2007,Prattsburgh,466001,650,346763,205,182947,529710,03/15/2016
2007,Hammondsport,467201,1052,462756,403,297736,760492,03/15/2016
2007,Wayland-Cohocton,467401,2108,1068641,648,544669,1613310,03/15/2016
2007,Babylon,472001,2669,3252826,388,859455,4112281,03/15/2016
2007,West Babylon,472002,5325,5722148,1051,2072763,7794911,03/15/2016
2007,North Babylon,472003,6329,6725241,1476,2905019,9630260,03/15/2016
2007,Lindenhurst,472004,8150,9399649,1766,3766698,13166347,03/15/2016
2007,Copiague,472005,4966,5462086,1111,2172110,7634196,03/15/2016
2007,Amityville,472006,3959,4331496,806,1519672,5851168,03/15/2016
2007,Deer Park,472007,5016,5928964,1414,3101412,9030376,03/15/2016
2007,Wyandanch,472009,1106,1184316,176,340949,1525265,03/15/2016
2007,Three Village,472201,9246,9754756,1435,2784002,12538758,03/15/2016
2007,Brookhaven-Comsewogue,472203,4366,4480070,830,1510359,5990429,03/15/2016
2007,South Country,472204,4967,4991254,716,1304456,6295710,03/15/2016
2007,Sachem,472205,17240,16039007,2453,4145440,20184447,03/15/2016
2007,Port Jefferson,472206,1587,982831,220,253077,1235908,03/15/2016
2007,Mount Sinai,472207,2981,3363757,441,917568,4281325,03/15/2016
2007,Miller Place,472208,3643,3965068,380,754478,4719546,03/15/2016
2007,Rocky Point,472209,3807,4408643,485,1002277,5410920,03/15/2016
2007,Middle Country,472211,11603,12137148,2192,4149340,16286488,03/15/2016
2007,Longwood,472212,12073,13136741,3133,5630792,18767533,03/15/2016
2007,Patchogue-Medford,472224,9110,9325676,1624,2891491,12217167,03/15/2016
2007,William Floyd,472232,9137,10194292,1271,2471526,12665818,03/15/2016
2007,Center Moriches,472233,1629,1908627,251,530344,2438971,03/15/2016
2007,East Moriches,472234,1283,1420039,175,357918,1777957,03/15/2016
2007,Eastport- South Manor,472235,4139,4363828,833,1467964,5831792,03/15/2016
2007,East Hampton,472401,1293,291363,366,169724,461087,03/15/2016
2007,Wainscott,472402,119,9666,26,4682,14348,03/15/2016
2007,Amagansett,472403,256,27704,101,23859,51563,03/15/2016
2007,Springs,472404,932,312546,296,217801,530347,03/15/2016
2007,Sag Harbor,472405,1244,401456,473,313284,714740,03/15/2016
2007,Montauk,472406,683,111060,252,113725,224785,03/15/2016
2007,Elwood,472601,3214,2823024,586,1016551,3839575,03/15/2016
2007,Cold Spring Harbor,472602,2143,1704553,142,221931,1926484,03/15/2016
2007,Huntington,472603,7702,6781631,1207,2063970,8845601,03/15/2016
2007,Northport-East Northport,472604,9019,6293415,1489,2051285,8344700,03/15/2016
2007,Half Hollow Hills,472605,11195,8309208,1613,2209922,10519130,03/15/2016
2007,Harborfields,472606,4741,4250796,682,1206934,5457730,03/15/2016
2007,Commack,472610,9262,9188780,1796,3414729,12603509,03/15/2016
2007,South Huntington,472613,8791,8052650,1696,3061910,11114560,03/15/2016
2007,Bay Shore,472801,5712,6316476,1066,2193790,8510266,03/15/2016
2007,Islip,472802,3911,4210239,671,1286324,5496563,03/15/2016
2007,East Islip,472803,5591,6125109,993,2248237,8373346,03/15/2016
2007,Sayville,472804,4052,4413418,806,1633017,6046435,03/15/2016
2007,Bayport-Blue Point,472805,3045,3709726,474,1089699,4799425,03/15/2016
2007,Hauppauge,472806,5120,3010251,968,1046127,4056378,03/15/2016
2007,Connetquot,472807,8710,8817698,1505,2807619,11625317,03/15/2016
2007,West Islip,472809,6514,6539044,1258,2394485,8933529,03/15/2016
2007,Brentwood,472812,9420,6671468,1931,2588359,9259827,03/15/2016
2007,Central Islip,472813,5425,6639094,861,1964948,8604042,03/15/2016
2007,Fire Island,472814,92,10156,18,3751,13907,03/15/2016
2007,Shoreham-Wading River,473001,3128,2587087,752,1059988,3647075,03/15/2016
2007,Riverhead,473002,6802,5317281,2598,3100830,8418111,03/15/2016
2007,Shelter Island,473201,594,127358,222,90652,218010,03/15/2016
2007,Smithtown,473401,13737,13779401,2417,4340054,18119455,03/15/2016
2007,Kings Park,473405,5455,4703448,890,1429136,6132584,03/15/2016
2007,Remsenburg-Speonk,473601,428,142878,83,56210,199088,03/15/2016
2007,Westhampton Beach,473602,982,352357,235,165114,517471,03/15/2016
2007,Quogue,473603,246,30571,41,10230,40801,03/15/2016
2007,Hampton Bays,473605,2178,1419275,666,892468,2311743,03/15/2016
2007,Southhampton,473606,1713,299953,544,192921,492874,03/15/2016
2007,Bridgehampton,473609,288,25995,89,16479,42474,03/15/2016
2007,Sagaponack,473610,76,2172,9,529,2701,03/15/2016
2007,Tuckahoe Common,473613,524,227573,166,146468,374041,03/15/2016
2007,East Quogue,473617,1091,671088,284,330282,1001370,03/15/2016
2007,Oysterponds,473802,387,111313,181,97492,208805,03/15/2016
2007,Fishers Island,473804,37,9749,6,2962,12711,03/15/2016
2007,Southold,473805,1551,843562,579,587038,1430600,03/15/2016
2007,Greenport,473810,646,366103,291,302738,668841,03/15/2016
2007,Mattituck-Cutchogue,473812,2177,1261895,679,734764,1996659,03/15/2016
2007,New Suffolk,473815,84,16515,34,12344,28859,03/15/2016
2007,Fallsburg,482801,1254,1156390,314,489401,1645791,03/15/2016
2007,Eldred,483401,1101,643665,374,398693,1042358,03/15/2016
2007,Liberty,483601,1480,1277380,548,831656,2109036,03/15/2016
2007,Tri-Valley,484201,1302,936108,333,389211,1325319,03/15/2016
2007,Roscoe,484401,364,190049,178,161529,351578,03/15/2016
2007,Livingston Manor,484402,628,320079,256,220132,540211,03/15/2016
2007,Monticello,484601,3323,2014908,1029,1082984,3097892,03/15/2016
2007,Sullivan West,484802,2176,1133446,889,820067,1953513,03/15/2016
2007,Waverly,492001,1854,1036746,637,592379,1629125,03/15/2016
2007,Candor,492401,1044,661533,341,373670,1035203,03/15/2016
2007,Newark Valley,492602,1738,1234295,518,641718,1876013,03/15/2016
2007,Owego-Apalachin,493001,2981,2097917,1013,1221325,3319242,03/15/2016
2007,Spencer-Van Etten,493401,1349,717401,397,356565,1073966,03/15/2016
2007,Tioga,493603,1205,430641,366,221751,652392,03/15/2016
2007,Ithaca,500700,8345,4681981,1585,1455207,6137188,03/15/2016
2007,Dryden,502401,2467,1834101,567,648758,2482859,03/15/2016
2007,Groton,502801,1332,819483,312,319818,1139301,03/15/2016
2007,Lansing,503201,1715,1019848,315,326232,1346080,03/15/2016
2007,Newfield,503401,1040,628602,280,233687,862289,03/15/2016
2007,Trumansburg,503601,1725,1250689,384,449967,1700656,03/15/2016
2007,Kingston,510800,8629,5733630,2803,3368190,9101820,03/15/2016
2007,Highland,513203,2428,1630547,518,635683,2266230,03/15/2016
2007,Rondout Valley,513401,3775,2914318,990,1336040,4250358,03/15/2016
2007,Marlboro,513601,2385,1436700,498,540501,1977201,03/15/2016
2007,New Paltz,513801,3238,2239873,626,804868,3044741,03/15/2016
2007,Onteora,514001,3418,1695260,1187,1045378,2740638,03/15/2016
2007,Saugerties,514801,4424,2710387,1259,1395760,4106147,03/15/2016
2007,Wallkill,515201,3943,3028966,877,992943,4021909,03/15/2016
2007,Ellenville,515602,1703,1334128,563,651622,1985750,03/15/2016
2007,Glens Falls,520500,2868,1937397,823,976159,2913556,03/15/2016
2007,Bolton,522001,408,87405,144,56336,143741,03/15/2016
2007,Lake George,522201,1536,374321,429,192236,566557,03/15/2016
2007,North Warren,522402,1032,350124,433,255307,605431,03/15/2016
2007,Johnsburg,523001,573,304500,224,209640,514140,03/15/2016
2007,Hadley-Luzerne,523201,1333,520914,526,358558,879472,03/15/2016
2007,Queensbury,523402,4564,2670572,1063,1096184,3766756,03/15/2016
2007,Glens Falls Common,523418,274,151368,89,82676,234044,03/15/2016
2007,Warrensburg,524001,1281,751305,433,437675,1188980,03/15/2016
2007,Argyle,532001,918,576701,257,282273,858974,03/15/2016
2007,Fort Ann,532802,801,735440,222,359125,1094565,03/15/2016
2007,Fort Edward,533001,560,491330,203,317619,808949,03/15/2016
2007,Granville,533201,1551,995846,484,519126,1514972,03/15/2016
2007,Greenwich,533401,1475,1005022,466,569911,1574933,03/15/2016
2007,Hartford,533801,709,473954,179,209368,683322,03/15/2016
2007,Hudson Falls,534401,2670,1809487,966,1147501,2956988,03/15/2016
2007,Putnam,534601,168,44585,52,24758,69343,03/15/2016
2007,Salem,534801,870,507661,316,325315,832976,03/15/2016
2007,Cambridge,535010,1306,784127,517,542771,1326898,03/15/2016
2007,Whitehall,535201,916,442216,383,290189,732405,03/15/2016
2007,Newark,542001,2811,2036625,945,1220806,3257431,03/15/2016
2007,Clyde-Savannah,542401,1182,905630,427,540716,1446346,03/15/2016
2007,Lyons,542801,1201,752862,432,435532,1188394,03/15/2016
2007,Gananda,543002,1467,1242017,109,173533,1415550,03/15/2016
2007,Marion,543201,1375,1001692,305,392652,1394344,03/15/2016
2007,Wayne,543401,3742,2514435,709,870199,3384634,03/15/2016
2007,Palmyra-Macedon,543601,2641,2051323,710,969888,3021211,03/15/2016
2007,Sodus,544201,1574,953971,542,548569,1502540,03/15/2016
2007,Williamson,544602,1544,1139344,426,577724,1717068,03/15/2016
2007,North Rose-Wolcott,544801,1902,986592,696,592856,1579448,03/15/2016
2007,Red Creek,544803,1213,586713,383,313200,899913,03/15/2016
2007,Mount Vernon,550800,5324,13926659,1413,6217080,20143739,03/15/2016
2007,New Rochelle,551000,9326,19607349,1519,5827328,25434677,03/15/2016
2007,Peekskill,551200,3454,8290195,580,2246317,10536512,03/15/2016
2007,Rye,551400,2911,3699192,299,805147,4504339,03/15/2016
2007,White Plains,551700,7324,16151587,1123,4036829,20188416,03/15/2016
2007,Yonkers,551800,17533,28229565,4534,11484231,39713796,03/15/2016
2007,Katonah-Lewisboro,552001,5087,8115613,460,1416411,9532024,03/15/2016
2007,Bedford,552002,5135,6117025,666,1479650,7596675,03/15/2016
2007,Croton-Harmon,552202,2347,5315497,276,1056882,6372379,03/15/2016
2007,Hendrick Hudson,552203,3487,6274636,501,1424685,7699321,03/15/2016
2007,Eastchester,552401,3095,7109253,659,2526103,9635356,03/15/2016
2007,Tuckahoe,552402,1227,2516866,228,787341,3304207,03/15/2016
2007,Bronxville,552403,1165,2521360,51,327771,2849131,03/15/2016
2007,Tarrytowns,552601,2526,5592614,441,1745697,7338311,03/15/2016
2007,Irvington,552602,1827,4071453,210,942968,5014421,03/15/2016
2007,Dobbs Ferry,552603,1529,4160467,208,1061838,5222305,03/15/2016
2007,Hastings On Hudson,552604,1698,4685152,292,1413557,6098709,03/15/2016
2007,Ardsley,552605,2547,5084313,332,1244103,6328416,03/15/2016
2007,Edgemont,552606,1706,4078843,120,536247,4615090,03/15/2016
2007,Greenburgh,552607,4280,7425386,853,2393638,9819024,03/15/2016
2007,Elmsford,552609,1330,2227983,307,947104,3175087,03/15/2016
2007,Harrison,552801,3705,3716230,671,1362673,5078903,03/15/2016
2007,Mamaroneck,553201,5021,7381019,642,1817206,9198225,03/15/2016
2007,Mount Pleasant,553401,2712,4253671,683,2053811,6307482,03/15/2016
2007,Pocantico Hills,553402,471,412592,92,145299,557891,03/15/2016
2007,Valhalla,553405,1855,3288338,401,1363756,4652094,03/15/2016
2007,Pleasantville,553409,1965,4079719,333,1208801,5288520,03/15/2016
2007,Chappaqua,553604,4490,7269473,228,747479,8016952,03/15/2016
2007,Byram Hills,553801,3029,3788057,213,573225,4361282,03/15/2016
2007,North Salem,554001,1923,2654937,212,514286,3169223,03/15/2016
2007,Ossining,554201,5826,12534597,769,2949555,15484152,03/15/2016
2007,Briarcliff Manor,554202,1710,3850026,114,498626,4348652,03/15/2016
2007,Pelham,554401,2514,4262200,318,971157,5233357,03/15/2016
2007,Rye Neck,554801,1564,2394013,293,809455,3203468,03/15/2016
2007,Port Chester-Rye,554804,2857,4537844,884,2435982,6973826,03/15/2016
2007,Blind Brook-Rye,554805,1684,2438864,178,486866,2925730,03/15/2016
2007,Scarsdale,555001,4689,6167558,220,582420,6749978,03/15/2016
2007,Somers,555201,5172,7391629,1228,3222522,10614151,03/15/2016
2007,Lakeland,555401,8617,18884023,1642,5383259,24267282,03/15/2016
2007,Yorktown,555402,5190,10282953,647,2328194,12611147,03/15/2016
2007,Attica,562201,2353,1256511,625,617266,1873777,03/15/2016
2007,Letchworth,562601,1431,700571,388,326282,1026853,03/15/2016
2007,Wyoming,563802,458,254589,89,88955,343544,03/15/2016
2007,Perry,564201,1248,685600,435,424944,1110544,03/15/2016
2007,Warsaw,564801,1386,925430,390,473701,1399131,03/15/2016
2007,Penn Yan,573001,2939,1230288,1158,842298,2072586,03/15/2016
2007,Dundee,573401,1217,536368,435,311541,847909,03/15/2016
2007,New York City School,650000,599439,113239910,97501,32718922,145958832,03/15/2016
2006,Albany,010100,9992,6828510,3420,3979273,10807783,03/15/2016
2006,Cohoes,010300,2067,1697420,776,1059698,2757118,03/15/2016
2006,Watervliet,011800,1283,666003,516,459528,1125531,03/15/2016
2006,Berne-Knox-Westerlo,012001,1662,1140814,346,408473,1549287,03/15/2016
2006,Bethlehem,012206,6922,5078455,1223,1671710,6750165,03/15/2016
2006,Ravena-Coeymans-Selkirk,012402,2820,2052903,762,958361,3011264,03/15/2016
2006,South Colonie,012601,8885,4478973,2754,2513077,6992050,03/15/2016
2006,North Colonie,012605,7759,3661073,1716,1492892,5153965,03/15/2016
2006,Menands,012615,391,188661,106,93628,282289,03/15/2016
2006,Maplewood,012622,95,61228,60,67766,128994,03/15/2016
2006,Green Island,012801,275,214419,139,198426,412845,03/15/2016
2006,Guilderland,013002,7428,4644698,1490,1739500,6384198,03/15/2016
2006,Voorheesville,013403,1979,1301469,378,465978,1767447,03/15/2016
2006,Alfred-Almond,022001,869,650773,267,331121,981894,03/15/2016
2006,Andover,023001,489,433287,173,232341,665628,03/15/2016
2006,Genesee Valley,023202,754,369035,366,263805,632840,03/15/2016
2006,Belfast,023401,438,239003,167,130323,369326,03/15/2016
2006,Canaseraga,024002,394,237880,149,134603,372483,03/15/2016
2006,Cuba-Rushford,024801,1352,854674,529,534782,1389456,03/15/2016
2006,Friendship,025001,378,306728,155,175050,481778,03/15/2016
2006,Fillmore,025801,816,372397,259,187956,560353,03/15/2016
2006,Whitesville,026001,238,167447,99,89430,256877,03/15/2016
2006,Scio,026601,499,404638,185,224680,629318,03/15/2016
2006,Wellsville,027001,1671,1113548,798,797642,1911190,03/15/2016
2006,Bolivar-Richburg,027602,989,465259,355,229823,695082,03/15/2016
2006,Binghamton,030200,6057,4242509,2563,2773799,7016308,03/15/2016
2006,Chenango Forks,032001,2210,1576907,619,796940,2373847,03/15/2016
2006,South Mountain-Hickory,032201,143,45556,24,14482,60038,03/15/2016
2006,Harpursville,032601,1174,592725,303,248565,841290,03/15/2016
2006,Susquehanna Valley,032801,2550,2193111,827,1233210,3426321,03/15/2016
2006,Chenango Valley,033001,2693,2088730,1146,1627856,3716586,03/15/2016
2006,Maine-Endwell,033801,3536,3327015,1359,2158526,5485541,03/15/2016
2006,Deposit,034201,738,386069,304,269614,655683,03/15/2016
2006,Whitney Point,034401,1806,1058997,474,467179,1526176,03/15/2016
2006,Union-Endicott,034601,5648,4889181,2399,3618002,8507183,03/15/2016
2006,Johnson City,034602,3140,2400256,1511,1846899,4247155,03/15/2016
2006,Vestal,034801,5891,5118917,1819,2737346,7856263,03/15/2016
2006,Windsor,035001,2170,1545713,690,842145,2387858,03/15/2016
2006,Olean,041200,2850,1759540,1102,959933,2719473,03/15/2016
2006,Salamanca,041600,1102,519351,535,322750,842101,03/15/2016
2006,Allegany-Limestone,042001,1643,875760,605,467579,1343339,03/15/2016
2006,West Valley,042204,519,380678,158,196867,577545,03/15/2016
2006,Ellicottville,043601,731,212247,244,120917,333164,03/15/2016
2006,Franklinville,044001,962,568145,338,288131,856276,03/15/2016
2006,Hinsdale,044601,598,310029,235,185567,495596,03/15/2016
2006,Cattaraugus - Little Valley,046402,1500,813126,497,410147,1223273,03/15/2016
2006,Gowanda,047201,1500,903531,629,630563,1534094,03/15/2016
2006,Portville,047401,1140,741392,381,397603,1138995,03/15/2016
2006,Randolph,047601,1253,552301,415,313105,865406,03/15/2016
2006,Yorkshire-Pioneer,048401,3407,1484529,950,693677,2178206,03/15/2016
2006,Auburn,050100,5377,3355793,2216,2341164,5696957,03/15/2016
2006,Weedsport,052201,1202,865416,334,421955,1287371,03/15/2016
2006,Cato-Meridian,052401,1459,866914,344,335773,1202687,03/15/2016
2006,Southern Cayuga,053001,1300,733509,389,374007,1107516,03/15/2016
2006,Port Byron,053801,1401,988368,473,584509,1572877,03/15/2016
2006,Moravia,054201,1414,738723,366,325431,1064154,03/15/2016
2006,Union Springs,055401,1287,908909,430,527963,1436872,03/15/2016
2006,Dunkirk,060300,2301,1714706,1209,1381635,3096341,03/15/2016
2006,Jamestown,060800,4939,2708482,1836,1587104,4295586,03/15/2016
2006,Southwestern,062201,2280,1487506,765,844398,2331904,03/15/2016
2006,Frewsburg,062401,1062,748847,375,462276,1211123,03/15/2016
2006,Cassadaga Valley,062601,1500,788645,488,430164,1218809,03/15/2016
2006,Chautauqua Lake,062803,1232,383737,425,233862,617599,03/15/2016
2006,Pine Valley,063001,847,585601,302,331388,916989,03/15/2016
2006,Clymer,063201,646,286393,231,178190,464583,03/15/2016
2006,Bemus Point,063601,1193,617478,422,366773,984251,03/15/2016
2006,Falconer,063801,1602,1038422,542,583865,1622287,03/15/2016
2006,Silver Creek,064601,1283,793638,480,507479,1301117,03/15/2016
2006,Forestville,064603,918,532343,297,297545,829888,03/15/2016
2006,Panama,064801,829,524795,245,253941,778736,03/15/2016
2006,Fredonia,065801,2194,1404926,735,871082,2276008,03/15/2016
2006,Brocton,066001,847,696545,285,344534,1041079,03/15/2016
2006,Ripley,066201,445,397997,176,238006,636003,03/15/2016
2006,Sherman,066601,563,346807,152,154602,501409,03/15/2016
2006,Westfield,067201,1040,743993,393,490699,1234692,03/15/2016
2006,Elmira,070400,7749,5241635,3121,3426785,8668420,03/15/2016
2006,Horseheads,073401,5675,3418473,1947,2091701,5510174,03/15/2016
2006,Elmira Heights,073402,1265,840485,567,642319,1482804,03/15/2016
2006,Norwich,081100,2366,1592271,801,853114,2445385,03/15/2016
2006,Afton,082001,856,608879,315,363813,972692,03/15/2016
2006,Bainbridge-Guilford,082201,1185,849802,429,503494,1353296,03/15/2016
2006,Greene,083001,1493,945037,487,532224,1477261,03/15/2016
2006,Unadilla Valley,083803,1127,595229,389,340635,935864,03/15/2016
2006,Georgetown-So Otselic Valley,084401,549,327345,146,130293,457638,03/15/2016
2006,Oxford Academy,084601,1107,703674,410,418778,1122452,03/15/2016
2006,Sherburne-Earlville,085601,1731,1026609,565,558087,1584696,03/15/2016
2006,Plattsburgh,091300,2163,1493674,743,909287,2402961,03/15/2016
2006,Ausable Valley,092201,1978,1201896,673,607010,1808906,03/15/2016
2006,Beekmantown,092401,2796,1645866,761,726736,2372602,03/15/2016
2006,Northeastern Clinton,092801,2086,1425798,559,608152,2033950,03/15/2016
2006,Chazy,093001,732,474305,188,208277,682582,03/15/2016
2006,Northern Adirondack,093601,1437,549381,415,246878,796259,03/15/2016
2006,Peru,094001,2760,1702679,589,604954,2307633,03/15/2016
2006,Saranac,094401,2407,1625777,646,736286,2362063,03/15/2016
2006,Hudson,100600,2095,1249967,926,940070,2190037,03/15/2016
2006,Copake-Taconic Hills,102801,2147,915056,749,574921,1489977,03/15/2016
2006,Germantown,103602,905,464371,320,297956,762327,03/15/2016
2006,Chatham,103801,1944,1030492,522,484919,1515411,03/15/2016
2006,Kinderhook,104401,3055,1824191,701,741935,2566126,03/15/2016
2006,New Lebanon,104801,900,454782,240,210758,665540,03/15/2016
2006,Cortland,110200,3198,1855365,1082,1132588,2987953,03/15/2016
2006,Cincinnatus,112001,739,387308,259,212060,599368,03/15/2016
2006,Mc Graw,112204,769,472131,230,234234,706365,03/15/2016
2006,Homer,113001,2799,1858429,774,903120,2761549,03/15/2016
2006,Marathon,113401,942,639070,288,319660,958730,03/15/2016
2006,Andes,122002,237,91396,146,101402,192798,03/15/2016
2006,Downsville,122401,382,149071,228,145128,294199,03/15/2016
2006,Charlotte Valley,122601,602,281446,245,195193,476639,03/15/2016
2006,Delhi,122801,1256,654705,521,491904,1146609,03/15/2016
2006,Franklin,123201,457,212529,153,126296,338825,03/15/2016
2006,Hancock,123606,456,273376,245,238101,511477,03/15/2016
2006,Margaretville,124601,686,224679,319,190797,415476,03/15/2016
2006,Roxbury,124802,565,321938,254,253649,575587,03/15/2016
2006,Sidney,125001,1441,868594,660,687735,1556329,03/15/2016
2006,Stamford,125201,556,369217,219,255219,624436,03/15/2016
2006,South Kortright,125202,511,254046,242,216234,470280,03/15/2016
2006,Walton,125601,1238,543265,517,396134,939399,03/15/2016
2006,Beacon,130200,3525,2548512,870,1184626,3733138,03/15/2016
2006,Poughkeepsie,131300,2882,1850711,926,1079255,2929966,03/15/2016
2006,Dover,132602,1590,1402571,285,483344,1885915,03/15/2016
2006,Hyde Park,133201,5565,4946742,1433,2227167,7173909,03/15/2016
2006,Northeast,133801,984,673389,299,368896,1042285,03/15/2016
2006,Pawling,134001,1894,1471186,332,483214,1954400,03/15/2016
2006,Pine Plains,134201,1851,870184,472,398353,1268537,03/15/2016
2006,Arlington,134601,11416,9074560,1832,2703670,11778230,03/15/2016
2006,Spackenkill,134602,1892,1710298,424,678692,2388990,03/15/2016
2006,Red Hook,134801,2301,1887756,599,906719,2794475,03/15/2016
2006,Rhinebeck,135001,1803,1262903,508,673202,1936105,03/15/2016
2006,Wappingers,135601,15188,8532077,3015,3168802,11700879,03/15/2016
2006,Millbrook,135801,1474,811636,307,333575,1145211,03/15/2016
2006,Buffalo,140200,30339,12540402,9580,5349742,17890144,03/15/2016
2006,Lackawanna,140900,2318,654872,1454,575646,1230518,03/15/2016
2006,Tonawanda,141600,3221,1883732,1372,1419504,3303236,03/15/2016
2006,Alden,142001,2740,1583451,823,853488,2436939,03/15/2016
2006,Amherst,142201,5653,3319863,1478,1575348,4895211,03/15/2016
2006,Williamsville,142203,16639,9809870,3648,3817166,13627036,03/15/2016
2006,Sweet Home,142207,5287,2266641,2151,1710333,3976974,03/15/2016
2006,East Aurora,142401,2919,1376636,839,730086,2106722,03/15/2016
2006,Cheektowaga,143001,3640,1980018,1917,1731763,3711781,03/15/2016
2006,Cheektowaga-Maryvale,143002,3615,1919494,2078,1998084,3917578,03/15/2016
2006,Cleveland Hill,143003,2513,1931856,969,1344340,3276196,03/15/2016
2006,Depew,143007,3384,2189092,1206,1428094,3617186,03/15/2016
2006,Cheektowaga-Sloan,143009,2289,2050836,1424,2341368,4392204,03/15/2016
2006,Clarence,143201,6330,3057192,1418,1143179,4200371,03/15/2016
2006,Springville-Griffith,143801,3008,1803240,875,932170,2735410,03/15/2016
2006,Eden,144001,2413,1263235,674,658279,1921514,03/15/2016
2006,Iroquois,144201,4194,1965291,1244,1078531,3043822,03/15/2016
2006,Evans-Brant,144401,4123,2538061,1081,1079584,3617645,03/15/2016
2006,Grand Island,144601,4925,3155132,1017,1178030,4333162,03/15/2016
2006,Hamburg,144801,5551,2778815,1440,1353508,4132323,03/15/2016
2006,Frontier,144804,7834,3685262,2247,1827019,5512281,03/15/2016
2006,Holland,145001,1686,853617,379,359509,1213126,03/15/2016
2006,Lancaster,145201,9412,4512195,2709,2305650,6817845,03/15/2016
2006,Akron,145601,1953,971212,603,480872,1452084,03/15/2016
2006,North Collins,145801,982,594046,303,325037,919083,03/15/2016
2006,Orchard Park,146001,7632,3871977,1724,1627542,5499519,03/15/2016
2006,Kenmore,146401,14705,9105090,6193,7104203,16209293,03/15/2016
2006,West Seneca,146801,11794,6350320,4722,4511106,10861426,03/15/2016
2006,Crown Point,152203,427,179913,147,104781,284694,03/15/2016
2006,Elizabethtown-Lewis,152401,558,280756,166,146020,426776,03/15/2016
2006,Keene,153001,261,97578,82,57043,154621,03/15/2016
2006,Minerva,153401,227,137592,88,81853,219445,03/15/2016
2006,Moriah,153601,936,593504,483,454397,1047901,03/15/2016
2006,Newcomb,153801,122,10239,69,9672,19911,03/15/2016
2006,Lake Placid,154002,1113,375382,332,183637,559019,03/15/2016
2006,Schroon Lake,154601,444,129861,219,109414,239275,03/15/2016
2006,Ticonderoga,154801,1155,375481,459,250980,626461,03/15/2016
2006,Westport,155001,295,163398,137,132865,296263,03/15/2016
2006,Willsboro,155201,553,300006,270,241945,541951,03/15/2016
2006,Tupper Lake,162001,1282,560834,489,324237,885071,03/15/2016
2006,Chateaugay,163401,768,475301,231,226876,702177,03/15/2016
2006,Salmon River,164201,818,357748,306,218725,576473,03/15/2016
2006,Saranac Lake,164601,2252,848519,617,373676,1222195,03/15/2016
2006,Malone,164801,3083,1838601,1038,948065,2786666,03/15/2016
2006,Brushton-Moira,165001,991,546313,330,285389,831702,03/15/2016
2006,St. Regis Falls,165401,461,229413,164,126450,355863,03/15/2016
2006,Gloversville,170500,3195,2103065,1349,1231522,3334587,03/15/2016
2006,Johnstown,170800,2231,1248470,745,676521,1924991,03/15/2016
2006,Broadalbin-Perth,172201,2273,1102646,703,585290,1687936,03/15/2016
2006,Wheelerville,172401,358,173715,140,117354,291069,03/15/2016
2006,Mayfield,173001,1443,881764,472,466283,1348047,03/15/2016
2006,Northville,173201,648,304143,265,215724,519867,03/15/2016
2006,Oppenheim-Ephratah,173401,650,409299,181,174559,583858,03/15/2016
2006,Batavia,180200,3219,2395092,1113,1456704,3851796,03/15/2016
2006,Alexander,182202,1170,867333,347,466797,1334130,03/15/2016
2006,Byron-Bergen,183001,1594,1198067,451,517839,1715906,03/15/2016
2006,Elba,183401,617,590513,179,310102,900615,03/15/2016
2006,Le Roy,183601,1727,1305589,521,699917,2005506,03/15/2016
2006,Oakfield-Alabama,183801,1116,809771,395,497627,1307398,03/15/2016
2006,Pavilion,184001,1162,836063,260,318990,1155053,03/15/2016
2006,Pembroke,184202,1475,1053319,455,560543,1613862,03/15/2016
2006,Cairo-Durham,192401,1784,949675,730,670357,1620032,03/15/2016
2006,Catskill,192601,2141,1373152,772,862428,2235580,03/15/2016
2006,Coxsackie-Athens,192801,1940,1155903,618,645522,1801425,03/15/2016
2006,Greenville,193201,1932,1276173,600,706192,1982365,03/15/2016
2006,Hunter-Tannersville,193601,672,264725,292,204059,468784,03/15/2016
2006,Windham-Ashland-Jewett,194601,593,189598,257,149825,339423,03/15/2016
2006,Piseco,202001,90,7822,34,5426,13248,03/15/2016
2006,Indian Lake,202601,331,95275,155,81680,176955,03/15/2016
2006,Inlet,202801,90,12737,43,11524,24261,03/15/2016
2006,Lake Pleasant,203001,196,57947,89,48620,106567,03/15/2016
2006,Long Lake,203201,164,38394,95,38603,76997,03/15/2016
2006,Raquette Lake,203202,26,987,14,1015,2002,03/15/2016
2006,Wells,203601,228,73063,113,66035,139098,03/15/2016
2006,Little Falls,210900,1253,1007316,618,780143,1787459,03/15/2016
2006,West Canada Valley,212402,1054,640008,315,329025,969033,03/15/2016
2006,Frankfort-Schuyler,212602,1405,966128,591,709356,1675484,03/15/2016
2006,Ilion,212801,1630,835628,574,488793,1324421,03/15/2016
2006,Mohawk,212802,1088,668081,425,438822,1106903,03/15/2016
2006,Herkimer,213001,1485,1060237,806,891156,1951393,03/15/2016
2006,Dolgeville,213602,1053,530421,423,323398,853819,03/15/2016
2006,Poland,213803,936,451318,297,246120,697438,03/15/2016
2006,Van Hornesville-Owen D. Young,215001,318,186578,116,119044,305622,03/15/2016
2006,Town Of Webb,215401,546,107810,262,95479,203289,03/15/2016
2006,Mount Markham,215601,1498,967479,477,511154,1478633,03/15/2016
2006,Watertown,221800,3757,1495595,1332,863503,2359098,03/15/2016
2006,South Jefferson,222001,2234,1030784,543,393118,1423902,03/15/2016
2006,Alexandria,222202,859,363928,285,205660,569588,03/15/2016
2006,Indian River,222401,1717,332891,413,118812,451703,03/15/2016
2006,General Brown,222601,1844,738844,516,345197,1084041,03/15/2016
2006,Thousand Islands,223201,1525,700839,566,445611,1146450,03/15/2016
2006,Belleville-Henderson,223402,722,237647,275,144979,382626,03/15/2016
2006,Sackets Harbor,223801,617,332108,174,157669,489777,03/15/2016
2006,Lyme,224401,558,241893,248,186095,427988,03/15/2016
2006,La Fargeville,224601,625,231670,155,96410,328080,03/15/2016
2006,Carthage,226001,2526,1388665,733,633497,2022162,03/15/2016
2006,Copenhagen,232201,593,240469,145,98296,338765,03/15/2016
2006,Harrisville,232401,547,355547,189,170314,525861,03/15/2016
2006,Lowville,233601,1632,703363,515,353728,1057091,03/15/2016
2006,South Lewis,234001,1521,723152,566,406258,1129410,03/15/2016
2006,Beaver River,234401,1246,477125,383,240719,717844,03/15/2016
2006,Avon,242001,1257,943772,329,426304,1370076,03/15/2016
2006,Caledonia-Mumford,242201,1337,868039,367,433516,1301555,03/15/2016
2006,Geneseo,242601,1411,791297,339,349536,1140833,03/15/2016
2006,Livonia,243401,2652,1759659,573,671165,2430824,03/15/2016
2006,Mount Morris,243601,618,487816,248,327837,815653,03/15/2016
2006,Dansville,243801,2138,1153031,736,651866,1804897,03/15/2016
2006,Dalton-Nunda,244001,1198,833833,349,391574,1225407,03/15/2016
2006,York,245201,1148,718639,312,341634,1060273,03/15/2016
2006,Oneida,251200,2870,1729149,940,982166,2711315,03/15/2016
2006,Brookfield,252009,312,148082,86,62322,210404,03/15/2016
2006,Cazenovia,252201,2327,1450744,524,579961,2030705,03/15/2016
2006,De Ruyter,252401,578,395806,172,198705,594511,03/15/2016
2006,Morrisville-Eaton,252601,1005,561328,249,230279,791607,03/15/2016
2006,Hamilton,253201,962,555368,250,249261,804629,03/15/2016
2006,Canastota,253601,2023,1365420,672,781208,2146628,03/15/2016
2006,Madison,254001,617,428514,195,214705,643219,03/15/2016
2006,Stockbridge Valley,254601,561,389128,174,203445,592573,03/15/2016
2006,Chittenango,254801,3197,2479612,848,1075504,3555116,03/15/2016
2006,Rochester,261400,25918,11117697,4956,3248439,14366136,03/15/2016
2006,Brighton,262001,5387,4045684,955,1309087,5354771,03/15/2016
2006,Gates-Chili,262601,7918,5764256,2789,3623911,9388167,03/15/2016
2006,Greece,262801,19020,13086065,5306,6721160,19807225,03/15/2016
2006,East Irondequoit,263401,6625,5669437,2435,3696203,9365640,03/15/2016
2006,West Irondequoit,263403,6403,5510101,1932,3091532,8601633,03/15/2016
2006,Honeoye Falls-Lima,263601,3307,2320752,558,718993,3039745,03/15/2016
2006,Spencerport,263801,5410,4050455,1265,1747391,5797846,03/15/2016
2006,Hilton,264001,6488,4477568,1246,1581807,6059375,03/15/2016
2006,Penfield,264201,8033,6249526,1550,2197547,8447073,03/15/2016
2006,Fairport,264401,9899,7028516,2151,2741517,9770033,03/15/2016
2006,East Rochester,264413,1721,1399230,657,886674,2285904,03/15/2016
2006,Pittsford,264601,8725,6237338,1088,1451690,7689028,03/15/2016
2006,Churchville-Chili,264801,5856,4380327,1287,1737833,6118160,03/15/2016
2006,Rush-Henrietta,265001,8588,5054183,2141,2325202,7379385,03/15/2016
2006,Brockport,265201,4960,3734094,853,1129136,4863230,03/15/2016
2006,Webster,265401,12820,8675206,3127,3890222,12565428,03/15/2016
2006,Wheatland-Chili,265601,1398,1105233,375,505659,1610892,03/15/2016
2006,Amsterdam,270100,4097,2900505,1961,2326801,5227306,03/15/2016
2006,Canajoharie,272201,1292,881846,471,552322,1434168,03/15/2016
2006,Fonda-Fultonville,272801,1903,1265940,582,647571,1913511,03/15/2016
2006,Fort Plain,273001,999,1035609,378,623309,1658918,03/15/2016
2006,St. Johnsville,273802,605,379878,280,274393,654271,03/15/2016
2006,Glen Cove,280500,3550,3045430,1185,1895673,4941103,03/15/2016
2006,Long Beach,281000,7148,4984412,1155,1712433,6696845,03/15/2016
2006,Hempstead,282001,2938,4009271,479,1251051,5260322,03/15/2016
2006,Uniondale,282002,4805,4907517,799,1644343,6551860,03/15/2016
2006,East Meadow,282003,10755,11941699,2935,5697839,17639538,03/15/2016
2006,North Bellmore,282004,5798,6490044,1246,2833633,9323677,03/15/2016
2006,Levittown,282005,10871,15184162,2393,6930734,22114896,03/15/2016
2006,Seaford,282006,3875,3748571,840,1652583,5401154,03/15/2016
2006,Bellmore,282007,3077,3343182,495,1073494,4416676,03/15/2016
2006,Roosevelt,282008,2139,2524600,322,778700,3303300,03/15/2016
2006,Freeport,282009,5785,7452356,962,2488906,9941262,03/15/2016
2006,Baldwin,282010,7220,9287403,1084,2755504,12042907,03/15/2016
2006,Oceanside,282011,8484,8088252,1726,3328742,11416994,03/15/2016
2006,Malverne,282012,3013,3621208,612,1570680,5191888,03/15/2016
2006,Valley Stream 13,282013,5855,6435537,1517,3272677,9708214,03/15/2016
2006,Hewlett-Woodmere,282014,4739,5928615,670,1632947,7561562,03/15/2016
2006,Lawrence,282015,6165,4321957,945,1464972,5786929,03/15/2016
2006,Elmont,282016,7703,7693011,1613,3384248,11077259,03/15/2016
2006,Franklin Square,282017,4932,4487207,1478,2752756,7239963,03/15/2016
2006,Garden City,282018,5530,3536186,767,1008127,4544313,03/15/2016
2006,East Rockaway,282019,2042,2419569,519,1205098,3624667,03/15/2016
2006,Lynbrook,282020,3810,4122868,789,1799369,5922237,03/15/2016
2006,Rockville Centre,282021,4781,4428606,722,1453417,5882023,03/15/2016
2006,Floral Park-Bellerose,282022,4098,3414873,890,1527979,4942852,03/15/2016
2006,Wantagh,282023,4301,4715395,732,1680954,6396349,03/15/2016
2006,Valley Stream 24,282024,2428,2506804,575,1155025,3661829,03/15/2016
2006,Merrick,282025,4678,4830480,565,1164489,5994969,03/15/2016
2006,Island Trees,282026,3270,3503147,757,1695368,5198515,03/15/2016
2006,West Hempstead,282027,3510,3825902,674,1534323,5360225,03/15/2016
2006,North Merrick,282029,3233,3665428,698,1621049,5286477,03/15/2016
2006,Valley Stream 30,282030,2838,2587536,593,1136279,3723815,03/15/2016
2006,Island Park,282031,1492,1137790,313,463802,1601592,03/15/2016
2006,Westbury,282201,2925,4140458,648,1760002,5900460,03/15/2016
2006,East Williston,282202,2016,1915671,211,419316,2334987,03/15/2016
2006,Roslyn,282203,4088,3902374,375,769503,4671877,03/15/2016
2006,Port Washington,282204,5730,4241181,747,1089438,5330619,03/15/2016
2006,New Hyde Park-Garden City,282205,4463,3734458,1268,2178450,5912908,03/15/2016
2006,Manhasset,282206,3755,2167521,340,422046,2589567,03/15/2016
2006,Great Neck,282207,9144,5065764,1089,1199556,6265320,03/15/2016
2006,Herricks,282209,5859,5048965,1058,2026418,7075383,03/15/2016
2006,Mineola,282210,4334,3567784,1158,2002938,5570722,03/15/2016
2006,Carle Place,282211,1818,1611730,466,869742,2481472,03/15/2016
2006,North Shore,282401,3652,2612270,601,883807,3496077,03/15/2016
2006,Syosset,282402,8101,7815300,1199,1953736,9769036,03/15/2016
2006,Locust Valley,282403,3287,2122130,473,677598,2799728,03/15/2016
2006,Plainview-Old Bethpage,282404,7161,7402351,1337,2994790,10397141,03/15/2016
2006,Oyster Bay-East Norwich,282406,2643,1661127,385,515292,2176419,03/15/2016
2006,Jericho,282415,3309,2840812,329,564906,3405718,03/15/2016
2006,Hicksville,282417,7584,5672055,2167,3303546,8975601,03/15/2016
2006,Plainedge,282418,4462,5337080,1158,2915161,8252241,03/15/2016
2006,Bethpage,282421,3995,3446669,1449,1899645,5346314,03/15/2016
2006,Farmingdale,282422,8399,10368954,2112,5185726,15554680,03/15/2016
2006,Massapequa,282423,11491,10691088,2439,4863991,15555079,03/15/2016
2006,Lockport,290900,6384,5182251,1822,2299229,7481480,03/15/2016
2006,Niagara Falls,291100,7892,4115277,3736,3010946,7126223,03/15/2016
2006,North Tonawanda,291200,6540,4302250,2332,2773255,7075505,03/15/2016
2006,Lewiston-Porter,292401,4167,2885693,1384,1792707,4678400,03/15/2016
2006,Newfane,292801,2418,2128572,739,1098712,3227284,03/15/2016
2006,Niagara-Wheatfield,293001,5116,3181127,1661,1711689,4892816,03/15/2016
2006,Starpoint,293201,4004,2727196,923,1163500,3890696,03/15/2016
2006,Royalton-Hartland,293601,2058,1478096,582,757387,2235483,03/15/2016
2006,Barker,293801,1153,605656,324,291839,897495,03/15/2016
2006,Wilson,294201,1911,1474257,544,760450,2234707,03/15/2016
2006,Rome,301300,6139,4768630,2536,3092982,7861612,03/15/2016
2006,Utica,301600,7914,5691995,3612,3934454,9626449,03/15/2016
2006,Adirondack,302601,1938,1052639,641,536265,1588904,03/15/2016
2006,Camden,303001,2937,1586120,872,717457,2303577,03/15/2016
2006,Clinton,304001,2014,1762192,599,782918,2545110,03/15/2016
2006,New Hartford,304801,3778,2622953,1223,1437374,4060327,03/15/2016
2006,New York Mills,304804,817,545870,478,578910,1124780,03/15/2016
2006,Sauquoit Valley,305002,1432,925309,412,469409,1394718,03/15/2016
2006,Remsen,305201,765,497231,220,239290,736521,03/15/2016
2006,Waterville,305401,1153,705771,340,351648,1057419,03/15/2016
2006,Holland Patent,305801,2240,1533844,598,708507,2242351,03/15/2016
2006,Sherrill,306000,2708,1928829,903,1129419,3058248,03/15/2016
2006,Westmoreland,306801,1502,1430043,509,744752,2174795,03/15/2016
2006,Oriskany,307001,938,736395,322,437547,1173942,03/15/2016
2006,Whitesboro,307002,5007,3340972,1823,2160429,5501401,03/15/2016
2006,Syracuse,311500,16252,7828438,5055,4076894,11905332,03/15/2016
2006,West Genesee,312001,7252,5189388,2682,3380032,8569420,03/15/2016
2006,North Syracuse,312403,14166,9557050,3392,3710153,13267203,03/15/2016
2006,East Syracuse-Minoa,312601,5014,3805128,1843,2292309,6097437,03/15/2016
2006,Jamesville-Dewitt,312611,4150,2754467,825,987200,3741667,03/15/2016
2006,Jordan-Elbridge,312801,1806,1619433,521,736955,2356388,03/15/2016
2006,Fabius-Pompey,313001,1137,1012114,283,443403,1455517,03/15/2016
2006,Westhill,313201,2679,2160909,911,1353568,3514477,03/15/2016
2006,Solvay,313202,1825,1545569,947,1384201,2929770,03/15/2016
2006,La Fayette,313407,1074,659962,269,281267,941229,03/15/2016
2006,Baldwinsville,313601,8075,6346134,1744,2332512,8678646,03/15/2016
2006,Fayetteville-Manlius,313801,6444,5095113,1129,1615589,6710702,03/15/2016
2006,Marcellus,314001,2617,1735626,684,818306,2553932,03/15/2016
2006,Onondaga,314201,1484,1298496,432,643786,1942282,03/15/2016
2006,Liverpool,314801,10832,8654087,2934,3995396,12649483,03/15/2016
2006,Lyncourt,314804,818,769135,449,635121,1404256,03/15/2016
2006,Skaneateles,315001,2245,1204948,579,562661,1767609,03/15/2016
2006,Tully,315402,1370,948780,295,362634,1311414,03/15/2016
2006,Canandaigua,320200,4454,2599204,1062,1104863,3704067,03/15/2016
2006,Geneva,320500,2636,1796943,1113,1276891,3073834,03/15/2016
2006,East Bloomfield,322601,1426,1116136,313,421299,1537435,03/15/2016
2006,Gorham-Middlesex,323201,2192,1163761,601,557362,1721123,03/15/2016
2006,Manchester-Shortsville,323601,1194,1019915,394,575925,1595840,03/15/2016
2006,Naples,323801,1357,701938,340,302203,1004141,03/15/2016
2006,Phelps-Clifton Springs,324001,2376,1874139,592,830221,2704360,03/15/2016
2006,Honeoye,324201,1579,856570,377,366957,1223527,03/15/2016
2006,Victor,324801,4801,2877074,798,816996,3694070,03/15/2016
2006,Middletown,330900,5464,4728531,1218,1824243,6552774,03/15/2016
2006,Newburgh,331100,9759,8806498,2443,3823415,12629913,03/15/2016
2006,Port Jervis,331300,2769,2956578,865,1581348,4537926,03/15/2016
2006,Washingtonville,332002,5515,4585894,662,1068432,5654326,03/15/2016
2006,Chester,332201,1384,1101258,229,335798,1437056,03/15/2016
2006,Cornwall,332401,3571,2813865,571,813565,3627430,03/15/2016
2006,Pine Bush,332601,6063,4178508,947,1190689,5369197,03/15/2016
2006,Goshen,333001,3063,2070960,577,733742,2804702,03/15/2016
2006,Highland Falls,333601,902,573948,241,284374,858322,03/15/2016
2006,Minisink Valley,333801,4702,3538996,663,918998,4457994,03/15/2016
2006,Monroe-Woodbury,334001,8892,7361372,1018,1669070,9030442,03/15/2016
2006,Kiryas Joel Village,334002,923,337081,33,22296,359377,03/15/2016
2006,Valley,334201,5235,3942072,1058,1452700,5394772,03/15/2016
2006,Tuxedo,335003,569,198177,88,65596,263773,03/15/2016
2006,Warwick Valley,335401,5338,3959698,761,1052324,5012022,03/15/2016
2006,Greenwood Lake,335411,1629,1328864,237,362101,1690965,03/15/2016
2006,Florida,335415,1135,927712,247,378891,1306603,03/15/2016
2006,Albion,342001,2408,1557319,791,831036,2388355,03/15/2016
2006,Kendall,343007,1279,941331,286,374987,1316318,03/15/2016
2006,Holley,343204,1532,1456719,425,694261,2150980,03/15/2016
2006,Medina,343401,2091,1580484,750,945578,2526062,03/15/2016
2006,Lyndonville,343801,980,657460,315,365167,1022627,03/15/2016
2006,Fulton,350400,3737,2949427,1197,1441664,4391091,03/15/2016
2006,Oswego,351200,5253,4058590,1663,1936566,5995156,03/15/2016
2006,Altmar Parish-Williamstown,352002,1668,1078235,412,415947,1494182,03/15/2016
2006,Hannibal,353001,1774,1318462,392,491414,1809876,03/15/2016
2006,Central Square,353201,5765,3445024,1268,1405788,4850812,03/15/2016
2006,Mexico,353401,2936,1908451,659,728806,2637257,03/15/2016
2006,Pulaski,355001,1226,811038,316,351497,1162535,03/15/2016
2006,Sandy Creek,355201,1200,832776,387,400469,1233245,03/15/2016
2006,Phoenix,355401,2801,2295806,685,941119,3236925,03/15/2016
2006,Oneonta,361200,2667,1837766,795,930842,2768608,03/15/2016
2006,Gilbertsville-Mt Upton,362202,684,324443,236,188698,513141,03/15/2016
2006,Cherry Valley-Springfield,362401,858,434404,373,313470,747874,03/15/2016
2006,Edmeston,362801,597,286819,202,171496,458315,03/15/2016
2006,Laurens,363401,569,346099,181,190975,537074,03/15/2016
2006,Schenevus,363601,566,392331,220,252601,644932,03/15/2016
2006,Milford,364001,635,391357,261,285383,676740,03/15/2016
2006,Morris,364201,562,372604,232,268902,641506,03/15/2016
2006,Otego-Unadilla,364801,1412,933755,530,582732,1516487,03/15/2016
2006,Cooperstown,365001,1294,611913,457,385929,997842,03/15/2016
2006,Richfield Springs,365601,807,334742,386,282328,617070,03/15/2016
2006,Worcester,366606,505,300945,211,219836,520781,03/15/2016
2006,Mahopac,372001,6231,6812983,812,1666126,8479109,03/15/2016
2006,Carmel,372002,6816,8069985,890,1968801,10038786,03/15/2016
2006,Haldane,372601,1083,1037516,238,397898,1435414,03/15/2016
2006,Garrison,372604,559,326889,71,78628,405517,03/15/2016
2006,Putnam Valley,372803,2734,3803785,311,789319,4593104,03/15/2016
2006,Brewster,373001,5004,5195497,774,1542057,6737554,03/15/2016
2006,Rensselaer,381400,1291,871330,398,408970,1280300,03/15/2016
2006,Troy,381700,4265,3206945,1351,1594733,4801678,03/15/2016
2006,Lansingburgh,381701,2667,1870569,876,988268,2858837,03/15/2016
2006,Berlin,382001,1566,943704,420,429284,1372988,03/15/2016
2006,Brunswick,382202,1825,1252473,476,554656,1807129,03/15/2016
2006,East Greenbush,382401,6852,4988948,1471,1890559,6879507,03/15/2016
2006,Hoosick Falls,382801,1658,1062412,596,598898,1661310,03/15/2016
2006,North Greenbush,383201,354,95982,128,63672,159654,03/15/2016
2006,Wynantskill,383204,851,604728,282,359211,963939,03/15/2016
2006,Averill Park,384001,4578,2970632,928,1060295,4030927,03/15/2016
2006,Hoosic Valley,384201,1540,1055065,389,457311,1512376,03/15/2016
2006,Schodack,384401,1507,1134547,318,427827,1562374,03/15/2016
2006,Clarkstown,392001,11803,10102097,1760,2853850,12955947,03/15/2016
2006,Nanuet,392008,2406,2168279,578,970041,3138320,03/15/2016
2006,Haverstraw-Stony Point,392201,8342,14039109,1775,5101622,19140731,03/15/2016
2006,South Orangetown,392401,4343,4472897,984,1914152,6387049,03/15/2016
2006,Nyack,392404,4104,4895039,815,1911950,6806989,03/15/2016
2006,Pearl River,392408,3123,3550697,717,1539627,5090324,03/15/2016
2006,Ramapo,392601,6004,9626682,1106,3235426,12862108,03/15/2016
2006,East Ramapo,392602,12319,13416555,1691,3184243,16600798,03/15/2016
2006,Ogdensburg,401200,2211,1409663,666,563382,1973045,03/15/2016
2006,Brasher Falls,402001,1349,881993,422,411822,1293815,03/15/2016
2006,Canton,402201,1791,1118014,471,484082,1602096,03/15/2016
2006,Clifton-Fine,402601,481,216794,259,154165,370959,03/15/2016
2006,Colton-Pierrepont,402801,617,267689,224,148257,415946,03/15/2016
2006,Edwards-Knox,403401,743,267039,220,118363,385402,03/15/2016
2006,Gouverneur,404001,2010,942220,589,397812,1340032,03/15/2016
2006,Hammond,404201,394,166643,153,100525,267168,03/15/2016
2006,Hermon-Dekalb,404401,574,359648,170,163386,523034,03/15/2016
2006,Lisbon,405002,825,506246,238,230960,737206,03/15/2016
2006,Madrid-Waddington,405601,1012,619431,306,296868,916299,03/15/2016
2006,Massena,405801,3449,2184669,1350,1414189,3598858,03/15/2016
2006,Morristown,406001,618,367935,214,210509,578444,03/15/2016
2006,Norwood-Norfolk,406201,1436,1057463,459,514592,1572055,03/15/2016
2006,Heuvelton,406404,861,575800,245,263338,839138,03/15/2016
2006,Parishville-Hopkinton,406601,680,309808,175,113572,423380,03/15/2016
2006,Potsdam,407402,1921,1505687,534,670710,2176397,03/15/2016
2006,Mechanicville,411000,1469,869454,583,638971,1508425,03/15/2016
2006,Saratoga Springs,411500,9462,4712536,1666,1545811,6258347,03/15/2016
2006,Burnt Hills-Ballston Lake,412001,4870,3373249,1119,1449315,4822564,03/15/2016
2006,Shenendehowa,412402,13602,8459026,1941,2254898,10713924,03/15/2016
2006,Corinth,412601,1524,841029,501,446111,1287140,03/15/2016
2006,Edinburg,413001,357,74969,152,54401,129370,03/15/2016
2006,Galway,413201,1648,882801,365,334996,1217797,03/15/2016
2006,Ballston Spa,414201,5407,4384839,1006,1327020,5711859,03/15/2016
2006,South Glens Falls,414401,3716,2826558,1064,1301904,4128462,03/15/2016
2006,Schuylerville,415001,2264,2038983,474,698071,2737054,03/15/2016
2006,Stillwater,415201,1650,837139,375,343879,1181018,03/15/2016
2006,Waterford-Halfmoon,415401,984,767368,421,561247,1328615,03/15/2016
2006,Schenectady,421500,7922,7111622,2638,3529851,10641473,03/15/2016
2006,Duanesburg,422001,1303,798892,220,245210,1044102,03/15/2016
2006,Scotia-Glenville,422202,4242,3192586,1089,1488912,4681498,03/15/2016
2006,Niskayuna,422401,6189,3967859,905,1089343,5057202,03/15/2016
2006,Schalmont,422801,3329,2357140,880,1110975,3468115,03/15/2016
2006,Rotterdam-Mohonasen,422803,4772,3016392,1883,2114244,5130636,03/15/2016
2006,Cobleskill-Richmondville,432602,2425,1635246,815,910650,2545896,03/15/2016
2006,Gilboa-Conesville,433401,538,266458,262,203203,469661,03/15/2016
2006,Jefferson,433601,437,230967,152,133221,364188,03/15/2016
2006,Middleburgh,433801,1259,895512,464,540819,1436331,03/15/2016
2006,Schoharie,434201,1480,980540,448,511728,1492268,03/15/2016
2006,Sharon Springs,434601,425,313860,154,186315,500175,03/15/2016
2006,Odessa-Montour,442001,1227,832744,395,443419,1276163,03/15/2016
2006,Watkins Glen,442401,1783,856536,708,566299,1422835,03/15/2016
2006,South Seneca,452801,1339,795213,484,472097,1267310,03/15/2016
2006,Romulus,453003,740,503083,213,257239,760322,03/15/2016
2006,Seneca Falls,453201,1979,1589784,728,1012607,2602391,03/15/2016
2006,Waterloo,453801,2187,1548024,827,989615,2537639,03/15/2016
2006,Corning,460300,7057,5095937,2154,2472691,7568628,03/15/2016
2006,Hornell,460600,1759,1074680,693,606310,1680990,03/15/2016
2006,Addison,462001,1431,1009925,425,415658,1425583,03/15/2016
2006,Avoca,462201,782,393964,254,195357,589321,03/15/2016
2006,Bath,462402,1810,950276,649,602482,1552758,03/15/2016
2006,Bradford,462601,448,305722,143,156584,462306,03/15/2016
2006,Campbell-Savona,463002,1215,887834,347,423266,1311100,03/15/2016
2006,Canisteo-Greenwood,463202,1318,698193,505,387442,1085635,03/15/2016
2006,Arkport,465201,660,482091,282,333005,815096,03/15/2016
2006,Jasper-Troupsburg,465601,604,292174,203,152982,445156,03/15/2016
2006,Prattsburgh,466001,644,327511,191,156727,484238,03/15/2016
2006,Hammondsport,467201,1052,484646,416,319233,803879,03/15/2016
2006,Wayland-Cohocton,467401,2092,1077826,627,516959,1594785,03/15/2016
2006,Babylon,472001,2646,3201772,387,849192,4050964,03/15/2016
2006,West Babylon,472002,5340,5887193,1046,2098395,7985588,03/15/2016
2006,North Babylon,472003,6319,6822078,1478,2936062,9758140,03/15/2016
2006,Lindenhurst,472004,8124,9396990,1788,3786581,13183571,03/15/2016
2006,Copiague,472005,5017,5728723,1121,2243661,7972384,03/15/2016
2006,Amityville,472006,3884,4384210,747,1434952,5819162,03/15/2016
2006,Deer Park,472007,5012,5954938,1433,3134462,9089400,03/15/2016
2006,Wyandanch,472009,1092,1178849,175,336475,1515324,03/15/2016
2006,Three Village,472201,9130,9605456,1399,2697804,12303260,03/15/2016
2006,Brookhaven-Comsewogue,472203,4404,4488593,793,1440183,5928776,03/15/2016
2006,South Country,472204,4901,4943215,714,1294929,6238144,03/15/2016
2006,Sachem,472205,17118,16744232,2418,4283344,21027576,03/15/2016
2006,Port Jefferson,472206,1595,1004164,220,256754,1260918,03/15/2016
2006,Mount Sinai,472207,2811,3129762,372,760525,3890287,03/15/2016
2006,Miller Place,472208,3652,3919377,367,720769,4640146,03/15/2016
2006,Rocky Point,472209,3800,4348818,478,966995,5315813,03/15/2016
2006,Middle Country,472211,11471,11814130,2079,3878608,15692738,03/15/2016
2006,Longwood,472212,11932,13066074,3093,5592127,18658201,03/15/2016
2006,Patchogue-Medford,472224,8960,8719118,1612,2734204,11453322,03/15/2016
2006,William Floyd,472232,8945,9835228,1258,2388739,12223967,03/15/2016
2006,Center Moriches,472233,1603,1965230,254,558997,2524227,03/15/2016
2006,East Moriches,472234,1230,1341226,171,345083,1686309,03/15/2016
2006,Eastport- South Manor,472235,4075,4363653,811,1443920,5807573,03/15/2016
2006,East Hampton,472401,1250,284122,370,170955,455077,03/15/2016
2006,Wainscott,472402,128,9590,25,4098,13688,03/15/2016
2006,Amagansett,472403,254,29074,97,23951,53025,03/15/2016
2006,Springs,472404,906,307538,293,216286,523824,03/15/2016
2006,Sag Harbor,472405,1190,401628,527,372217,773845,03/15/2016
2006,Montauk,472406,678,109630,256,113935,223565,03/15/2016
2006,Elwood,472601,3179,2817299,598,1035304,3852603,03/15/2016
2006,Cold Spring Harbor,472602,2130,1707470,147,230044,1937514,03/15/2016
2006,Huntington,472603,7633,6903643,1251,2171839,9075482,03/15/2016
2006,Northport-East Northport,472604,8920,6362648,1533,2136820,8499468,03/15/2016
2006,Half Hollow Hills,472605,11066,8355714,1633,2241912,10597626,03/15/2016
2006,Harborfields,472606,4693,4288994,704,1256084,5545078,03/15/2016
2006,Commack,472610,9233,9124129,1799,3400618,12524747,03/15/2016
2006,South Huntington,472613,8681,8135740,1755,3206483,11342223,03/15/2016
2006,Bay Shore,472801,5628,6093540,1040,2093403,8186943,03/15/2016
2006,Islip,472802,3874,3977544,681,1272257,5249801,03/15/2016
2006,East Islip,472803,5524,5964966,1026,2280103,8245069,03/15/2016
2006,Sayville,472804,4004,4374471,797,1616789,5991260,03/15/2016
2006,Bayport-Blue Point,472805,2981,3385391,507,1091061,4476452,03/15/2016
2006,Hauppauge,472806,5083,2917183,969,1028750,3945933,03/15/2016
2006,Connetquot,472807,8612,8714961,1489,2775253,11490214,03/15/2016
2006,West Islip,472809,6471,6559836,1252,2404430,8964266,03/15/2016
2006,Brentwood,472812,9207,6571804,1951,2632075,9203879,03/15/2016
2006,Central Islip,472813,5368,6654489,834,1916832,8571321,03/15/2016
2006,Fire Island,472814,98,10890,18,3766,14656,03/15/2016
2006,Shoreham-Wading River,473001,3075,2664606,769,1127642,3792248,03/15/2016
2006,Riverhead,473002,6615,5358858,2596,3157660,8516518,03/15/2016
2006,Shelter Island,473201,582,127046,236,98019,225065,03/15/2016
2006,Smithtown,473401,13612,13687770,2402,4306775,17994545,03/15/2016
2006,Kings Park,473405,5368,4602164,920,1473388,6075552,03/15/2016
2006,Remsenburg-Speonk,473601,409,138230,87,59643,197873,03/15/2016
2006,Westhampton Beach,473602,902,335450,236,172216,507666,03/15/2016
2006,Quogue,473603,236,30045,46,11712,41757,03/15/2016
2006,Hampton Bays,473605,2032,1325203,739,986860,2312063,03/15/2016
2006,Southhampton,473606,1670,307230,624,229325,536555,03/15/2016
2006,Bridgehampton,473609,283,21960,97,15469,37429,03/15/2016
2006,Sagaponack,473610,74,2225,12,742,2967,03/15/2016
2006,Tuckahoe Common,473613,495,215533,184,163737,379270,03/15/2016
2006,East Quogue,473617,1012,619464,328,355439,974903,03/15/2016
2006,Oysterponds,473802,372,104719,186,98320,203039,03/15/2016
2006,Fishers Island,473804,42,11445,6,3073,14518,03/15/2016
2006,Southold,473805,1499,811077,592,598055,1409132,03/15/2016
2006,Greenport,473810,621,360291,301,332828,693119,03/15/2016
2006,Mattituck-Cutchogue,473812,2145,1215123,711,753758,1968881,03/15/2016
2006,New Suffolk,473815,74,15292,37,14094,29386,03/15/2016
2006,Fallsburg,482801,1211,1186448,319,520334,1706782,03/15/2016
2006,Eldred,483401,1073,661223,387,430490,1091713,03/15/2016
2006,Liberty,483601,1456,1313175,564,882473,2195648,03/15/2016
2006,Tri-Valley,484201,1260,911048,330,382817,1293865,03/15/2016
2006,Roscoe,484401,351,178564,176,152816,331380,03/15/2016
2006,Livingston Manor,484402,616,321027,261,223243,544270,03/15/2016
2006,Monticello,484601,3204,2043676,1065,1164667,3208343,03/15/2016
2006,Sullivan West,484802,2110,1247488,909,937977,2185465,03/15/2016
2006,Waverly,492001,1812,1081826,624,609002,1690828,03/15/2016
2006,Candor,492401,1032,681049,333,372614,1053663,03/15/2016
2006,Newark Valley,492602,1701,1268728,527,673484,1942212,03/15/2016
2006,Owego-Apalachin,493001,2946,2116285,1019,1236612,3352897,03/15/2016
2006,Spencer-Van Etten,493401,1311,803825,391,400075,1203900,03/15/2016
2006,Tioga,493603,1185,459889,360,233917,693806,03/15/2016
2006,Ithaca,500700,8228,4747928,1602,1488665,6236593,03/15/2016
2006,Dryden,502401,2473,1874084,548,638651,2512735,03/15/2016
2006,Groton,502801,1325,842806,314,324296,1167102,03/15/2016
2006,Lansing,503201,1677,978877,320,327188,1306065,03/15/2016
2006,Newfield,503401,1034,669197,275,239608,908805,03/15/2016
2006,Trumansburg,503601,1714,1216307,389,446348,1662655,03/15/2016
2006,Kingston,510800,8413,5696975,2860,3489606,9186581,03/15/2016
2006,Highland,513203,2346,1666794,533,688404,2355198,03/15/2016
2006,Rondout Valley,513401,3703,2929910,972,1327322,4257232,03/15/2016
2006,Marlboro,513601,2288,1376666,503,534131,1910797,03/15/2016
2006,New Paltz,513801,3212,2195673,632,799345,2995018,03/15/2016
2006,Onteora,514001,3382,1725517,1156,1043781,2769298,03/15/2016
2006,Saugerties,514801,4351,2795531,1245,1433484,4229015,03/15/2016
2006,Wallkill,515201,3857,2996992,887,1007216,4004208,03/15/2016
2006,Ellenville,515602,1662,1390978,571,686982,2077960,03/15/2016
2006,Glens Falls,520500,2781,1948339,835,1012516,2960855,03/15/2016
2006,Bolton,522001,407,89675,139,55495,145170,03/15/2016
2006,Lake George,522201,1523,382519,436,199211,581730,03/15/2016
2006,North Warren,522402,1021,352950,427,256714,609664,03/15/2016
2006,Johnsburg,523001,568,330531,241,243103,573634,03/15/2016
2006,Hadley-Luzerne,523201,1274,512654,535,369307,881961,03/15/2016
2006,Queensbury,523402,4441,2723863,1049,1127241,3851104,03/15/2016
2006,Glens Falls Common,523418,252,138210,99,88652,226862,03/15/2016
2006,Warrensburg,524001,1246,761851,417,433490,1195341,03/15/2016
2006,Argyle,532001,905,599681,251,284238,883919,03/15/2016
2006,Fort Ann,532802,765,725952,214,349042,1074994,03/15/2016
2006,Fort Edward,533001,529,488434,208,336506,824940,03/15/2016
2006,Granville,533201,1513,1032010,484,551381,1583391,03/15/2016
2006,Greenwich,533401,1437,1025663,469,599672,1625335,03/15/2016
2006,Hartford,533801,712,517826,167,211679,729505,03/15/2016
2006,Hudson Falls,534401,2600,1759435,948,1107297,2866732,03/15/2016
2006,Putnam,534601,168,43053,52,23922,66975,03/15/2016
2006,Salem,534801,853,511424,315,332509,843933,03/15/2016
2006,Cambridge,535010,1302,783129,515,533996,1317125,03/15/2016
2006,Whitehall,535201,908,442869,382,280185,723054,03/15/2016
2006,Newark,542001,2798,2127507,927,1236269,3363776,03/15/2016
2006,Clyde-Savannah,542401,1154,887779,434,533930,1421709,03/15/2016
2006,Lyons,542801,1179,739872,426,423745,1163617,03/15/2016
2006,Gananda,543002,1439,1252324,109,175460,1427784,03/15/2016
2006,Marion,543201,1353,1020607,293,389077,1409684,03/15/2016
2006,Wayne,543401,3692,2408225,684,814564,3222789,03/15/2016
2006,Palmyra-Macedon,543601,2625,2125075,696,980180,3105255,03/15/2016
2006,Sodus,544201,1597,1008200,544,558079,1566279,03/15/2016
2006,Williamson,544602,1537,1154598,408,563713,1718311,03/15/2016
2006,North Rose-Wolcott,544801,1921,1112001,715,665931,1777932,03/15/2016
2006,Red Creek,544803,1196,602875,394,326329,929204,03/15/2016
2006,Mount Vernon,550800,5233,13408785,1494,6056601,19465386,03/15/2016
2006,New Rochelle,551000,9188,18826381,1535,5734868,24561249,03/15/2016
2006,Peekskill,551200,3311,7848895,601,2224359,10073254,03/15/2016
2006,Rye,551400,2889,3668785,316,848972,4517757,03/15/2016
2006,White Plains,551700,6937,15049661,1117,3875610,18925271,03/15/2016
2006,Yonkers,551800,17150,27492572,4604,11301332,38793904,03/15/2016
2006,Katonah-Lewisboro,552001,5028,8230726,459,1441911,9672637,03/15/2016
2006,Bedford,552002,5061,5900991,641,1357338,7258329,03/15/2016
2006,Croton-Harmon,552202,2291,5089283,291,1087027,6176310,03/15/2016
2006,Hendrick Hudson,552203,3447,6131804,501,1361536,7493340,03/15/2016
2006,Eastchester,552401,3032,6835052,680,2503453,9338505,03/15/2016
2006,Tuckahoe,552402,1198,2355571,232,762459,3118030,03/15/2016
2006,Bronxville,552403,1171,2580186,65,433124,3013310,03/15/2016
2006,Tarrytowns,552601,2449,5221205,459,1712632,6933837,03/15/2016
2006,Irvington,552602,1813,3991845,214,922399,4914244,03/15/2016
2006,Dobbs Ferry,552603,1514,4081857,215,1058760,5140617,03/15/2016
2006,Hastings On Hudson,552604,1673,4523283,308,1449114,5972397,03/15/2016
2006,Ardsley,552605,2520,4944436,345,1265895,6210331,03/15/2016
2006,Edgemont,552606,1694,3967249,115,510323,4477572,03/15/2016
2006,Greenburgh,552607,4216,7252940,887,2436452,9689392,03/15/2016
2006,Elmsford,552609,1325,2221002,315,965429,3186431,03/15/2016
2006,Harrison,552801,3691,3711221,682,1235730,4946951,03/15/2016
2006,Mamaroneck,553201,4912,7159299,666,1873450,9032749,03/15/2016
2006,Mount Pleasant,553401,2715,4209600,674,1992423,6202023,03/15/2016
2006,Pocantico Hills,553402,470,393227,91,133689,526916,03/15/2016
2006,Valhalla,553405,1825,3304634,401,1365304,4669938,03/15/2016
2006,Pleasantville,553409,1958,4127053,328,1193751,5320804,03/15/2016
2006,Chappaqua,553604,4408,7223950,212,713836,7937786,03/15/2016
2006,Byram Hills,553801,3008,3714034,224,589531,4303565,03/15/2016
2006,North Salem,554001,1902,2782647,218,555765,3338412,03/15/2016
2006,Ossining,554201,5726,12282444,793,2982945,15265389,03/15/2016
2006,Briarcliff Manor,554202,1702,3815474,108,463696,4279170,03/15/2016
2006,Pelham,554401,2501,4224861,316,960320,5185181,03/15/2016
2006,Rye Neck,554801,1560,2345133,296,811023,3156156,03/15/2016
2006,Port Chester-Rye,554804,2835,4313624,901,2347891,6661515,03/15/2016
2006,Blind Brook-Rye,554805,1677,2433958,176,482714,2916672,03/15/2016
2006,Scarsdale,555001,4642,6254857,219,596632,6851489,03/15/2016
2006,Somers,555201,5071,7296117,1204,3164892,10461009,03/15/2016
2006,Lakeland,555401,8450,18756942,1624,5257123,24014065,03/15/2016
2006,Yorktown,555402,5132,10218855,641,2313137,12531992,03/15/2016
2006,Attica,562201,2302,1249432,640,639093,1888525,03/15/2016
2006,Letchworth,562601,1418,720024,396,342971,1062995,03/15/2016
2006,Wyoming,563802,446,243893,92,90270,334163,03/15/2016
2006,Perry,564201,1249,729922,426,439676,1169598,03/15/2016
2006,Warsaw,564801,1386,920986,388,466570,1387556,03/15/2016
2006,Penn Yan,573001,2897,1248688,1139,850614,2099302,03/15/2016
2006,Dundee,573401,1181,561836,461,348011,909847,03/15/2016
2006,New York City School,650000,607892,126551201,95158,34854135,161405336,03/15/2016
2005,Albany,010100,9870,6621000,3561,3641348,10262348,03/15/2016
2005,Cohoes,010300,1985,1688121,834,1045119,2733240,03/15/2016
2005,Watervliet,011800,1267,669638,532,431648,1101286,03/15/2016
2005,Berne-Knox-Westerlo,012001,1637,1163521,351,384450,1547971,03/15/2016
2005,Bethlehem,012206,6821,5136686,1229,1521849,6658535,03/15/2016
2005,Ravena-Coeymans-Selkirk,012402,2811,1910516,743,784805,2695321,03/15/2016
2005,South Colonie,012601,8657,4313320,2825,2266562,6579882,03/15/2016
2005,North Colonie,012605,7508,3462218,1730,1302488,4764706,03/15/2016
2005,Menands,012615,380,176578,107,80749,257327,03/15/2016
2005,Maplewood,012622,91,52549,61,55303,107852,03/15/2016
2005,Green Island,012801,265,210888,141,181991,392879,03/15/2016
2005,Guilderland,013002,7312,4693229,1504,1592761,6285990,03/15/2016
2005,Voorheesville,013403,1968,1331013,371,415727,1746740,03/15/2016
2005,Alfred-Almond,022001,852,633732,273,304822,938554,03/15/2016
2005,Andover,023001,485,428102,170,218546,646648,03/15/2016
2005,Genesee Valley,023202,743,346941,363,233820,580761,03/15/2016
2005,Belfast,023401,431,231442,171,123165,354607,03/15/2016
2005,Canaseraga,024002,394,223160,146,116331,339491,03/15/2016
2005,Cuba-Rushford,024801,1331,842339,534,503105,1345444,03/15/2016
2005,Friendship,025001,373,311491,158,170515,482006,03/15/2016
2005,Fillmore,025801,803,387720,263,183881,571601,03/15/2016
2005,Whitesville,026001,240,158530,96,79948,238478,03/15/2016
2005,Scio,026601,500,402970,189,213441,616411,03/15/2016
2005,Wellsville,027001,1680,1091836,804,729525,1821361,03/15/2016
2005,Bolivar-Richburg,027602,995,454106,348,205046,659152,03/15/2016
2005,Binghamton,030200,5857,3884198,2670,2567031,6451229,03/15/2016
2005,Chenango Forks,032001,2215,1617364,609,697239,2314603,03/15/2016
2005,South Mountain-Hickory,032201,138,37508,27,12232,49740,03/15/2016
2005,Harpursville,032601,1146,560821,317,228909,789730,03/15/2016
2005,Susquehanna Valley,032801,2518,2058165,847,1078426,3136591,03/15/2016
2005,Chenango Valley,033001,2663,1959084,1157,1357937,3317021,03/15/2016
2005,Maine-Endwell,033801,3477,3403200,1379,2030063,5433263,03/15/2016
2005,Deposit,034201,703,368304,304,240693,608997,03/15/2016
2005,Whitney Point,034401,1776,1015714,475,409013,1424727,03/15/2016
2005,Union-Endicott,034601,5558,4880646,2418,3293537,8174183,03/15/2016
2005,Johnson City,034602,3047,2380545,1585,1781393,4161938,03/15/2016
2005,Vestal,034801,5781,4663714,1865,2347847,7011561,03/15/2016
2005,Windsor,035001,2140,1485952,694,739931,2225883,03/15/2016
2005,Olean,041200,2826,1729861,1141,913414,2643275,03/15/2016
2005,Salamanca,041600,1121,524212,543,307820,832032,03/15/2016
2005,Allegany-Limestone,042001,1603,901051,534,402763,1303814,03/15/2016
2005,West Valley,042204,523,379098,173,190889,569987,03/15/2016
2005,Ellicottville,043601,730,233099,251,124028,357127,03/15/2016
2005,Franklinville,044001,941,560459,334,267188,827647,03/15/2016
2005,Hinsdale,044601,585,303446,233,167220,470666,03/15/2016
2005,Cattaraugus - Little Valley,046402,1491,815991,510,389637,1205628,03/15/2016
2005,Gowanda,047201,1499,903219,643,583573,1486792,03/15/2016
2005,Portville,047401,1120,734758,384,366714,1101472,03/15/2016
2005,Randolph,047601,1229,538398,418,262528,800926,03/15/2016
2005,Yorkshire-Pioneer,048401,3387,1466105,951,617538,2083643,03/15/2016
2005,Auburn,050100,5306,3363338,2250,2159443,5522781,03/15/2016
2005,Weedsport,052201,1179,849429,343,388034,1237463,03/15/2016
2005,Cato-Meridian,052401,1455,862243,339,300366,1162609,03/15/2016
2005,Southern Cayuga,053001,1267,714652,400,344759,1059411,03/15/2016
2005,Port Byron,053801,1418,978594,458,497160,1475754,03/15/2016
2005,Moravia,054201,1404,731076,376,290373,1021449,03/15/2016
2005,Union Springs,055401,1288,914314,465,502350,1416664,03/15/2016
2005,Dunkirk,060300,2288,1760335,1251,1364906,3125241,03/15/2016
2005,Jamestown,060800,4863,2662686,1853,1394659,4057345,03/15/2016
2005,Southwestern,062201,2263,1491773,787,793373,2285146,03/15/2016
2005,Frewsburg,062401,1057,720221,366,388743,1108964,03/15/2016
2005,Cassadaga Valley,062601,1500,782674,485,378002,1160676,03/15/2016
2005,Chautauqua Lake,062803,1243,387043,415,203684,590727,03/15/2016
2005,Pine Valley,063001,848,610029,284,294977,905006,03/15/2016
2005,Clymer,063201,647,293930,226,167173,461103,03/15/2016
2005,Bemus Point,063601,1174,619045,418,333215,952260,03/15/2016
2005,Falconer,063801,1555,1029662,549,557176,1586838,03/15/2016
2005,Silver Creek,064601,1274,798359,494,470949,1269308,03/15/2016
2005,Forestville,064603,910,507163,301,259381,766544,03/15/2016
2005,Panama,064801,815,458704,240,204941,663645,03/15/2016
2005,Fredonia,065801,2159,1436070,744,817050,2253120,03/15/2016
2005,Brocton,066001,837,689363,290,343126,1032489,03/15/2016
2005,Ripley,066201,439,395429,181,234477,629906,03/15/2016
2005,Sherman,066601,565,310161,149,122504,432665,03/15/2016
2005,Westfield,067201,1088,812145,342,400189,1212334,03/15/2016
2005,Elmira,070400,7683,5110528,3137,3091054,8201582,03/15/2016
2005,Horseheads,073401,5618,3317819,1911,1807033,5124852,03/15/2016
2005,Elmira Heights,073402,1241,823792,585,606102,1429894,03/15/2016
2005,Norwich,081100,2332,1602493,814,795038,2397531,03/15/2016
2005,Afton,082001,840,588227,317,331826,920053,03/15/2016
2005,Bainbridge-Guilford,082201,1151,705963,417,378055,1084018,03/15/2016
2005,Greene,083001,1477,953260,491,490560,1443820,03/15/2016
2005,Unadilla Valley,083803,1122,592215,394,313717,905932,03/15/2016
2005,Georgetown-So Otselic Valley,084401,553,323306,137,110701,434007,03/15/2016
2005,Oxford Academy,084601,1099,712197,397,373539,1085736,03/15/2016
2005,Sherburne-Earlville,085601,1695,1014552,581,518825,1533377,03/15/2016
2005,Plattsburgh,091300,2145,1505411,751,829973,2335384,03/15/2016
2005,Ausable Valley,092201,1947,1237444,660,575442,1812886,03/15/2016
2005,Beekmantown,092401,2744,1571514,748,624085,2195599,03/15/2016
2005,Northeastern Clinton,092801,2036,1340630,573,543049,1883679,03/15/2016
2005,Chazy,093001,720,437895,194,180294,618189,03/15/2016
2005,Northern Adirondack,093601,1409,538787,424,222726,761513,03/15/2016
2005,Peru,094001,2696,1536675,585,501265,2037940,03/15/2016
2005,Saranac,094401,2354,1549664,650,652890,2202554,03/15/2016
2005,Hudson,100600,2060,1267198,992,912330,2179528,03/15/2016
2005,Taconic Hills,102801,2115,914492,790,546253,1460745,03/15/2016
2005,Germantown,103602,887,468477,325,276097,744574,03/15/2016
2005,Chatham,103801,1919,993563,530,473199,1466762,03/15/2016
2005,Kinderhook,104401,2950,1645219,734,646354,2291573,03/15/2016
2005,New Lebanon,104801,891,468916,242,199674,668590,03/15/2016
2005,Cortland,110200,3113,1766913,1109,999552,2766465,03/15/2016
2005,Cincinnatus,112001,735,371299,251,177037,548336,03/15/2016
2005,Mc Graw,112204,759,464289,226,209596,673885,03/15/2016
2005,Homer,113001,2752,1819770,779,807133,2626903,03/15/2016
2005,Marathon,113401,936,635420,287,288188,923608,03/15/2016
2005,Andes,122002,230,91755,154,98693,190448,03/15/2016
2005,Downsville,122401,368,143720,231,133491,277211,03/15/2016
2005,Charlotte Valley,122601,584,269162,249,176980,446142,03/15/2016
2005,Delhi,122801,1247,651874,533,450259,1102133,03/15/2016
2005,Franklin,123201,442,214058,162,124130,338188,03/15/2016
2005,Hancock,123606,454,275686,256,227383,503069,03/15/2016
2005,Margaretville,124601,693,224935,327,171367,396302,03/15/2016
2005,Roxbury,124802,551,318215,265,242494,560709,03/15/2016
2005,Sidney,125001,1429,886470,679,648004,1534474,03/15/2016
2005,Stamford,125201,554,387253,217,232630,619883,03/15/2016
2005,South Kortright,125202,499,252597,244,197693,450290,03/15/2016
2005,Walton,125601,1218,534731,518,357035,891766,03/15/2016
2005,Beacon,130200,3399,2504883,842,1026452,3531335,03/15/2016
2005,Poughkeepsie,131300,2822,1936105,955,1043193,2979298,03/15/2016
2005,Dover,132602,1539,1384635,289,447439,1832074,03/15/2016
2005,Hyde Park,133201,5439,4602556,1437,1895200,6497756,03/15/2016
2005,Northeast,133801,976,660477,296,320987,981464,03/15/2016
2005,Pawling,134001,1819,1425049,341,443838,1868887,03/15/2016
2005,Pine Plains,134201,1815,842182,483,354317,1196499,03/15/2016
2005,Arlington,134601,11169,8741320,1834,2362877,11104197,03/15/2016
2005,Spackenkill,134602,1880,1660503,427,596483,2256986,03/15/2016
2005,Red Hook,134801,2225,1901215,584,812738,2713953,03/15/2016
2005,Rhinebeck,135001,1775,1245906,495,583319,1829225,03/15/2016
2005,Wappingers,135601,14878,8302867,3065,2823488,11126355,03/15/2016
2005,Millbrook,135801,1448,733075,309,264730,997805,03/15/2016
2005,Buffalo,140200,29606,12371584,9943,5297030,17668614,03/15/2016
2005,Lackawanna,140900,2308,679951,1481,581051,1261002,03/15/2016
2005,Tonawanda,141600,3173,1862018,1378,1277626,3139644,03/15/2016
2005,Alden,142001,2714,1605585,838,795182,2400767,03/15/2016
2005,Amherst,142201,5558,3512966,1527,1549934,5062900,03/15/2016
2005,Williamsville,142203,16492,10244283,3692,3627266,13871549,03/15/2016
2005,Sweet Home,142207,5231,2369436,2157,1594421,3963857,03/15/2016
2005,East Aurora,142401,2894,1435649,858,696004,2131653,03/15/2016
2005,Cheektowaga,143001,3593,1923743,1971,1570645,3494388,03/15/2016
2005,Cheektowaga-Maryvale,143002,3521,1950439,2162,1917733,3868172,03/15/2016
2005,Cleveland Hill,143003,2430,1778355,1014,1197262,2975617,03/15/2016
2005,Depew,143007,3388,2304422,1217,1337152,3641574,03/15/2016
2005,Cheektowaga-Sloan,143009,2238,1958397,1505,2117290,4075687,03/15/2016
2005,Clarence,143201,6248,3154385,1378,1026590,4180975,03/15/2016
2005,Springville-Griffith,143801,2972,1839752,867,845151,2684903,03/15/2016
2005,Eden,144001,2346,1210823,670,569067,1779890,03/15/2016
2005,Iroquois,144201,4161,1976353,1230,958755,2935108,03/15/2016
2005,Evans-Brant,144401,4072,2519801,1088,975137,3494938,03/15/2016
2005,Grand Island,144601,4790,3020577,995,1008648,4029225,03/15/2016
2005,Hamburg,144801,5450,2722483,1470,1217555,3940038,03/15/2016
2005,Frontier,144804,7680,3675744,2254,1647250,5322994,03/15/2016
2005,Holland,145001,1655,819547,379,310073,1129620,03/15/2016
2005,Lancaster,145201,9286,4549780,2749,2090613,6640393,03/15/2016
2005,Akron,145601,1921,951318,589,412961,1364279,03/15/2016
2005,North Collins,145801,956,552057,303,275307,827364,03/15/2016
2005,Orchard Park,146001,7516,3975979,1745,1516097,5492076,03/15/2016
2005,Kenmore,146401,14499,9082117,6340,6511493,15593610,03/15/2016
2005,West Seneca,146801,11741,6394719,4834,4156210,10550929,03/15/2016
2005,Crown Point,152203,410,176805,166,109326,286131,03/15/2016
2005,Elizabethtown-Lewis,152401,539,284178,167,137373,421551,03/15/2016
2005,Keene,153001,266,101977,79,49996,151973,03/15/2016
2005,Minerva,153401,224,135449,88,78216,213665,03/15/2016
2005,Moriah,153601,923,517186,482,367680,884866,03/15/2016
2005,Newcomb,153801,124,10546,66,8456,19002,03/15/2016
2005,Lake Placid,154002,1118,395346,325,170955,566301,03/15/2016
2005,Schroon Lake,154601,434,131975,217,103795,235770,03/15/2016
2005,Ticonderoga,154801,1141,387150,473,247064,634214,03/15/2016
2005,Westport,155001,315,177318,132,117834,295152,03/15/2016
2005,Willsboro,155201,537,290702,260,209431,500133,03/15/2016
2005,Tupper Lake,162001,1267,547624,510,296528,844152,03/15/2016
2005,Chateaugay,163401,744,469352,233,206036,675388,03/15/2016
2005,Salmon River,164201,807,356391,305,198493,554884,03/15/2016
2005,Saranac Lake,164601,2206,872086,618,359519,1231605,03/15/2016
2005,Malone,164801,3019,1825336,1085,907932,2733268,03/15/2016
2005,Brushton-Moira,165001,967,530944,334,264648,795592,03/15/2016
2005,St. Regis Falls,165401,459,237560,159,116117,353677,03/15/2016
2005,Gloversville,170500,3157,2151578,1384,1182830,3334408,03/15/2016
2005,Johnstown,170800,2178,1232722,760,637525,1870247,03/15/2016
2005,Broadalbin-Perth,172201,2272,1016810,666,469534,1486344,03/15/2016
2005,Wheelerville,172401,343,173626,142,111489,285115,03/15/2016
2005,Mayfield,173001,1401,859687,488,433016,1292703,03/15/2016
2005,Northville,173201,650,300131,268,192059,492190,03/15/2016
2005,Oppenheim-Ephratah,173401,635,409224,179,162022,571246,03/15/2016
2005,Batavia,180200,3187,2376578,1142,1333723,3710301,03/15/2016
2005,Alexander,182202,1169,885708,338,407085,1292793,03/15/2016
2005,Byron-Bergen,183001,1599,1263133,437,471863,1734996,03/15/2016
2005,Elba,183401,617,578085,178,267778,845863,03/15/2016
2005,Le Roy,183601,1719,1275035,503,595294,1870329,03/15/2016
2005,Oakfield-Alabama,183801,1111,775676,399,435337,1211013,03/15/2016
2005,Pavilion,184001,1140,820244,267,294990,1115234,03/15/2016
2005,Pembroke,184202,1463,964998,446,455494,1420492,03/15/2016
2005,Cairo-Durham,192401,1763,911496,726,583075,1494571,03/15/2016
2005,Catskill,192601,2058,1345183,812,829628,2174811,03/15/2016
2005,Coxsackie-Athens,192801,1892,1169042,609,585872,1754914,03/15/2016
2005,Greenville,193201,1866,1256058,579,618164,1874222,03/15/2016
2005,Hunter-Tannersville,193601,669,259187,299,182198,441385,03/15/2016
2005,Windham-Ashland-Jewett,194601,577,186980,259,134948,321928,03/15/2016
2005,Piseco,202001,91,8183,34,4978,13161,03/15/2016
2005,Indian Lake,202601,329,95544,149,70429,165973,03/15/2016
2005,Inlet,202801,86,11700,44,9920,21620,03/15/2016
2005,Lake Pleasant,203001,188,58327,101,50621,108948,03/15/2016
2005,Long Lake,203201,163,36683,104,36674,73357,03/15/2016
2005,Raquette Lake,203202,25,1152,14,1109,2261,03/15/2016
2005,Wells,203601,221,89606,112,70922,160528,03/15/2016
2005,Little Falls,210900,1224,949838,635,712386,1662224,03/15/2016
2005,West Canada Valley,212402,1017,559942,315,270466,830408,03/15/2016
2005,Frankfort-Schuyler,212602,1356,877991,602,605256,1483247,03/15/2016
2005,Ilion,212801,1632,725967,578,393241,1119208,03/15/2016
2005,Mohawk,212802,1073,646922,438,400071,1046993,03/15/2016
2005,Herkimer,213001,1479,972275,791,745068,1717343,03/15/2016
2005,Dolgeville,213602,1031,494896,428,289430,784326,03/15/2016
2005,Poland,213803,925,452527,297,222703,675230,03/15/2016
2005,Van Hornesville-Owen D. Young,215001,312,189164,120,113878,303042,03/15/2016
2005,Town Of Webb,215401,541,110296,271,89744,200040,03/15/2016
2005,Mount Markham,215601,1488,969184,462,446088,1415272,03/15/2016
2005,Watertown,221800,3590,1511309,1363,847499,2358808,03/15/2016
2005,South Jefferson,222001,2139,975803,529,348970,1324773,03/15/2016
2005,Alexandria,222202,826,329985,281,172477,502462,03/15/2016
2005,Indian River,222401,1639,317751,416,111867,429618,03/15/2016
2005,General Brown,222601,1818,754302,504,312607,1066909,03/15/2016
2005,Thousand Islands,223201,1471,676469,599,426055,1102524,03/15/2016
2005,Belleville-Henderson,223402,686,226192,275,133284,359476,03/15/2016
2005,Sackets Harbor,223801,599,315958,181,147171,463129,03/15/2016
2005,Lyme,224401,542,241622,237,164808,406430,03/15/2016
2005,La Fargeville,224601,598,232808,155,90219,323027,03/15/2016
2005,Carthage,226001,2467,1415793,744,618915,2034708,03/15/2016
2005,Copenhagen,232201,572,225955,141,84071,310026,03/15/2016
2005,Harrisville,232401,550,345285,195,156649,501934,03/15/2016
2005,Lowville,233601,1591,739932,521,349766,1089698,03/15/2016
2005,South Lewis,234001,1503,700251,570,359069,1059320,03/15/2016
2005,Beaver River,234401,1211,461234,376,211217,672451,03/15/2016
2005,Avon,242001,1216,924371,331,393455,1317826,03/15/2016
2005,Caledonia-Mumford,242201,1337,860788,358,372757,1233545,03/15/2016
2005,Geneseo,242601,1367,772438,333,306789,1079227,03/15/2016
2005,Livonia,243401,2623,1669863,568,574083,2243946,03/15/2016
2005,Mount Morris,243601,621,451195,251,276901,728096,03/15/2016
2005,Dansville,243801,2110,1096728,712,544609,1641337,03/15/2016
2005,Dalton-Nunda,244001,1179,837801,338,353016,1190817,03/15/2016
2005,York,245201,1133,681931,309,295706,977637,03/15/2016
2005,Oneida,251200,2816,1662705,939,863552,2526257,03/15/2016
2005,Brookfield,252009,311,152703,84,59927,212630,03/15/2016
2005,Cazenovia,252201,2268,1407514,513,510522,1918036,03/15/2016
2005,De Ruyter,252401,566,358709,178,165819,524528,03/15/2016
2005,Morrisville-Eaton,252601,999,563505,241,202092,765597,03/15/2016
2005,Hamilton,253201,949,558431,253,230896,789327,03/15/2016
2005,Canastota,253601,1977,1298033,667,676300,1974333,03/15/2016
2005,Madison,254001,613,424496,190,188271,612767,03/15/2016
2005,Stockbridge Valley,254601,545,381157,177,182566,563723,03/15/2016
2005,Chittenango,254801,3151,2515054,824,956799,3471853,03/15/2016
2005,Rochester,261400,25801,11146785,5137,3112648,14259433,03/15/2016
2005,Brighton,262001,5288,3931533,985,1181455,5112988,03/15/2016
2005,Gates-Chili,262601,7867,5723077,2796,3276319,8999396,03/15/2016
2005,Greece,262801,18718,13287354,5408,6240817,19528171,03/15/2016
2005,East Irondequoit,263401,6482,5285442,2546,3312222,8597664,03/15/2016
2005,West Irondequoit,263403,6355,5295583,1988,2726475,8022058,03/15/2016
2005,Honeoye Falls-Lima,263601,3290,2341764,516,593280,2935044,03/15/2016
2005,Spencerport,263801,5350,4021361,1277,1572154,5593515,03/15/2016
2005,Hilton,264001,6328,4396378,1234,1391887,5788265,03/15/2016
2005,Penfield,264201,7965,6031000,1598,1964546,7995546,03/15/2016
2005,Fairport,264401,9807,6711572,2109,2315558,9027130,03/15/2016
2005,East Rochester,264413,1684,1301693,668,788432,2090125,03/15/2016
2005,Pittsford,264601,8601,6020987,1101,1269979,7290966,03/15/2016
2005,Churchville-Chili,264801,5694,4271207,1295,1561016,5832223,03/15/2016
2005,Rush-Henrietta,265001,8376,5106732,2126,2121225,7227957,03/15/2016
2005,Brockport,265201,4902,3645628,844,984349,4629977,03/15/2016
2005,Webster,265401,12475,8271867,3164,3436777,11708644,03/15/2016
2005,Wheatland-Chili,265601,1377,1043852,375,441660,1485512,03/15/2016
2005,Amsterdam,270100,4021,2927132,2022,2234603,5161735,03/15/2016
2005,Canajoharie,272201,1233,791413,461,457669,1249082,03/15/2016
2005,Fonda-Fultonville,272801,1862,1241307,577,580904,1822211,03/15/2016
2005,Fort Plain,273001,984,977461,393,570833,1548294,03/15/2016
2005,St. Johnsville,273802,591,374359,278,249900,624259,03/15/2016
2005,Glen Cove,280500,3481,3249301,1123,1857990,5107291,03/15/2016
2005,Long Beach,281000,7078,4924813,1119,1488048,6412861,03/15/2016
2005,Hempstead,282001,2988,4525792,487,1281217,5807009,03/15/2016
2005,Uniondale,282002,4879,4598995,807,1368483,5967478,03/15/2016
2005,East Meadow,282003,10739,12083819,2962,5282743,17366562,03/15/2016
2005,North Bellmore,282004,5795,6331422,1237,2450564,8781986,03/15/2016
2005,Levittown,282005,10853,15248382,2398,6165279,21413661,03/15/2016
2005,Seaford,282006,3870,3794553,850,1461164,5255717,03/15/2016
2005,Bellmore,282007,3077,3340846,520,1002000,4342846,03/15/2016
2005,Roosevelt,282008,2192,2507782,325,674300,3182082,03/15/2016
2005,Freeport,282009,5707,7614786,975,2288887,9903673,03/15/2016
2005,Baldwin,282010,7235,9260197,1121,2511973,11772170,03/15/2016
2005,Oceanside,282011,8474,8044779,1728,2926581,10971360,03/15/2016
2005,Malverne,282012,3008,3530859,620,1351619,4882478,03/15/2016
2005,Valley Stream 13,282013,5857,6942379,1538,3085526,10027905,03/15/2016
2005,Hewlett-Woodmere,282014,4732,5928336,685,1457953,7386289,03/15/2016
2005,Lawrence,282015,6188,4765814,953,1407655,6173469,03/15/2016
2005,Elmont,282016,7704,7842836,1642,3036804,10879640,03/15/2016
2005,Franklin Square,282017,4916,4433985,1495,2414721,6848706,03/15/2016
2005,Garden City,282018,5569,3612607,779,900594,4513201,03/15/2016
2005,East Rockaway,282019,2026,2410969,516,1083758,3494727,03/15/2016
2005,Lynbrook,282020,3772,4214255,804,1626109,5840364,03/15/2016
2005,Rockville Centre,282021,4747,4513371,733,1312063,5825434,03/15/2016
2005,Floral Park-Bellerose,282022,4060,3518134,877,1355413,4873547,03/15/2016
2005,Wantagh,282023,4287,4766449,749,1502595,6269044,03/15/2016
2005,Valley Stream 24,282024,2406,2476250,587,1067567,3543817,03/15/2016
2005,Merrick,282025,4626,4728859,581,1030340,5759199,03/15/2016
2005,Island Trees,282026,3252,3541311,772,1540290,5081601,03/15/2016
2005,West Hempstead,282027,3471,3881067,705,1423162,5304229,03/15/2016
2005,North Merrick,282029,3237,3661886,709,1460468,5122354,03/15/2016
2005,Valley Stream 30,282030,2836,2497851,617,1007134,3504985,03/15/2016
2005,Island Park,282031,1491,1132667,314,406038,1538705,03/15/2016
2005,Westbury,282201,2976,4274894,667,1621297,5896191,03/15/2016
2005,East Williston,282202,2018,1937662,227,391538,2329200,03/15/2016
2005,Roslyn,282203,4085,3834323,388,691479,4525802,03/15/2016
2005,Port Washington,282204,5582,4087475,735,955228,5042703,03/15/2016
2005,New Hyde Park-Garden City,282205,4449,3589212,1288,1888619,5477831,03/15/2016
2005,Manhasset,282206,3746,2138267,361,394001,2532268,03/15/2016
2005,Great Neck,282207,9052,4994299,1085,1054038,6048337,03/15/2016
2005,Herricks,282209,5780,5037527,1076,1847124,6884651,03/15/2016
2005,Mineola,282210,4236,3448040,1186,1784035,5232075,03/15/2016
2005,Carle Place,282211,1806,1665193,482,800522,2465715,03/15/2016
2005,North Shore,282401,3605,2514334,609,759660,3273994,03/15/2016
2005,Syosset,282402,8109,7832355,1217,1741654,9574009,03/15/2016
2005,Locust Valley,282403,3267,2144365,487,619308,2763673,03/15/2016
2005,Plainview-Old Bethpage,282404,7159,7318883,1352,2554993,9873876,03/15/2016
2005,Oyster Bay-East Norwich,282406,2633,1619160,396,464853,2084013,03/15/2016
2005,Jericho,282415,3327,2814421,322,495363,3309784,03/15/2016
2005,Hicksville,282417,7640,5652392,2212,2945318,8597710,03/15/2016
2005,Plainedge,282418,4456,5225767,1181,2532122,7757889,03/15/2016
2005,Bethpage,282421,3988,3484246,1467,1704378,5188624,03/15/2016
2005,Farmingdale,282422,8380,10165166,2121,4588895,14754061,03/15/2016
2005,Massapequa,282423,11477,10708543,2466,4308653,15017196,03/15/2016
2005,Lockport,290900,6324,5205430,1816,2083503,7288933,03/15/2016
2005,Niagara Falls,291100,7804,3983782,3861,2780058,6763840,03/15/2016
2005,North Tonawanda,291200,6325,4235933,2343,2512293,6748226,03/15/2016
2005,Lewiston-Porter,292401,4105,2684161,1396,1507059,4191220,03/15/2016
2005,Newfane,292801,2407,2067972,726,938599,3006571,03/15/2016
2005,Niagara-Wheatfield,293001,5007,3093279,1666,1523796,4617075,03/15/2016
2005,Starpoint,293201,3912,2650458,917,1006929,3657387,03/15/2016
2005,Royalton-Hartland,293601,2060,1493157,585,680862,2174019,03/15/2016
2005,Barker,293801,1130,654032,330,298017,952049,03/15/2016
2005,Wilson,294201,1882,1464756,551,686394,2151150,03/15/2016
2005,Rome,301300,6038,4613685,2638,2888820,7502505,03/15/2016
2005,Utica,301600,7735,5369701,3821,3724365,9094066,03/15/2016
2005,Adirondack,302601,1940,1054511,613,460068,1514579,03/15/2016
2005,Camden,303001,2879,1630250,860,673989,2304239,03/15/2016
2005,Clinton,304001,1952,1633251,599,685462,2318713,03/15/2016
2005,New Hartford,304801,3695,2567972,1254,1335486,3903458,03/15/2016
2005,New York Mills,304804,792,539183,498,546041,1085224,03/15/2016
2005,Sauquoit Valley,305002,1405,900362,414,413420,1313782,03/15/2016
2005,Remsen,305201,773,510750,217,211909,722659,03/15/2016
2005,Waterville,305401,1132,705319,352,333858,1039177,03/15/2016
2005,Holland Patent,305801,2205,1482164,584,604494,2086658,03/15/2016
2005,Sherrill,306000,2687,1893303,903,988958,2882261,03/15/2016
2005,Westmoreland,306801,1482,1438332,523,698966,2137298,03/15/2016
2005,Oriskany,307001,925,708351,318,374602,1082953,03/15/2016
2005,Whitesboro,307002,4930,3383119,1861,2002731,5385850,03/15/2016
2005,Syracuse,311500,16131,7807316,5323,3902474,11709790,03/15/2016
2005,West Genesee,312001,7088,5220915,2699,3131423,8352338,03/15/2016
2005,North Syracuse,312403,13902,9403778,3454,3410163,12813941,03/15/2016
2005,East Syracuse-Minoa,312601,4999,3751569,1805,1996903,5748472,03/15/2016
2005,Jamesville-Dewitt,312611,4068,2611128,860,892167,3503295,03/15/2016
2005,Jordan-Elbridge,312801,1769,1498117,520,617860,2115977,03/15/2016
2005,Fabius-Pompey,313001,1123,1036452,270,386441,1422893,03/15/2016
2005,Westhill,313201,2662,2181876,933,1263358,3445234,03/15/2016
2005,Solvay,313202,1813,1565994,978,1305133,2871127,03/15/2016
2005,La Fayette,313407,1068,679108,269,257207,936315,03/15/2016
2005,Baldwinsville,313601,8020,6283759,1723,2045237,8328996,03/15/2016
2005,Fayetteville-Manlius,313801,6482,5089108,1049,1330406,6419514,03/15/2016
2005,Marcellus,314001,2570,1690745,705,746209,2436954,03/15/2016
2005,Onondaga,314201,1439,1224126,433,560939,1785065,03/15/2016
2005,Liverpool,314801,10675,8437777,2933,3513180,11950957,03/15/2016
2005,Lyncourt,314804,809,726965,467,590979,1317944,03/15/2016
2005,Skaneateles,315001,2239,1247354,599,541838,1789192,03/15/2016
2005,Tully,315402,1359,873186,295,307614,1180800,03/15/2016
2005,Canandaigua,320200,4313,2521849,1065,993156,3515005,03/15/2016
2005,Geneva,320500,2622,1817790,1140,1189727,3007517,03/15/2016
2005,East Bloomfield,322601,1398,1084612,310,374945,1459557,03/15/2016
2005,Gorham-Middlesex,323201,2151,1169885,594,507121,1677006,03/15/2016
2005,Manchester-Shortsville,323601,1189,984599,393,500366,1484965,03/15/2016
2005,Naples,323801,1353,712123,335,275652,987775,03/15/2016
2005,Phelps-Clifton Springs,324001,2340,1826672,601,746102,2572774,03/15/2016
2005,Honeoye,324201,1558,859979,373,327729,1187708,03/15/2016
2005,Victor,324801,4639,2810777,773,707744,3518521,03/15/2016
2005,Middletown,330900,5270,4559965,1264,1688964,6248929,03/15/2016
2005,Newburgh,331100,9550,8383992,2481,3439692,11823684,03/15/2016
2005,Port Jervis,331300,2683,2860452,897,1452932,4313384,03/15/2016
2005,Washingtonville,332002,5418,4525296,648,917072,5442368,03/15/2016
2005,Chester,332201,1364,1096072,232,301523,1397595,03/15/2016
2005,Cornwall,332401,3479,2790745,555,711149,3501894,03/15/2016
2005,Pine Bush,332601,5899,4179847,950,1091638,5271485,03/15/2016
2005,Goshen,333001,2999,2022180,566,634111,2656291,03/15/2016
2005,Highland Falls,333601,860,541754,244,250765,792519,03/15/2016
2005,Minisink Valley,333801,4554,3524012,673,842449,4366461,03/15/2016
2005,Monroe-Woodbury,334001,8682,7271864,1009,1477150,8749014,03/15/2016
2005,Kiryas Joel Village,334002,852,284607,41,22766,307373,03/15/2016
2005,Valley,334201,5141,3841945,1061,1280139,5122084,03/15/2016
2005,Tuxedo,335003,558,182273,86,53167,235440,03/15/2016
2005,Warwick Valley,335401,5195,3951233,793,989751,4940984,03/15/2016
2005,Greenwood Lake,335411,1568,1249032,245,323002,1572034,03/15/2016
2005,Florida,335415,1101,885460,250,334170,1219630,03/15/2016
2005,Albion,342001,2374,1578617,801,772470,2351087,03/15/2016
2005,Kendall,343007,1278,950563,273,322210,1272773,03/15/2016
2005,Holley,343204,1511,1458284,428,642614,2100898,03/15/2016
2005,Medina,343401,2053,1501749,768,866415,2368164,03/15/2016
2005,Lyndonville,343801,958,647330,323,339239,986569,03/15/2016
2005,Fulton,350400,3713,2899785,1188,1306794,4206579,03/15/2016
2005,Oswego,351200,5207,4090679,1686,1975186,6065865,03/15/2016
2005,Altmar Parish-Williamstown,352002,1647,1096934,403,388534,1485468,03/15/2016
2005,Hannibal,353001,1731,1360084,398,470952,1831036,03/15/2016
2005,Central Square,353201,5593,3327321,1274,1107412,4434733,03/15/2016
2005,Mexico,353401,2864,1875783,660,664113,2539896,03/15/2016
2005,Pulaski,355001,1218,764109,321,307955,1072064,03/15/2016
2005,Sandy Creek,355201,1197,774974,408,375926,1150900,03/15/2016
2005,Phoenix,355401,2765,2267366,689,843847,3111213,03/15/2016
2005,Oneonta,361200,2634,1777291,829,905071,2682362,03/15/2016
2005,Gilbertsville-Mt Upton,362202,683,339213,232,171302,510515,03/15/2016
2005,Cherry Valley-Springfield,362401,857,438216,375,288066,726282,03/15/2016
2005,Edmeston,362801,594,274573,201,146487,421060,03/15/2016
2005,Laurens,363401,559,347583,177,173018,520601,03/15/2016
2005,Schenevus,363601,553,372969,206,205580,578549,03/15/2016
2005,Milford,364001,627,388955,266,261902,650857,03/15/2016
2005,Morris,364201,542,355493,228,232871,588364,03/15/2016
2005,Otego-Unadilla,364801,1406,929049,533,513570,1442619,03/15/2016
2005,Cooperstown,365001,1253,612172,469,361411,973583,03/15/2016
2005,Richfield Springs,365601,791,338234,380,261345,599579,03/15/2016
2005,Worcester,366606,509,300814,211,195034,495848,03/15/2016
2005,Mahopac,372001,6119,6964446,806,1522500,8486946,03/15/2016
2005,Carmel,372002,6704,7557528,870,1621808,9179336,03/15/2016
2005,Haldane,372601,1039,972080,241,350258,1322338,03/15/2016
2005,Garrison,372604,543,323961,74,73604,397565,03/15/2016
2005,Putnam Valley,372803,2706,4040729,312,746385,4787114,03/15/2016
2005,Brewster,373001,4940,5309725,791,1442955,6752680,03/15/2016
2005,Rensselaer,381400,1230,847384,386,366081,1213465,03/15/2016
2005,Troy,381700,4244,3262533,1390,1510919,4773452,03/15/2016
2005,Lansingburgh,381701,2632,1905820,894,936844,2842664,03/15/2016
2005,Berlin,382001,1534,953206,423,393297,1346503,03/15/2016
2005,Brunswick,382202,1771,1275314,479,522835,1798149,03/15/2016
2005,East Greenbush,382401,6664,4850704,1521,1752829,6603533,03/15/2016
2005,Hoosick Falls,382801,1616,1025671,569,547395,1573066,03/15/2016
2005,North Greenbush,383201,343,98228,132,61689,159917,03/15/2016
2005,Wynantskill,383204,832,597381,289,334269,931650,03/15/2016
2005,Averill Park,384001,4432,2938553,954,988641,3927194,03/15/2016
2005,Hoosic Valley,384201,1511,1078563,393,427855,1506418,03/15/2016
2005,Schodack,384401,1469,1131736,336,404725,1536461,03/15/2016
2005,Clarkstown,392001,11826,9995495,1767,2493048,12488543,03/15/2016
2005,Nanuet,392008,2389,2059900,603,854427,2914327,03/15/2016
2005,Haverstraw-Stony Point,392201,8127,11348674,1771,3606257,14954931,03/15/2016
2005,South Orangetown,392401,4287,4239612,1023,1682914,5922526,03/15/2016
2005,Nyack,392404,4074,4733024,822,1684442,6417466,03/15/2016
2005,Pearl River,392408,3049,3358918,749,1372791,4731709,03/15/2016
2005,Ramapo,392601,5990,9171413,1145,2890220,12061633,03/15/2016
2005,East Ramapo,392602,12398,14149553,1740,3060814,17210367,03/15/2016
2005,Ogdensburg,401200,2179,1354803,692,540007,1894810,03/15/2016
2005,Brasher Falls,402001,1317,765741,422,347973,1113714,03/15/2016
2005,Canton,402201,1723,1058897,482,446157,1505054,03/15/2016
2005,Clifton-Fine,402601,472,203636,255,136367,340003,03/15/2016
2005,Colton-Pierrepont,402801,603,277343,225,148915,426258,03/15/2016
2005,Edwards-Knox,403401,734,264226,215,106411,370637,03/15/2016
2005,Gouverneur,404001,1971,911049,604,385271,1296320,03/15/2016
2005,Hammond,404201,367,141800,157,87781,229581,03/15/2016
2005,Hermon-Dekalb,404401,552,341519,175,154565,496084,03/15/2016
2005,Lisbon,405002,805,463423,247,206727,670150,03/15/2016
2005,Madrid-Waddington,405601,999,581554,313,266219,847773,03/15/2016
2005,Massena,405801,3388,2108242,1375,1300123,3408365,03/15/2016
2005,Morristown,406001,612,369676,212,192195,561871,03/15/2016
2005,Norwood-Norfolk,406201,1408,1005550,472,475479,1481029,03/15/2016
2005,Heuvelton,406404,853,520849,246,221076,741925,03/15/2016
2005,Parishville-Hopkinton,406601,683,307143,173,100657,407800,03/15/2016
2005,Potsdam,407402,1921,1469718,538,601140,2070858,03/15/2016
2005,Mechanicville,411000,1421,820196,581,549440,1369636,03/15/2016
2005,Saratoga Springs,411500,9327,4770544,1718,1453539,6224083,03/15/2016
2005,Burnt Hills-Ballston Lake,412001,4774,3286316,1111,1261189,4547505,03/15/2016
2005,Shenendehowa,412402,13336,8497241,1942,2044016,10541257,03/15/2016
2005,Corinth,412601,1486,831505,476,388205,1219710,03/15/2016
2005,Edinburg,413001,333,74913,156,53456,128369,03/15/2016
2005,Galway,413201,1605,862341,359,294880,1157221,03/15/2016
2005,Ballston Spa,414201,5255,4288954,1040,1207641,5496595,03/15/2016
2005,South Glens Falls,414401,3595,2664153,1048,1132691,3796844,03/15/2016
2005,Schuylerville,415001,2231,1987132,475,631985,2619117,03/15/2016
2005,Stillwater,415201,1603,849237,376,322872,1172109,03/15/2016
2005,Waterford-Halfmoon,415401,940,755923,474,579975,1335898,03/15/2016
2005,Schenectady,421500,7722,7160511,2898,3934165,11094676,03/15/2016
2005,Duanesburg,422001,1279,786814,220,224662,1011476,03/15/2016
2005,Scotia-Glenville,422202,4131,3154355,1102,1363417,4517772,03/15/2016
2005,Niskayuna,422401,6063,3856074,937,988797,4844871,03/15/2016
2005,Schalmont,422801,3245,2303357,895,1004453,3307810,03/15/2016
2005,Rotterdam-Mohonasen,422803,4641,2901130,1945,1916782,4817912,03/15/2016
2005,Cobleskill-Richmondville,432602,2371,1484647,814,758902,2243549,03/15/2016
2005,Gilboa-Conesville,433401,538,263770,277,191652,455422,03/15/2016
2005,Jefferson,433601,434,231661,146,115583,347244,03/15/2016
2005,Middleburgh,433801,1236,860074,461,471560,1331634,03/15/2016
2005,Schoharie,434201,1454,999940,442,470526,1470466,03/15/2016
2005,Sharon Springs,434601,426,307645,156,163760,471405,03/15/2016
2005,Odessa-Montour,442001,1199,763970,416,398926,1162896,03/15/2016
2005,Watkins Glen,442401,1751,852216,717,521851,1374067,03/15/2016
2005,South Seneca,452801,1288,777261,506,445598,1222859,03/15/2016
2005,Romulus,453003,719,492125,230,246357,738482,03/15/2016
2005,Seneca Falls,453201,1928,1510471,757,915606,2426077,03/15/2016
2005,Waterloo,453801,2162,1492583,837,892513,2385096,03/15/2016
2005,Corning,460300,6976,4840508,2156,2176479,7016987,03/15/2016
2005,Hornell,460600,1745,1069524,719,572225,1641749,03/15/2016
2005,Addison,462001,1418,983126,426,370306,1353432,03/15/2016
2005,Avoca,462201,784,394504,246,170491,564995,03/15/2016
2005,Bath,462402,1790,930507,659,548118,1478625,03/15/2016
2005,Bradford,462601,440,319628,138,151023,470651,03/15/2016
2005,Campbell-Savona,463002,1191,534065,346,234731,768796,03/15/2016
2005,Canisteo-Greenwood,463202,1306,667253,494,328419,995672,03/15/2016
2005,Arkport,465201,653,462702,307,296484,759186,03/15/2016
2005,Jasper-Troupsburg,465601,592,277834,198,130189,408023,03/15/2016
2005,Prattsburgh,466001,641,308300,191,132464,440764,03/15/2016
2005,Hammondsport,467201,1049,482013,407,282049,764062,03/15/2016
2005,Wayland-Cohocton,467401,2083,939603,619,408440,1348043,03/15/2016
2005,Babylon,472001,2608,3182345,396,779054,3961399,03/15/2016
2005,West Babylon,472002,5246,5902861,1064,1934126,7836987,03/15/2016
2005,North Babylon,472003,6215,6804367,1503,2684211,9488578,03/15/2016
2005,Lindenhurst,472004,7960,9192839,1800,3375079,12567918,03/15/2016
2005,Copiague,472005,4890,5509825,1124,1985039,7494864,03/15/2016
2005,Amityville,472006,3785,4693671,724,1395000,6088671,03/15/2016
2005,Deer Park,472007,4918,5830334,1452,2806385,8636719,03/15/2016
2005,Wyandanch,472009,1033,1096158,158,266498,1362656,03/15/2016
2005,Three Village,472201,9170,9399233,1300,2168232,11567465,03/15/2016
2005,Brookhaven-Comsewogue,472203,4438,4531387,775,1269465,5800852,03/15/2016
2005,South Country,472204,4946,4988692,673,1088091,6076783,03/15/2016
2005,Sachem,472205,17177,17347580,2280,3706117,21053697,03/15/2016
2005,Port Jefferson,472206,1617,1021773,213,220950,1242723,03/15/2016
2005,Mount Sinai,472207,2698,3089668,341,638050,3727718,03/15/2016
2005,Miller Place,472208,3581,4039887,337,617521,4657408,03/15/2016
2005,Rocky Point,472209,3776,4364564,475,879512,5244076,03/15/2016
2005,Middle Country,472211,11587,11173931,1983,3102101,14276032,03/15/2016
2005,Longwood,472212,11907,13046363,3008,4902022,17948385,03/15/2016
2005,Patchogue-Medford,472224,9104,8083911,1559,2161822,10245733,03/15/2016
2005,William Floyd,472232,8997,9574262,1260,2083005,11657267,03/15/2016
2005,Center Moriches,472233,1570,1986665,252,507944,2494609,03/15/2016
2005,East Moriches,472234,1202,1134418,169,261848,1396266,03/15/2016
2005,Eastport- South Manor,472235,4025,4365950,798,1286890,5652840,03/15/2016
2005,East Hampton,472401,1276,277385,375,146184,423569,03/15/2016
2005,Wainscott,472402,127,9809,27,4003,13812,03/15/2016
2005,Amagansett,472403,247,29692,101,22946,52638,03/15/2016
2005,Springs,472404,919,314377,292,189883,504260,03/15/2016
2005,Sag Harbor,472405,1170,420220,544,353392,773612,03/15/2016
2005,Montauk,472406,682,106630,265,100671,207301,03/15/2016
2005,Elwood,472601,3156,2838856,600,926835,3765691,03/15/2016
2005,Cold Spring Harbor,472602,2129,1674488,145,194794,1869282,03/15/2016
2005,Huntington,472603,7497,6793757,1319,2036883,8830640,03/15/2016
2005,Northport-East Northport,472604,8862,6301030,1555,1899478,8200508,03/15/2016
2005,Half Hollow Hills,472605,10845,8199299,1541,1868238,10067537,03/15/2016
2005,Harborfields,472606,4660,4325490,702,1118312,5443802,03/15/2016
2005,Commack,472610,9194,9020205,1822,3020162,12040367,03/15/2016
2005,South Huntington,472613,8572,8167496,1816,2967336,11134832,03/15/2016
2005,Bay Shore,472801,5443,5832687,1090,1924095,7756782,03/15/2016
2005,Islip,472802,3822,3721804,673,1068544,4790348,03/15/2016
2005,East Islip,472803,5485,5547339,1021,1887737,7435076,03/15/2016
2005,Sayville,472804,3970,4363965,790,1428796,5792761,03/15/2016
2005,Bayport-Blue Point,472805,2985,3274637,489,890228,4164865,03/15/2016
2005,Hauppauge,472806,5043,2949522,960,918478,3868000,03/15/2016
2005,Connetquot,472807,8525,8634924,1469,2425455,11060379,03/15/2016
2005,West Islip,472809,6412,6520035,1283,2174169,8694204,03/15/2016
2005,Brentwood,472812,9002,6516226,2005,2418913,8935139,03/15/2016
2005,Central Islip,472813,5268,6372622,857,1701967,8074589,03/15/2016
2005,Fire Island,472814,100,10922,13,2334,13256,03/15/2016
2005,Shoreham-Wading River,473001,3059,2805759,762,1057755,3863514,03/15/2016
2005,Riverhead,473002,6416,5380883,2609,2911994,8292877,03/15/2016
2005,Shelter Island,473201,574,128402,233,87538,215940,03/15/2016
2005,Smithtown,473401,13548,13276617,2458,3822042,17098659,03/15/2016
2005,Kings Park,473405,5349,4561874,939,1332063,5893937,03/15/2016
2005,Remsenburg-Speonk,473601,411,140822,87,52522,193344,03/15/2016
2005,Westhampton Beach,473602,882,327004,242,154540,481544,03/15/2016
2005,Quogue,473603,239,25833,50,9790,35623,03/15/2016
2005,Hampton Bays,473605,1977,1281281,754,868539,2149820,03/15/2016
2005,Southhampton,473606,1671,292507,613,193046,485553,03/15/2016
2005,Bridgehampton,473609,284,42740,97,26409,69149,03/15/2016
2005,Sagaponack,473610,76,2254,14,752,3006,03/15/2016
2005,Tuckahoe Common,473613,492,204486,177,132631,337117,03/15/2016
2005,East Quogue,473617,967,701729,308,366355,1068084,03/15/2016
2005,Oysterponds,473802,366,101323,199,91723,193046,03/15/2016
2005,Fishers Island,473804,40,10857,7,3167,14024,03/15/2016
2005,Southold,473805,1488,767779,591,506352,1274131,03/15/2016
2005,Greenport,473810,608,353379,314,306231,659610,03/15/2016
2005,Mattituck-Cutchogue,473812,2119,1167911,750,686733,1854644,03/15/2016
2005,New Suffolk,473815,76,16457,38,13577,30034,03/15/2016
2005,Fallsburg,482801,1151,1134372,348,512055,1646427,03/15/2016
2005,Eldred,483401,1023,614505,387,372032,986537,03/15/2016
2005,Liberty,483601,1417,1289401,564,791232,2080633,03/15/2016
2005,Tri-Valley,484201,1238,882528,327,338869,1221397,03/15/2016
2005,Roscoe,484401,339,173822,186,146211,320033,03/15/2016
2005,Livingston Manor,484402,600,319654,270,212054,531708,03/15/2016
2005,Monticello,484601,3075,1969208,1088,1081493,3050701,03/15/2016
2005,Sullivan West,484802,2069,1245146,912,858144,2103290,03/15/2016
2005,Waverly,492001,1778,921989,639,492062,1414051,03/15/2016
2005,Candor,492401,1003,643160,342,333595,976755,03/15/2016
2005,Newark Valley,492602,1689,1278462,513,596580,1875042,03/15/2016
2005,Owego-Apalachin,493001,2943,2107913,1022,1097377,3205290,03/15/2016
2005,Spencer-Van Etten,493401,1292,777981,382,343606,1121587,03/15/2016
2005,Tioga,493603,1182,486946,354,216883,703829,03/15/2016
2005,Ithaca,500700,8129,4855653,1600,1387831,6243484,03/15/2016
2005,Dryden,502401,2417,1853104,550,572377,2425481,03/15/2016
2005,Groton,502801,1310,861516,312,300022,1161538,03/15/2016
2005,Lansing,503201,1657,995674,310,292236,1287910,03/15/2016
2005,Newfield,503401,1040,702938,252,204640,907578,03/15/2016
2005,Trumansburg,503601,1693,1162740,387,390364,1553104,03/15/2016
2005,Kingston,510800,8317,5832570,2906,3252867,9085437,03/15/2016
2005,Highland,513203,2262,1681935,527,626933,2308868,03/15/2016
2005,Rondout Valley,513401,3630,2955241,1000,1232625,4187866,03/15/2016
2005,Marlboro,513601,2240,1315106,497,459762,1774868,03/15/2016
2005,New Paltz,513801,3167,2137970,621,689933,2827903,03/15/2016
2005,Onteora,514001,3372,1771801,1171,950070,2721871,03/15/2016
2005,Saugerties,514801,4258,2795545,1273,1342732,4138277,03/15/2016
2005,Wallkill,515201,3794,2928584,860,871030,3799614,03/15/2016
2005,Ellenville,515602,1602,1352457,580,641969,1994426,03/15/2016
2005,Glens Falls,520500,2741,1933513,825,898062,2831575,03/15/2016
2005,Bolton,522001,413,91879,143,51310,143189,03/15/2016
2005,Lake George,522201,1483,376223,436,176232,552455,03/15/2016
2005,North Warren,522402,992,355589,424,239505,595094,03/15/2016
2005,Johnsburg,523001,564,334436,240,221191,555627,03/15/2016
2005,Hadley-Luzerne,523201,1277,552024,517,344479,896503,03/15/2016
2005,Queensbury,523402,4340,2713879,1024,993240,3707119,03/15/2016
2005,Glens Falls Common,523418,248,124828,93,69440,194268,03/15/2016
2005,Warrensburg,524001,1184,776740,419,417449,1194189,03/15/2016
2005,Argyle,532001,874,608539,253,272396,880935,03/15/2016
2005,Fort Ann,532802,732,607976,213,272352,880328,03/15/2016
2005,Fort Edward,533001,521,418302,214,274483,692785,03/15/2016
2005,Granville,533201,1463,1033375,505,529850,1563225,03/15/2016
2005,Greenwich,533401,1396,919249,471,492714,1411963,03/15/2016
2005,Hartford,533801,683,492742,177,196034,688776,03/15/2016
2005,Hudson Falls,534401,2540,1693164,935,952081,2645245,03/15/2016
2005,Putnam,534601,161,44779,57,25588,70367,03/15/2016
2005,Salem,534801,844,516197,323,310528,826725,03/15/2016
2005,Cambridge,535010,1274,762011,521,474184,1236195,03/15/2016
2005,Whitehall,535201,879,449476,389,274048,723524,03/15/2016
2005,Newark,542001,2744,2017242,943,1087017,3104259,03/15/2016
2005,Clyde-Savannah,542401,1150,861971,428,467711,1329682,03/15/2016
2005,Lyons,542801,1167,736025,432,387823,1123848,03/15/2016
2005,Gananda,543002,1413,1242437,104,149194,1391631,03/15/2016
2005,Marion,543201,1339,1001281,287,335219,1336500,03/15/2016
2005,Wayne,543401,3634,2448283,652,706065,3154348,03/15/2016
2005,Palmyra-Macedon,543601,2617,2113038,684,847236,2960274,03/15/2016
2005,Sodus,544201,1580,1041406,548,528779,1570185,03/15/2016
2005,Williamson,544602,1534,1174739,412,507811,1682550,03/15/2016
2005,North Rose-Wolcott,544801,1911,1114978,703,595435,1710413,03/15/2016
2005,Red Creek,544803,1186,578381,372,279227,857608,03/15/2016
2005,Mount Vernon,550800,5181,12239864,1538,5470580,17710444,03/15/2016
2005,New Rochelle,551000,9037,17775361,1590,5158851,22934212,03/15/2016
2005,Peekskill,551200,3141,7222579,616,2017709,9240288,03/15/2016
2005,Rye,551400,2817,3565125,346,796149,4361274,03/15/2016
2005,White Plains,551700,6729,13995184,1149,3506498,17501682,03/15/2016
2005,Yonkers,551800,16394,26642745,4947,10800721,37443466,03/15/2016
2005,Katonah-Lewisboro,552001,4911,7954702,476,1317019,9271721,03/15/2016
2005,Bedford,552002,4977,5819707,625,1224209,7043916,03/15/2016
2005,Croton-Harmon,552202,2230,4798784,310,1013730,5812514,03/15/2016
2005,Hendrick Hudson,552203,3389,5749940,509,1189944,6939884,03/15/2016
2005,Eastchester,552401,2968,6451367,705,2268060,8719427,03/15/2016
2005,Tuckahoe,552402,1178,2190915,241,671871,2862786,03/15/2016
2005,Bronxville,552403,1165,2434052,65,395977,2830029,03/15/2016
2005,Tarrytowns,552601,2386,4986008,469,1550299,6536307,03/15/2016
2005,Irvington,552602,1794,3772359,209,783439,4555798,03/15/2016
2005,Dobbs Ferry,552603,1497,3851241,211,890566,4741807,03/15/2016
2005,Hastings On Hudson,552604,1634,4287157,313,1286641,5573798,03/15/2016
2005,Ardsley,552605,2479,4732613,361,1137632,5870245,03/15/2016
2005,Edgemont,552606,1660,3760375,119,459521,4219896,03/15/2016
2005,Greenburgh,552607,4141,6956410,906,2187271,9143681,03/15/2016
2005,Elmsford,552609,1282,2053157,328,850039,2903196,03/15/2016
2005,Harrison,552801,3660,3639260,715,1299615,4938875,03/15/2016
2005,Mamaroneck,553201,4754,6768659,664,1621620,8390279,03/15/2016
2005,Mount Pleasant,553401,2692,4009484,682,1714577,5724061,03/15/2016
2005,Pocantico Hills,553402,470,367066,88,107529,474595,03/15/2016
2005,Valhalla,553405,1817,3171415,421,1269595,4441010,03/15/2016
2005,Pleasantville,553409,1932,3980063,333,1087569,5067632,03/15/2016
2005,Chappaqua,553604,4441,7133913,216,619264,7753177,03/15/2016
2005,Byram Hills,553801,2958,3479473,223,516534,3996007,03/15/2016
2005,North Salem,554001,1898,2774825,219,491009,3265834,03/15/2016
2005,Ossining,554201,5642,12041495,806,2738889,14780384,03/15/2016
2005,Briarcliff Manor,554202,1692,3761625,108,397529,4159154,03/15/2016
2005,Pelham,554401,2440,3922319,328,857819,4780138,03/15/2016
2005,Rye Neck,554801,1575,2351963,295,704868,3056831,03/15/2016
2005,Port Chester-Rye,554804,2905,4421007,964,2253543,6674550,03/15/2016
2005,Blind Brook-Rye,554805,1666,2366111,191,450837,2816948,03/15/2016
2005,Scarsdale,555001,4676,6361266,206,499586,6860852,03/15/2016
2005,Somers,555201,4927,6802735,1190,2667295,9470030,03/15/2016
2005,Lakeland,555401,8316,18076863,1659,4783405,22860268,03/15/2016
2005,Yorktown,555402,5112,10226140,631,2030378,12256518,03/15/2016
2005,Attica,562201,2289,1266290,630,566134,1832424,03/15/2016
2005,Letchworth,562601,1417,738231,383,308183,1046414,03/15/2016
2005,Wyoming,563802,448,238732,89,75784,314516,03/15/2016
2005,Perry,564201,1257,739530,431,402420,1141950,03/15/2016
2005,Warsaw,564801,1370,923950,402,437096,1361046,03/15/2016
2005,Penn Yan,573001,2882,1274465,1149,786401,2060866,03/15/2016
2005,Dundee,573401,1199,583782,438,305369,889151,03/15/2016
2005,New York City School,650000,628375,134729159,91171,30631492,165360651,03/15/2016
2004,Albany,010100,9715,6448521,3717,3745445,10193966,03/15/2016
2004,Cohoes,010300,1981,1562310,837,972070,2534380,03/15/2016
2004,Watervliet,011800,1245,674592,549,461529,1136121,03/15/2016
2004,Berne-Knox-Westerlo,012001,1564,1111831,351,382017,1493848,03/15/2016
2004,Bethlehem,012206,6731,4928317,1202,1438520,6366837,03/15/2016
2004,Ravena-Coeymans-Selkirk,012402,2729,1687411,739,703922,2391333,03/15/2016
2004,South Colonie,012601,8439,4193763,2805,2232390,6426153,03/15/2016
2004,North Colonie,012605,7273,3332671,1736,1294749,4627420,03/15/2016
2004,Menands,012615,369,163679,110,77656,241335,03/15/2016
2004,Maplewood,012622,87,42495,65,48549,91044,03/15/2016
2004,Green Island,012801,253,188925,142,172904,361829,03/15/2016
2004,Guilderland,013002,7108,4391188,1518,1537004,5928192,03/15/2016
2004,Voorheesville,013403,1937,1314828,371,416856,1731684,03/15/2016
2004,Alfred-Almond,022001,836,630337,277,312040,942377,03/15/2016
2004,Andover,023001,474,409091,174,219591,628682,03/15/2016
2004,Genesee Valley,023202,725,333890,365,235350,569240,03/15/2016
2004,Belfast,023401,444,235571,171,119190,354761,03/15/2016
2004,Canaseraga,024002,398,222229,145,113593,335822,03/15/2016
2004,Cuba-Rushford,024801,1297,827335,535,495838,1323173,03/15/2016
2004,Friendship,025001,356,295799,155,163236,459035,03/15/2016
2004,Fillmore,025801,783,374545,253,172738,547283,03/15/2016
2004,Whitesville,026001,238,157241,98,81826,239067,03/15/2016
2004,Scio,026601,492,371395,186,192081,563476,03/15/2016
2004,Wellsville,027001,1668,1026773,826,712056,1738829,03/15/2016
2004,Bolivar-Richburg,027602,991,414317,358,198062,612379,03/15/2016
2004,Binghamton,030200,5731,3735419,2744,2515962,6251381,03/15/2016
2004,Chenango Forks,032001,2215,1618703,594,670543,2289246,03/15/2016
2004,South Mountain-Hickory,032201,136,40542,27,13416,53958,03/15/2016
2004,Harpursville,032601,1122,531459,321,226592,758051,03/15/2016
2004,Susquehanna Valley,032801,2450,2027138,867,1104190,3131328,03/15/2016
2004,Chenango Valley,033001,2628,1889347,1171,1340730,3230077,03/15/2016
2004,Maine-Endwell,033801,3404,3348783,1404,2047244,5396027,03/15/2016
2004,Deposit,034201,684,363287,319,255041,618328,03/15/2016
2004,Whitney Point,034401,1735,975727,477,409393,1385120,03/15/2016
2004,Union-Endicott,034601,5413,4853155,2459,3358038,8211193,03/15/2016
2004,Johnson City,034602,2985,2312512,1647,1781599,4094111,03/15/2016
2004,Vestal,034801,5690,4528722,1852,2278356,6807078,03/15/2016
2004,Windsor,035001,2120,1434216,679,698383,2132599,03/15/2016
2004,Olean,041200,2817,1679769,1199,913466,2593235,03/15/2016
2004,Salamanca,041600,1137,504488,558,291910,796398,03/15/2016
2004,Allegany-Limestone,042001,1595,854269,548,383500,1237769,03/15/2016
2004,West Valley,042204,520,344722,167,167954,512676,03/15/2016
2004,Ellicottville,043601,725,262640,246,136990,399630,03/15/2016
2004,Franklinville,044001,926,545415,337,268283,813698,03/15/2016
2004,Hinsdale,044601,582,292167,233,159369,451536,03/15/2016
2004,Cattaraugus - Little Valley,046402,1491,809875,511,385204,1195079,03/15/2016
2004,Gowanda,047201,1505,913563,647,586004,1499567,03/15/2016
2004,Portville,047401,1114,690339,382,341586,1031925,03/15/2016
2004,Randolph,047601,1227,513288,415,244068,757356,03/15/2016
2004,Yorkshire-Pioneer,048401,3318,1424676,974,620375,2045051,03/15/2016
2004,Auburn,050100,5200,3344637,2343,2240405,5585042,03/15/2016
2004,Weedsport,052201,1143,810912,354,379410,1190322,03/15/2016
2004,Cato-Meridian,052401,1434,824891,338,290701,1115592,03/15/2016
2004,Southern Cayuga,053001,1264,684840,395,322595,1007435,03/15/2016
2004,Port Byron,053801,1432,962337,454,468059,1430396,03/15/2016
2004,Moravia,054201,1423,726713,373,280373,1007086,03/15/2016
2004,Union Springs,055401,1294,918026,422,459846,1377872,03/15/2016
2004,Dunkirk,060300,2235,1733317,1291,1405814,3139131,03/15/2016
2004,Jamestown,060800,4862,2702390,1896,1437976,4140366,03/15/2016
2004,Southwestern,062201,2294,1532003,798,820130,2352133,03/15/2016
2004,Frewsburg,062401,1055,707498,361,376345,1083843,03/15/2016
2004,Cassadaga Valley,062601,1453,764136,504,392166,1156302,03/15/2016
2004,Chautauqua Lake,062803,1241,367048,444,205558,572606,03/15/2016
2004,Pine Valley,063001,825,606618,289,309149,915767,03/15/2016
2004,Clymer,063201,630,280713,227,160518,441231,03/15/2016
2004,Bemus Point,063601,1183,633257,424,342645,975902,03/15/2016
2004,Falconer,063801,1557,1000781,546,534686,1535467,03/15/2016
2004,Silver Creek,064601,1260,767531,504,462673,1230204,03/15/2016
2004,Forestville,064603,878,464107,301,245842,709949,03/15/2016
2004,Panama,064801,811,452772,247,207774,660546,03/15/2016
2004,Fredonia,065801,2104,1413872,741,818735,2232607,03/15/2016
2004,Brocton,066001,818,665118,291,339527,1004645,03/15/2016
2004,Ripley,066201,424,342964,184,204215,547179,03/15/2016
2004,Sherman,066601,552,315229,139,116696,431925,03/15/2016
2004,Westfield,067201,1063,771427,357,395676,1167103,03/15/2016
2004,Elmira,070400,7569,4849903,3208,3007875,7857778,03/15/2016
2004,Horseheads,073401,5489,3177648,1919,1788676,4966324,03/15/2016
2004,Elmira Heights,073402,1217,737972,602,566981,1304953,03/15/2016
2004,Norwich,081100,2282,1542500,822,781252,2323752,03/15/2016
2004,Afton,082001,833,566865,315,315925,882790,03/15/2016
2004,Bainbridge-Guilford,082201,1127,703593,406,372639,1076232,03/15/2016
2004,Greene,083001,1467,954784,478,480100,1434884,03/15/2016
2004,Unadilla Valley,083803,1100,553227,400,306371,859598,03/15/2016
2004,Georgetown-So Otselic Valley,084401,553,308876,134,99261,408137,03/15/2016
2004,Oxford Academy,084601,1076,691266,407,378204,1069470,03/15/2016
2004,Sherburne-Earlville,085601,1677,997449,584,513014,1510463,03/15/2016
2004,Plattsburgh,091300,2081,1490577,761,850969,2341546,03/15/2016
2004,Ausable Valley,092201,1905,1087183,663,525370,1612553,03/15/2016
2004,Beekmantown,092401,2661,1414774,743,565748,1980522,03/15/2016
2004,Northeastern Clinton,092801,2020,1364696,568,547298,1911994,03/15/2016
2004,Chazy,093001,724,460006,186,178331,638337,03/15/2016
2004,Northern Adirondack,093601,1401,543758,419,220708,764466,03/15/2016
2004,Peru,094001,2651,1355266,564,423696,1778962,03/15/2016
2004,Saranac,094401,2290,1423592,651,606280,2029872,03/15/2016
2004,Hudson,100600,2022,1273157,1008,899629,2172786,03/15/2016
2004,Taconic Hills,102801,2081,913557,807,563328,1476885,03/15/2016
2004,Germantown,103602,853,457215,333,286565,743780,03/15/2016
2004,Chatham,103801,1888,976996,566,497403,1474399,03/15/2016
2004,Kinderhook,104401,2902,1622417,745,652639,2275056,03/15/2016
2004,New Lebanon,104801,875,482735,246,212655,695390,03/15/2016
2004,Cortland,110200,3024,1672906,1146,1007426,2680332,03/15/2016
2004,Cincinnatus,112001,718,349225,250,167637,516862,03/15/2016
2004,Mc Graw,112204,739,402476,225,185938,588414,03/15/2016
2004,Homer,113001,2738,1806718,757,778935,2585653,03/15/2016
2004,Marathon,113401,923,618797,282,275036,893833,03/15/2016
2004,Andes,122002,234,92789,155,98257,191046,03/15/2016
2004,Downsville,122401,365,143381,218,122587,265968,03/15/2016
2004,Charlotte Valley,122601,574,277546,244,179520,457066,03/15/2016
2004,Delhi,122801,1228,627702,524,431115,1058817,03/15/2016
2004,Franklin,123201,445,206585,157,114885,321470,03/15/2016
2004,Hancock,123606,455,285855,252,227046,512901,03/15/2016
2004,Margaretville,124601,675,222669,328,172960,395629,03/15/2016
2004,Roxbury,124802,523,332015,256,246085,578100,03/15/2016
2004,Sidney,125001,1401,949491,688,719792,1669283,03/15/2016
2004,Stamford,125201,555,397589,209,231982,629571,03/15/2016
2004,South Kortright,125202,490,259771,237,197907,457678,03/15/2016
2004,Walton,125601,1187,513719,521,349421,863140,03/15/2016
2004,Beacon,130200,3101,2000169,875,925130,2925299,03/15/2016
2004,Poughkeepsie,131300,2729,1855376,997,1069648,2925024,03/15/2016
2004,Dover,132602,1497,1362668,306,476524,1839192,03/15/2016
2004,Hyde Park,133201,5333,4439754,1457,1888985,6328739,03/15/2016
2004,Northeast,133801,946,629319,308,326838,956157,03/15/2016
2004,Pawling,134001,1756,1333424,365,459781,1793205,03/15/2016
2004,Pine Plains,134201,1767,851434,509,385584,1237018,03/15/2016
2004,Arlington,134601,10927,8305725,1832,2279778,10585503,03/15/2016
2004,Spackenkill,134602,1835,1428578,432,533611,1962189,03/15/2016
2004,Red Hook,134801,2158,1696452,595,764844,2461296,03/15/2016
2004,Rhinebeck,135001,1751,1093560,500,494287,1587847,03/15/2016
2004,Wappingers,135601,14573,8033675,3100,2823220,10856895,03/15/2016
2004,Millbrook,135801,1381,663318,324,258552,921870,03/15/2016
2004,Buffalo,140200,29502,12764708,10240,5611064,18375772,03/15/2016
2004,Lackawanna,140900,2195,652864,1509,582789,1235653,03/15/2016
2004,Tonawanda,141600,3115,1816404,1405,1287593,3103997,03/15/2016
2004,Alden,142001,2640,1630332,813,804592,2434924,03/15/2016
2004,Amherst,142201,5513,3517737,1538,1556653,5074390,03/15/2016
2004,Williamsville,142203,16164,9666734,3610,3420335,13087069,03/15/2016
2004,Sweet Home,142207,5131,2191317,2157,1514110,3705427,03/15/2016
2004,East Aurora,142401,2852,1498954,867,743520,2242474,03/15/2016
2004,Cheektowaga,143001,3568,1854341,1963,1516809,3371150,03/15/2016
2004,Cheektowaga-Maryvale,143002,3454,1874828,2201,1899724,3774552,03/15/2016
2004,Cleveland Hill,143003,2374,1799989,1066,1280552,3080541,03/15/2016
2004,Depew,143007,3351,2242066,1216,1318829,3560895,03/15/2016
2004,Cheektowaga-Sloan,143009,2182,1825428,1542,2068801,3894229,03/15/2016
2004,Clarence,143201,6057,2996782,1349,985941,3982723,03/15/2016
2004,Springville-Griffith,143801,2908,1833936,881,868926,2702862,03/15/2016
2004,Eden,144001,2314,1185529,661,555970,1741499,03/15/2016
2004,Iroquois,144201,4085,1804942,1221,876583,2681525,03/15/2016
2004,Evans-Brant,144401,4028,2432416,1104,965717,3398133,03/15/2016
2004,Grand Island,144601,4697,3112824,961,1011233,4124057,03/15/2016
2004,Hamburg,144801,5388,2716635,1482,1235082,3951717,03/15/2016
2004,Frontier,144804,7501,3520855,2268,1614781,5135636,03/15/2016
2004,Holland,145001,1637,760818,378,287695,1048513,03/15/2016
2004,Lancaster,145201,9141,4485492,2728,2063201,6548693,03/15/2016
2004,Akron,145601,1882,930884,596,411696,1342580,03/15/2016
2004,North Collins,145801,916,526714,311,281107,807821,03/15/2016
2004,Orchard Park,146001,7428,4016062,1708,1514218,5530280,03/15/2016
2004,Kenmore,146401,14300,9113605,6459,6718782,15832387,03/15/2016
2004,West Seneca,146801,11609,6262120,4876,4155057,10417177,03/15/2016
2004,Crown Point,152203,405,177530,165,108218,285748,03/15/2016
2004,Elizabethtown-Lewis,152401,515,281330,172,145641,426971,03/15/2016
2004,Keene,153001,265,107238,81,53874,161112,03/15/2016
2004,Minerva,153401,223,139910,86,79483,219393,03/15/2016
2004,Moriah,153601,913,474816,479,341250,816066,03/15/2016
2004,Newcomb,153801,124,10318,71,8601,18919,03/15/2016
2004,Lake Placid,154002,1113,398974,328,172608,571582,03/15/2016
2004,Schroon Lake,154601,432,131392,211,98880,230272,03/15/2016
2004,Ticonderoga,154801,1129,387231,474,250629,637860,03/15/2016
2004,Westport,155001,322,188490,127,117117,305607,03/15/2016
2004,Willsboro,155201,499,276813,265,216648,493461,03/15/2016
2004,Tupper Lake,162001,1275,530974,499,270248,801222,03/15/2016
2004,Chateaugay,163401,708,391539,242,185941,577480,03/15/2016
2004,Salmon River,164201,794,355309,301,197696,553005,03/15/2016
2004,Saranac Lake,164601,2130,835015,625,356053,1191068,03/15/2016
2004,Malone,164801,2968,1681932,1070,845530,2527462,03/15/2016
2004,Brushton-Moira,165001,934,497963,328,249673,747636,03/15/2016
2004,St. Regis Falls,165401,454,208996,163,105592,314588,03/15/2016
2004,Gloversville,170500,3135,2066551,1406,1163933,3230484,03/15/2016
2004,Johnstown,170800,2136,1212797,769,642133,1854930,03/15/2016
2004,Broadalbin-Perth,172201,2177,957718,692,465964,1423682,03/15/2016
2004,Wheelerville,172401,358,186972,140,110441,297413,03/15/2016
2004,Mayfield,173001,1363,821533,495,425650,1247183,03/15/2016
2004,Northville,173201,625,274838,272,180878,455716,03/15/2016
2004,Oppenheim-Ephratah,173401,623,404215,176,157470,561685,03/15/2016
2004,Batavia,180200,3175,2280162,1163,1300096,3580258,03/15/2016
2004,Alexander,182202,1166,923499,336,412547,1336046,03/15/2016
2004,Byron-Bergen,183001,1573,1222520,452,481918,1704438,03/15/2016
2004,Elba,183401,607,458310,182,220335,678645,03/15/2016
2004,Le Roy,183601,1689,1276356,510,604620,1880976,03/15/2016
2004,Oakfield-Alabama,183801,1094,798326,394,444091,1242417,03/15/2016
2004,Pavilion,184001,1158,838449,263,288297,1126746,03/15/2016
2004,Pembroke,184202,1444,956321,444,453163,1409484,03/15/2016
2004,Cairo-Durham,192401,1738,892523,738,598361,1490884,03/15/2016
2004,Catskill,192601,2041,1262222,806,770623,2032845,03/15/2016
2004,Coxsackie-Athens,192801,1845,1114166,597,561395,1675561,03/15/2016
2004,Greenville,193201,1814,1196863,590,616471,1813334,03/15/2016
2004,Hunter-Tannersville,193601,661,280772,295,195866,476638,03/15/2016
2004,Windham-Ashland-Jewett,194601,557,197708,267,151725,349433,03/15/2016
2004,Piseco,202001,82,7427,37,5585,13012,03/15/2016
2004,Indian Lake,202601,320,94782,152,72498,167280,03/15/2016
2004,Inlet,202801,87,10693,46,9423,20116,03/15/2016
2004,Lake Pleasant,203001,192,59731,105,52563,112294,03/15/2016
2004,Long Lake,203201,168,39251,105,38207,77458,03/15/2016
2004,Raquette Lake,203202,25,1493,14,1427,2920,03/15/2016
2004,Wells,203601,224,90081,115,72449,162530,03/15/2016
2004,Little Falls,210900,1228,901185,652,689639,1590824,03/15/2016
2004,West Canada Valley,212402,995,511498,308,246096,757594,03/15/2016
2004,Frankfort-Schuyler,212602,1321,867367,602,610057,1477424,03/15/2016
2004,Ilion,212801,1597,687230,610,398328,1085558,03/15/2016
2004,Mohawk,212802,1059,612182,450,394352,1006534,03/15/2016
2004,Herkimer,213001,1472,945037,809,733475,1678512,03/15/2016
2004,Dolgeville,213602,1007,442731,438,268931,711662,03/15/2016
2004,Poland,213803,896,414891,293,213648,628539,03/15/2016
2004,Van Hornesville-Owen D. Young,215001,316,194343,122,116285,310628,03/15/2016
2004,Town Of Webb,215401,551,104696,265,80672,185368,03/15/2016
2004,Mount Markham,215601,1469,1006965,453,464415,1471380,03/15/2016
2004,Watertown,221800,3539,1471126,1428,871756,2342882,03/15/2016
2004,South Jefferson,222001,2076,900976,546,342673,1243649,03/15/2016
2004,Alexandria,222202,787,292484,275,155967,448451,03/15/2016
2004,Indian River,222401,1606,315281,419,110944,426225,03/15/2016
2004,General Brown,222601,1778,711143,510,305064,1016207,03/15/2016
2004,Thousand Islands,223201,1435,677629,608,437136,1114765,03/15/2016
2004,Belleville-Henderson,223402,672,213400,298,137704,351104,03/15/2016
2004,Sackets Harbor,223801,565,292511,188,148454,440965,03/15/2016
2004,Lyme,224401,509,222230,249,168119,390349,03/15/2016
2004,La Fargeville,224601,587,230837,159,93445,324282,03/15/2016
2004,Carthage,226001,2379,1378942,761,635914,2014856,03/15/2016
2004,Copenhagen,232201,558,211193,144,82473,293666,03/15/2016
2004,Harrisville,232401,543,323781,199,149608,473389,03/15/2016
2004,Lowville,233601,1564,708711,546,348429,1057140,03/15/2016
2004,South Lewis,234001,1462,645115,574,344819,989934,03/15/2016
2004,Beaver River,234401,1209,445746,366,194120,639866,03/15/2016
2004,Avon,242001,1188,921372,336,407517,1328889,03/15/2016
2004,Caledonia-Mumford,242201,1343,853433,343,348514,1201947,03/15/2016
2004,Geneseo,242601,1354,770869,320,295280,1066149,03/15/2016
2004,Livonia,243401,2570,1583321,570,549217,2132538,03/15/2016
2004,Mount Morris,243601,623,435963,252,263913,699876,03/15/2016
2004,Dansville,243801,2110,1083566,685,534111,1617677,03/15/2016
2004,Dalton-Nunda,244001,1164,846760,336,361052,1207812,03/15/2016
2004,York,245201,1128,655852,316,288511,944363,03/15/2016
2004,Oneida,251200,2783,1610494,933,829791,2440285,03/15/2016
2004,Brookfield,252009,303,148304,82,56995,205299,03/15/2016
2004,Cazenovia,252201,2227,1322809,515,488041,1810850,03/15/2016
2004,De Ruyter,252401,564,351153,188,167447,518600,03/15/2016
2004,Morrisville-Eaton,252601,969,547778,245,202077,749855,03/15/2016
2004,Hamilton,253201,902,538278,252,232446,770724,03/15/2016
2004,Canastota,253601,1898,1187515,670,640323,1827838,03/15/2016
2004,Madison,254001,604,414134,190,182732,596866,03/15/2016
2004,Stockbridge Valley,254601,536,362516,170,170159,532675,03/15/2016
2004,Chittenango,254801,3113,2348221,799,871518,3219739,03/15/2016
2004,Rochester,261400,25529,11129034,5284,3162530,14291564,03/15/2016
2004,Brighton,262001,5232,3863212,974,1160293,5023505,03/15/2016
2004,Gates-Chili,262601,7787,5548504,2822,3223478,8771982,03/15/2016
2004,Greece,262801,18514,12969355,5352,6053816,19023171,03/15/2016
2004,East Irondequoit,263401,6364,4968866,2612,3253235,8222101,03/15/2016
2004,West Irondequoit,263403,6305,5254051,2029,2782542,8036593,03/15/2016
2004,Honeoye Falls-Lima,263601,3216,2330700,416,600000,2930700,03/15/2016
2004,Spencerport,263801,5294,3938876,1223,1484563,5423439,03/15/2016
2004,Hilton,264001,6164,4373981,1193,1369125,5743106,03/15/2016
2004,Penfield,264201,7926,6375097,1560,2008867,8383964,03/15/2016
2004,Fairport,264401,9704,6420685,2047,2174569,8595254,03/15/2016
2004,East Rochester,264413,1675,1312885,660,777995,2090880,03/15/2016
2004,Pittsford,264601,8425,5833615,1090,1240801,7074416,03/15/2016
2004,Churchville-Chili,264801,5540,4128448,1251,1497056,5625504,03/15/2016
2004,Rush-Henrietta,265001,8161,4917126,2093,2060132,6977258,03/15/2016
2004,Brockport,265201,4854,3434144,796,879023,4313167,03/15/2016
2004,Webster,265401,12178,8334371,3008,3346526,11680897,03/15/2016
2004,Wheatland-Chili,265601,1361,1037734,376,445916,1483650,03/15/2016
2004,Amsterdam,270100,3926,2820582,2060,2224796,5045378,03/15/2016
2004,Canajoharie,272201,1185,734648,466,449796,1184444,03/15/2016
2004,Fonda-Fultonville,272801,1797,1157115,570,553287,1710402,03/15/2016
2004,Fort Plain,273001,953,909943,401,557223,1467166,03/15/2016
2004,St. Johnsville,273802,573,342703,288,241539,584242,03/15/2016
2004,Glen Cove,280500,3433,2955804,1250,1786093,4741897,03/15/2016
2004,Long Beach,281000,6727,4451197,1105,1398225,5849422,03/15/2016
2004,Hempstead,282001,2779,4636653,488,1394729,6031382,03/15/2016
2004,Uniondale,282002,4619,3986010,841,1310445,5296455,03/15/2016
2004,East Meadow,282003,10412,11495493,2999,5251270,16746763,03/15/2016
2004,North Bellmore,282004,5598,6111929,1260,2469739,8581668,03/15/2016
2004,Levittown,282005,10547,14958791,2407,6257611,21216402,03/15/2016
2004,Seaford,282006,3725,3827887,864,1565741,5393628,03/15/2016
2004,Bellmore,282007,2977,3051899,529,956083,4007982,03/15/2016
2004,Roosevelt,282008,2081,2316046,335,670140,2986186,03/15/2016
2004,Freeport,282009,5354,7014887,953,2179517,9194404,03/15/2016
2004,Baldwin,282010,6940,8610925,1154,2496541,11107466,03/15/2016
2004,Oceanside,282011,8223,7713354,1758,2919976,10633330,03/15/2016
2004,Malverne,282012,2977,3466102,628,1352894,4818996,03/15/2016
2004,Valley Stream 13,282013,5716,6792330,1577,3177747,9970077,03/15/2016
2004,Hewlett-Woodmere,282014,4573,5541076,691,1430381,6971457,03/15/2016
2004,Lawrence,282015,5968,4602949,958,1425896,6028845,03/15/2016
2004,Elmont,282016,7334,7349740,1706,3083929,10433669,03/15/2016
2004,Franklin Square,282017,4747,4177696,1527,2427609,6605305,03/15/2016
2004,Garden City,282018,5438,3468286,766,866560,4334846,03/15/2016
2004,East Rockaway,282019,1943,2273850,527,1078663,3352513,03/15/2016
2004,Lynbrook,282020,3665,3960104,813,1597697,5557801,03/15/2016
2004,Rockville Centre,282021,4600,4234933,712,1233684,5468617,03/15/2016
2004,Floral Park-Bellerose,282022,3977,3492668,909,1414138,4906806,03/15/2016
2004,Wantagh,282023,4260,4483496,742,1430963,5914459,03/15/2016
2004,Valley Stream 24,282024,2362,2342093,615,1087603,3429696,03/15/2016
2004,Merrick,282025,4607,4460918,586,974132,5435050,03/15/2016
2004,Island Trees,282026,3229,3455899,783,1531250,4987149,03/15/2016
2004,West Hempstead,282027,3441,3617053,713,1361655,4978708,03/15/2016
2004,North Merrick,282029,3171,3467782,714,1424792,4892574,03/15/2016
2004,Valley Stream 30,282030,2738,2183642,688,991493,3175135,03/15/2016
2004,Island Park,282031,1464,1065379,322,399472,1464851,03/15/2016
2004,Westbury,282201,2812,3940680,661,1568251,5508931,03/15/2016
2004,East Williston,282202,2014,1936198,247,426524,2362722,03/15/2016
2004,Roslyn,282203,3912,3623700,389,673997,4297697,03/15/2016
2004,Port Washington,282204,5415,3940498,731,956963,4897461,03/15/2016
2004,New Hyde Park-Garden City,282205,4368,3363276,1317,1835830,5199106,03/15/2016
2004,Manhasset,282206,3600,2063500,351,383943,2447443,03/15/2016
2004,Great Neck,282207,8799,4715338,1103,1058484,5773822,03/15/2016
2004,Herricks,282209,5713,4920726,1088,1842167,6762893,03/15/2016
2004,Mineola,282210,4146,3366045,1193,1785115,5151160,03/15/2016
2004,Carle Place,282211,1787,1530510,488,765513,2296023,03/15/2016
2004,North Shore,282401,3488,2294026,602,714715,3008741,03/15/2016
2004,Syosset,282402,7753,7373026,1222,1750467,9123493,03/15/2016
2004,Locust Valley,282403,3178,2022568,458,571914,2594482,03/15/2016
2004,Plainview-Old Bethpage,282404,6974,7115650,1377,2609174,9724824,03/15/2016
2004,Oyster Bay-East Norwich,282406,2479,1518720,388,458187,1976907,03/15/2016
2004,Jericho,282415,3191,2529025,344,492271,3021296,03/15/2016
2004,Hicksville,282417,7257,5149070,2108,2808846,7957916,03/15/2016
2004,Plainedge,282418,4337,5015870,1198,2558261,7574131,03/15/2016
2004,Bethpage,282421,3870,3231740,1465,1648753,4880493,03/15/2016
2004,Farmingdale,282422,8064,9901277,2127,4637599,14538876,03/15/2016
2004,Massapequa,282423,11191,9948351,2452,4035083,13983434,03/15/2016
2004,Lockport,290900,6222,5212754,1837,2122413,7335167,03/15/2016
2004,Niagara Falls,291100,7574,3756849,4073,2826175,6583024,03/15/2016
2004,North Tonawanda,291200,6227,4128652,2407,2542832,6671484,03/15/2016
2004,Lewiston-Porter,292401,4043,2894892,1391,1648195,4543087,03/15/2016
2004,Newfane,292801,2350,2073070,743,979201,3052271,03/15/2016
2004,Niagara-Wheatfield,293001,4873,2955226,1666,1521966,4477192,03/15/2016
2004,Starpoint,293201,3787,2499447,895,954819,3454266,03/15/2016
2004,Royalton-Hartland,293601,2055,1436779,590,658492,2095271,03/15/2016
2004,Barker,293801,1137,712847,323,313607,1026454,03/15/2016
2004,Wilson,294201,1814,1406306,564,697393,2103699,03/15/2016
2004,Rome,301300,5897,4463481,2712,2922476,7385957,03/15/2016
2004,Utica,301600,7492,5075903,4032,3846019,8921922,03/15/2016
2004,Adirondack,302601,1897,985860,631,450989,1436849,03/15/2016
2004,Camden,303001,2826,1568966,865,643952,2212918,03/15/2016
2004,Clinton,304001,1920,1596355,586,669988,2266343,03/15/2016
2004,New Hartford,304801,3658,2533947,1253,1380216,3914163,03/15/2016
2004,New York Mills,304804,783,533557,511,569226,1102783,03/15/2016
2004,Sauquoit Valley,305002,1388,880952,410,406526,1287478,03/15/2016
2004,Remsen,305201,759,499080,217,205950,705030,03/15/2016
2004,Waterville,305401,1135,683636,346,314202,997838,03/15/2016
2004,Holland Patent,305801,2134,1392394,601,600475,1992869,03/15/2016
2004,Sherrill,306000,2652,1758447,912,936373,2694820,03/15/2016
2004,Westmoreland,306801,1437,1330499,517,666426,1996925,03/15/2016
2004,Oriskany,307001,909,673187,331,375407,1048594,03/15/2016
2004,Whitesboro,307002,4813,3262792,1918,2029143,5291935,03/15/2016
2004,Syracuse,311500,15804,7650003,5581,4096052,11746055,03/15/2016
2004,West Genesee,312001,7000,5117774,2700,3035968,8153742,03/15/2016
2004,North Syracuse,312403,13607,9134827,3519,3406161,12540988,03/15/2016
2004,East Syracuse-Minoa,312601,4912,3646717,1830,1959748,5606465,03/15/2016
2004,Jamesville-Dewitt,312611,4020,2595104,898,926695,3521799,03/15/2016
2004,Jordan-Elbridge,312801,1739,1428877,528,599372,2028249,03/15/2016
2004,Fabius-Pompey,313001,1101,842532,266,316878,1159410,03/15/2016
2004,Westhill,313201,2617,2089879,935,1183862,3273741,03/15/2016
2004,Solvay,313202,1831,1447922,965,1198247,2646169,03/15/2016
2004,La Fayette,313407,1058,647048,263,240778,887826,03/15/2016
2004,Baldwinsville,313601,7844,5638812,1733,1886460,7525272,03/15/2016
2004,Fayetteville-Manlius,313801,6291,4949507,1108,1399683,6349190,03/15/2016
2004,Marcellus,314001,2572,1635555,687,699429,2334984,03/15/2016
2004,Onondaga,314201,1417,1230016,442,576695,1806711,03/15/2016
2004,Liverpool,314801,10591,8270564,2931,3443656,11714220,03/15/2016
2004,Lyncourt,314804,794,705996,477,581253,1287249,03/15/2016
2004,Skaneateles,315001,2237,1250171,594,533889,1784060,03/15/2016
2004,Tully,315402,1356,832457,286,281917,1114374,03/15/2016
2004,Canandaigua,320200,4187,2427585,1050,977905,3405490,03/15/2016
2004,Geneva,320500,2605,1730501,1151,1148179,2878680,03/15/2016
2004,East Bloomfield,322601,1369,1047135,306,366810,1413945,03/15/2016
2004,Gorham-Middlesex,323201,2138,1184125,593,517253,1701378,03/15/2016
2004,Manchester-Shortsville,323601,1175,1006740,409,525236,1531976,03/15/2016
2004,Naples,323801,1334,755955,348,309179,1065134,03/15/2016
2004,Phelps-Clifton Springs,324001,2310,1793569,607,747849,2541418,03/15/2016
2004,Honeoye,324201,1533,841056,376,329825,1170881,03/15/2016
2004,Victor,324801,4436,2758129,735,699888,3458017,03/15/2016
2004,Middletown,330900,5060,4293920,1292,1659949,5953869,03/15/2016
2004,Newburgh,331100,9171,7884094,2477,3324849,11208943,03/15/2016
2004,Port Jervis,331300,2626,2345390,904,1197950,3543340,03/15/2016
2004,Washingtonville,332002,5276,4050780,626,811573,4862353,03/15/2016
2004,Chester,332201,1304,1083185,219,292142,1375327,03/15/2016
2004,Cornwall,332401,3337,2659264,563,712042,3371306,03/15/2016
2004,Pine Bush,332601,5761,4194884,937,1103016,5297900,03/15/2016
2004,Goshen,333001,2969,2055906,559,637204,2693110,03/15/2016
2004,Highland Falls,333601,813,509852,252,258391,768243,03/15/2016
2004,Minisink Valley,333801,4405,3420966,660,824613,4245579,03/15/2016
2004,Monroe-Woodbury,334001,8433,7235976,980,1466781,8702757,03/15/2016
2004,Kiryas Joel Village,334002,826,290238,45,26191,316429,03/15/2016
2004,Valley,334201,5052,3789355,1036,1242203,5031558,03/15/2016
2004,Tuxedo,335003,550,173874,84,50577,224451,03/15/2016
2004,Warwick Valley,335401,5005,3885764,791,1004914,4890678,03/15/2016
2004,Greenwood Lake,335411,1457,1119161,245,309943,1429104,03/15/2016
2004,Florida,335415,1067,833356,246,318554,1151910,03/15/2016
2004,Albion,342001,2325,1514931,807,766795,2281726,03/15/2016
2004,Kendall,343007,1265,935933,273,319705,1255638,03/15/2016
2004,Holley,343204,1475,1497494,443,686810,2184304,03/15/2016
2004,Medina,343401,2025,1482461,770,866345,2348806,03/15/2016
2004,Lyndonville,343801,919,621037,318,332806,953843,03/15/2016
2004,Fulton,350400,3669,2684154,1233,1257894,3942048,03/15/2016
2004,Oswego,351200,5114,3824597,1715,1941275,5765872,03/15/2016
2004,Altmar Parish-Williamstown,352002,1587,1035901,409,380144,1416045,03/15/2016
2004,Hannibal,353001,1705,980408,402,345267,1325675,03/15/2016
2004,Central Square,353201,5418,3219736,1278,1094487,4314223,03/15/2016
2004,Mexico,353401,2817,1737028,641,598106,2335134,03/15/2016
2004,Pulaski,355001,1218,761945,316,300779,1062724,03/15/2016
2004,Sandy Creek,355201,1190,720422,403,346642,1067064,03/15/2016
2004,Phoenix,355401,2715,2205107,677,819385,3024492,03/15/2016
2004,Oneonta,361200,2541,1697130,859,918375,2615505,03/15/2016
2004,Gilbertsville-Mt Upton,362202,675,334993,224,165980,500973,03/15/2016
2004,Cherry Valley-Springfield,362401,834,415054,385,287383,702437,03/15/2016
2004,Edmeston,362801,587,276938,209,154539,431477,03/15/2016
2004,Laurens,363401,564,354910,172,171959,526869,03/15/2016
2004,Schenevus,363601,559,360718,196,184507,545225,03/15/2016
2004,Milford,364001,626,383489,265,255951,639440,03/15/2016
2004,Morris,364201,539,341816,222,219314,561130,03/15/2016
2004,Otego-Unadilla,364801,1380,922116,537,523786,1445902,03/15/2016
2004,Cooperstown,365001,1227,597574,472,362721,960295,03/15/2016
2004,Richfield Springs,365601,776,324682,379,252456,577138,03/15/2016
2004,Worcester,366606,488,292369,223,207368,499737,03/15/2016
2004,Mahopac,372001,5994,6463052,807,1445639,7908691,03/15/2016
2004,Carmel,372002,6569,7135270,836,1487003,8622273,03/15/2016
2004,Haldane,372601,986,890291,251,347301,1237592,03/15/2016
2004,Garrison,372604,527,295853,68,63669,359522,03/15/2016
2004,Putnam Valley,372803,2632,3806687,307,712776,4519463,03/15/2016
2004,Brewster,373001,4917,5398845,785,1456062,6854907,03/15/2016
2004,Rensselaer,381400,1178,830529,387,364589,1195118,03/15/2016
2004,Troy,381700,4223,3261639,1460,1563792,4825431,03/15/2016
2004,Lansingburgh,381701,2611,1929562,927,974306,2903868,03/15/2016
2004,Berlin,382001,1479,932670,424,394285,1326955,03/15/2016
2004,Brunswick,382202,1756,1286599,463,506275,1792874,03/15/2016
2004,East Greenbush,382401,6521,4663371,1532,1702856,6366227,03/15/2016
2004,Hoosick Falls,382801,1583,992862,636,541275,1534137,03/15/2016
2004,North Greenbush,383201,342,91335,124,54037,145372,03/15/2016
2004,Wynantskill,383204,819,569962,293,324982,894944,03/15/2016
2004,Averill Park,384001,4319,2747166,950,931046,3678212,03/15/2016
2004,Hoosic Valley,384201,1484,1089811,379,411950,1501761,03/15/2016
2004,Schodack,384401,1449,1138794,327,401965,1540759,03/15/2016
2004,Clarkstown,392001,11704,9652937,1693,2327834,11980771,03/15/2016
2004,Nanuet,392008,2350,1873780,609,800776,2674556,03/15/2016
2004,Haverstraw-Stony Point,392201,8017,10626836,1745,3392518,14019354,03/15/2016
2004,South Orangetown,392401,4190,3931141,1022,1627808,5558949,03/15/2016
2004,Nyack,392404,3958,4483327,802,1609354,6092681,03/15/2016
2004,Pearl River,392408,3023,3201682,738,1328005,4529687,03/15/2016
2004,Ramapo,392601,5879,8544887,1099,2617457,11162344,03/15/2016
2004,East Ramapo,392602,12216,14202493,1670,3004770,17207263,03/15/2016
2004,Ogdensburg,401200,2162,1243502,706,499537,1743039,03/15/2016
2004,Brasher Falls,402001,1306,644998,412,291078,936076,03/15/2016
2004,Canton,402201,1687,1074445,474,452734,1527179,03/15/2016
2004,Clifton-Fine,402601,475,190001,246,123283,313284,03/15/2016
2004,Colton-Pierrepont,402801,583,270300,227,149980,420280,03/15/2016
2004,Edwards-Knox,403401,720,247707,221,102197,349904,03/15/2016
2004,Gouverneur,404001,1936,864390,601,366271,1230661,03/15/2016
2004,Hammond,404201,365,130007,149,76477,206484,03/15/2016
2004,Hermon-Dekalb,404401,539,323694,174,147314,471008,03/15/2016
2004,Lisbon,405002,779,437791,249,203311,641102,03/15/2016
2004,Madrid-Waddington,405601,987,557521,314,259283,816804,03/15/2016
2004,Massena,405801,3347,1988415,1379,1243552,3231967,03/15/2016
2004,Morristown,406001,613,330456,205,165322,495778,03/15/2016
2004,Norwood-Norfolk,406201,1384,993411,482,480421,1473832,03/15/2016
2004,Heuvelton,406404,832,469135,244,199366,668501,03/15/2016
2004,Parishville-Hopkinton,406601,673,281195,168,89969,371164,03/15/2016
2004,Potsdam,407402,1905,1449675,568,634350,2084025,03/15/2016
2004,Mechanicville,411000,1338,733884,580,518281,1252165,03/15/2016
2004,Saratoga Springs,411500,9143,4818953,1688,1472598,6291551,03/15/2016
2004,Burnt Hills-Ballston Lake,412001,4693,3260401,1111,1269700,4530101,03/15/2016
2004,Shenendehowa,412402,12925,8346282,1863,1970690,10316972,03/15/2016
2004,Corinth,412601,1428,781763,487,380006,1161769,03/15/2016
2004,Edinburg,413001,325,79137,156,58393,137530,03/15/2016
2004,Galway,413201,1570,832772,347,278274,1111046,03/15/2016
2004,Ballston Spa,414201,5174,4134830,1018,1158806,5293636,03/15/2016
2004,South Glens Falls,414401,3451,2521389,1029,1084558,3605947,03/15/2016
2004,Schuylerville,415001,2148,1911256,459,619615,2530871,03/15/2016
2004,Stillwater,415201,1577,807696,376,310504,1118200,03/15/2016
2004,Waterford-Halfmoon,415401,915,718451,478,562165,1280616,03/15/2016
2004,Schenectady,421500,7566,6693518,3145,4056155,10749673,03/15/2016
2004,Duanesburg,422001,1239,768898,221,219078,987976,03/15/2016
2004,Scotia-Glenville,422202,4039,3063462,1101,1343794,4407256,03/15/2016
2004,Niskayuna,422401,5968,3717492,896,922581,4640073,03/15/2016
2004,Schalmont,422801,3149,2200274,894,976485,3176759,03/15/2016
2004,Rotterdam-Mohonasen,422803,4526,2762247,1972,1881652,4643899,03/15/2016
2004,Cobleskill-Richmondville,432602,2343,1250045,797,639723,1889768,03/15/2016
2004,Gilboa-Conesville,433401,552,267857,261,176419,444276,03/15/2016
2004,Jefferson,433601,424,224928,143,115926,340854,03/15/2016
2004,Middleburgh,433801,1222,834119,453,450889,1285008,03/15/2016
2004,Schoharie,434201,1439,968859,433,446332,1415191,03/15/2016
2004,Sharon Springs,434601,411,263490,161,152060,415550,03/15/2016
2004,Odessa-Montour,442001,1178,764913,411,396970,1161883,03/15/2016
2004,Watkins Glen,442401,1732,807357,713,493298,1300655,03/15/2016
2004,South Seneca,452801,1278,742143,492,415714,1157857,03/15/2016
2004,Romulus,453003,701,421245,231,215596,636841,03/15/2016
2004,Seneca Falls,453201,1902,1379887,772,860799,2240686,03/15/2016
2004,Waterloo,453801,2117,1438763,833,871212,2309975,03/15/2016
2004,Corning,460300,6859,4797923,2203,2214253,7012176,03/15/2016
2004,Hornell,460600,1716,1000123,747,562779,1562902,03/15/2016
2004,Addison,462001,1397,939360,425,348603,1287963,03/15/2016
2004,Avoca,462201,765,381890,241,166740,548630,03/15/2016
2004,Bath,462402,1786,934295,660,544367,1478662,03/15/2016
2004,Bradford,462601,438,291672,131,128438,420110,03/15/2016
2004,Campbell-Savona,463002,1176,489846,344,213975,703821,03/15/2016
2004,Canisteo-Greenwood,463202,1315,656634,486,319379,976013,03/15/2016
2004,Arkport,465201,623,456899,296,281783,738682,03/15/2016
2004,Jasper-Troupsburg,465601,586,265233,196,122816,388049,03/15/2016
2004,Prattsburgh,466001,618,278197,194,123187,401384,03/15/2016
2004,Hammondsport,467201,1031,478052,427,296571,774623,03/15/2016
2004,Wayland-Cohocton,467401,2086,888827,614,386700,1275527,03/15/2016
2004,Babylon,472001,2576,3023332,394,746072,3769404,03/15/2016
2004,West Babylon,472002,5138,5656878,1084,1928373,7585251,03/15/2016
2004,North Babylon,472003,6098,6643344,1512,2688494,9331838,03/15/2016
2004,Lindenhurst,472004,7749,8770139,1762,3228199,11998338,03/15/2016
2004,Copiague,472005,4731,5390409,1131,2005606,7396015,03/15/2016
2004,Amityville,472006,3624,4465948,737,1441042,5906990,03/15/2016
2004,Deer Park,472007,4868,5685347,1467,2790973,8476320,03/15/2016
2004,Wyandanch,472009,955,1001836,172,285440,1287276,03/15/2016
2004,Three Village,472201,8994,8919071,1336,2142411,11061482,03/15/2016
2004,Brookhaven-Comsewogue,472203,4359,4305182,771,1200748,5505930,03/15/2016
2004,South Country,472204,4791,4721206,725,1134949,5856155,03/15/2016
2004,Sachem,472205,16932,16322328,2338,3573089,19895417,03/15/2016
2004,Port Jefferson,472206,1589,1005371,212,219669,1225040,03/15/2016
2004,Mount Sinai,472207,2558,2935757,346,646678,3582435,03/15/2016
2004,Miller Place,472208,3450,3852522,353,632570,4485092,03/15/2016
2004,Rocky Point,472209,3671,4227419,506,892940,5120359,03/15/2016
2004,Middle Country,472211,11237,10442202,2082,3064731,13506933,03/15/2016
2004,Longwood,472212,11515,12763256,3055,4863976,17627232,03/15/2016
2004,Patchogue-Medford,472224,8881,7884087,1607,2173751,10057838,03/15/2016
2004,William Floyd,472232,8675,8900124,1326,2070770,10970894,03/15/2016
2004,Center Moriches,472233,1503,2033341,256,547071,2580412,03/15/2016
2004,East Moriches,472234,1167,1092584,171,260278,1352862,03/15/2016
2004,Eastport- South Manor,472235,3889,4221942,801,1274957,5496899,03/15/2016
2004,East Hampton,472401,1298,257728,358,132310,390038,03/15/2016
2004,Wainscott,472402,128,10386,28,4614,15000,03/15/2016
2004,Amagansett,472403,255,30846,100,24158,55004,03/15/2016
2004,Springs,472404,925,287741,272,170183,457924,03/15/2016
2004,Sag Harbor,472405,1174,414677,558,359165,773842,03/15/2016
2004,Montauk,472406,702,111936,258,100872,212808,03/15/2016
2004,Elwood,472601,3107,2728297,630,948346,3676643,03/15/2016
2004,Cold Spring Harbor,472602,2110,1615242,146,191738,1806980,03/15/2016
2004,Huntington,472603,7382,6627859,1373,2090056,8717915,03/15/2016
2004,Northport-East Northport,472604,8761,5996405,1582,1853745,7850150,03/15/2016
2004,Half Hollow Hills,472605,10346,7563852,1413,1631771,9195623,03/15/2016
2004,Harborfields,472606,4613,4237760,727,1141807,5379567,03/15/2016
2004,Commack,472610,9094,8849013,1847,3033613,11882626,03/15/2016
2004,South Huntington,472613,8418,7951191,1877,3031172,10982363,03/15/2016
2004,Bay Shore,472801,5365,5659123,1076,1868126,7527249,03/15/2016
2004,Islip,472802,3777,3699876,684,1101934,4801810,03/15/2016
2004,East Islip,472803,5423,5471742,1043,1897457,7369199,03/15/2016
2004,Sayville,472804,3912,4338377,792,1442711,5781088,03/15/2016
2004,Bayport-Blue Point,472805,2943,3151503,493,871202,4022705,03/15/2016
2004,Hauppauge,472806,4950,2865633,957,891654,3757287,03/15/2016
2004,Connetquot,472807,8403,8303380,1449,2339702,10643082,03/15/2016
2004,West Islip,472809,6309,6206450,1312,2148770,8355220,03/15/2016
2004,Brentwood,472812,8717,6367047,2104,2554031,8921078,03/15/2016
2004,Central Islip,472813,5110,6487817,859,1778282,8266099,03/15/2016
2004,Fire Island,472814,98,10952,16,2958,13910,03/15/2016
2004,Shoreham-Wading River,473001,2979,2873772,769,1118553,3992325,03/15/2016
2004,Riverhead,473002,6229,5298970,2562,2858096,8157066,03/15/2016
2004,Shelter Island,473201,557,128815,252,97869,226684,03/15/2016
2004,Smithtown,473401,13325,12635510,2450,3689649,16325159,03/15/2016
2004,Kings Park,473405,5185,4285114,909,1253419,5538533,03/15/2016
2004,Remsenburg-Speonk,473601,404,126912,89,50777,177689,03/15/2016
2004,Westhampton Beach,473602,874,316763,250,156560,473323,03/15/2016
2004,Quogue,473603,234,26767,49,10154,36921,03/15/2016
2004,Hampton Bays,473605,1925,1163887,798,860814,2024701,03/15/2016
2004,Southhampton,473606,1657,297361,631,204701,502062,03/15/2016
2004,Bridgehampton,473609,291,43524,103,27909,71433,03/15/2016
2004,Sagaponack,473610,76,2390,12,684,3074,03/15/2016
2004,Tuckahoe Common,473613,473,193542,185,137141,330683,03/15/2016
2004,East Quogue,473617,937,644611,308,335670,980281,03/15/2016
2004,Oysterponds,473802,355,98831,206,95202,194033,03/15/2016
2004,Fishers Island,473804,39,10217,8,3486,13703,03/15/2016
2004,Southold,473805,1469,749787,626,528704,1278491,03/15/2016
2004,Greenport,473810,601,323266,323,282967,606233,03/15/2016
2004,Mattituck-Cutchogue,473812,2115,1216432,730,694869,1911301,03/15/2016
2004,New Suffolk,473815,73,16692,40,14851,31543,03/15/2016
2004,Fallsburg,482801,1098,1061967,355,506257,1568224,03/15/2016
2004,Eldred,483401,959,533470,373,325250,858720,03/15/2016
2004,Liberty,483601,1419,1308307,569,802635,2110942,03/15/2016
2004,Tri-Valley,484201,1217,879118,313,323637,1202755,03/15/2016
2004,Roscoe,484401,330,168558,188,141754,310312,03/15/2016
2004,Livingston Manor,484402,588,320323,260,203728,524051,03/15/2016
2004,Monticello,484601,2997,1992933,1064,1089634,3082567,03/15/2016
2004,Sullivan West,484802,2057,1110812,904,756942,1867754,03/15/2016
2004,Waverly,492001,1741,774647,632,417692,1192339,03/15/2016
2004,Candor,492401,989,576401,352,308772,885173,03/15/2016
2004,Newark Valley,492602,1630,1178341,506,544745,1723086,03/15/2016
2004,Owego-Apalachin,493001,2868,2039716,1018,1066583,3106299,03/15/2016
2004,Spencer-Van Etten,493401,1287,621251,375,267886,889137,03/15/2016
2004,Tioga,493603,1172,472470,349,211356,683826,03/15/2016
2004,Ithaca,500700,8054,5043762,1642,1481670,6525432,03/15/2016
2004,Dryden,502401,2377,1755873,548,537103,2292976,03/15/2016
2004,Groton,502801,1277,844158,313,294610,1138768,03/15/2016
2004,Lansing,503201,1614,981383,336,314002,1295385,03/15/2016
2004,Newfield,503401,1042,677823,258,192552,870375,03/15/2016
2004,Trumansburg,503601,1640,1033028,391,355104,1388132,03/15/2016
2004,Kingston,510800,8238,5628490,2910,3144597,8773087,03/15/2016
2004,Highland,513203,2165,1620740,523,626358,2247098,03/15/2016
2004,Rondout Valley,513401,3542,3003588,965,1215884,4219472,03/15/2016
2004,Marlboro,513601,2175,1284373,504,465361,1749734,03/15/2016
2004,New Paltz,513801,3086,2122363,616,695096,2817459,03/15/2016
2004,Onteora,514001,3300,1842796,1140,958642,2801438,03/15/2016
2004,Saugerties,514801,4179,2826634,1248,1338523,4165157,03/15/2016
2004,Wallkill,515201,3698,2884163,856,890157,3774320,03/15/2016
2004,Ellenville,515602,1540,1306944,573,629997,1936941,03/15/2016
2004,Glens Falls,520500,2723,1616689,830,812153,2428842,03/15/2016
2004,Bolton,522001,401,88955,146,52125,141080,03/15/2016
2004,Lake George,522201,1468,443736,428,207090,650826,03/15/2016
2004,North Warren,522402,978,350340,434,243751,594091,03/15/2016
2004,Johnsburg,523001,562,301761,241,198065,499826,03/15/2016
2004,Hadley-Luzerne,523201,1193,530061,484,329076,859137,03/15/2016
2004,Queensbury,523402,4233,2364969,1001,873813,3238782,03/15/2016
2004,Glens Falls Common,523418,238,90207,99,65674,155881,03/15/2016
2004,Warrensburg,524001,1187,788837,394,397005,1185842,03/15/2016
2004,Argyle,532001,848,530706,244,236276,766982,03/15/2016
2004,Fort Ann,532802,718,528897,212,249848,778745,03/15/2016
2004,Fort Edward,533001,516,390631,215,260159,650790,03/15/2016
2004,Granville,533201,1441,917638,494,464344,1381982,03/15/2016
2004,Greenwich,533401,1349,863686,469,479277,1342963,03/15/2016
2004,Hartford,533801,678,476443,176,187699,664142,03/15/2016
2004,Hudson Falls,534401,2459,1654105,935,948588,2602693,03/15/2016
2004,Putnam,534601,158,43113,55,23928,67041,03/15/2016
2004,Salem,534801,838,494310,303,279322,773632,03/15/2016
2004,Cambridge,535010,1261,735313,516,452569,1187882,03/15/2016
2004,Whitehall,535201,857,431560,412,280481,712041,03/15/2016
2004,Newark,542001,2701,1929600,944,1057473,2987073,03/15/2016
2004,Clyde-Savannah,542401,1108,823679,460,490310,1313989,03/15/2016
2004,Lyons,542801,1138,677108,453,380694,1057802,03/15/2016
2004,Gananda,543002,1372,1163877,89,122789,1286666,03/15/2016
2004,Marion,543201,1323,986210,272,316190,1302400,03/15/2016
2004,Wayne,543401,3545,2483668,630,705677,3189345,03/15/2016
2004,Palmyra-Macedon,543601,2563,2134404,658,836076,2970480,03/15/2016
2004,Sodus,544201,1578,1080808,541,535352,1616160,03/15/2016
2004,Williamson,544602,1512,1129943,399,479088,1609031,03/15/2016
2004,North Rose-Wolcott,544801,1898,1090901,705,573211,1664112,03/15/2016
2004,Red Creek,544803,1189,552614,395,269904,822518,03/15/2016
2004,Mount Vernon,550800,4949,11216797,1558,5343249,16560046,03/15/2016
2004,New Rochelle,551000,8475,15971761,1544,4826030,20797791,03/15/2016
2004,Peekskill,551200,3004,6513765,632,1936459,8450224,03/15/2016
2004,Rye,551400,3016,3419777,398,787416,4207193,03/15/2016
2004,White Plains,551700,6545,12918694,1151,3312958,16231652,03/15/2016
2004,Yonkers,551800,16331,25640781,4368,10577072,36217853,03/15/2016
2004,Katonah-Lewisboro,552001,4823,7656751,481,1306105,8962856,03/15/2016
2004,Bedford,552002,4880,5493789,664,1252213,6746002,03/15/2016
2004,Croton-Harmon,552202,2133,4382147,318,991794,5373941,03/15/2016
2004,Hendrick Hudson,552203,3322,5387075,526,1138568,6525643,03/15/2016
2004,Eastchester,552401,2934,6037467,711,2182934,8220401,03/15/2016
2004,Tuckahoe,552402,1167,2025172,245,643989,2669161,03/15/2016
2004,Bronxville,552403,1153,2216142,66,358599,2574741,03/15/2016
2004,Tarrytowns,552601,2314,4556120,461,1445544,6001664,03/15/2016
2004,Irvington,552602,1769,3424043,212,740050,4164093,03/15/2016
2004,Dobbs Ferry,552603,1462,3520377,212,847447,4367824,03/15/2016
2004,Hastings On Hudson,552604,1601,3959783,309,1210117,5169900,03/15/2016
2004,Ardsley,552605,2437,4360156,357,1050377,5410533,03/15/2016
2004,Edgemont,552606,1634,3432540,118,418563,3851103,03/15/2016
2004,Greenburgh,552607,4048,6342193,882,2034140,8376333,03/15/2016
2004,Elmsford,552609,1249,1878986,327,791255,2670241,03/15/2016
2004,Harrison,552801,3603,3307128,707,1234796,4541924,03/15/2016
2004,Mamaroneck,553201,4614,6348966,661,1587060,7936026,03/15/2016
2004,Mount Pleasant,553401,2670,3796141,676,1623395,5419536,03/15/2016
2004,Pocantico Hills,553402,452,328335,90,100164,428499,03/15/2016
2004,Valhalla,553405,1770,2988097,438,1268068,4256165,03/15/2016
2004,Pleasantville,553409,1894,3695361,335,1052482,4747843,03/15/2016
2004,Chappaqua,553604,4362,6823576,226,631933,7455509,03/15/2016
2004,Byram Hills,553801,2924,3366567,241,524979,3891546,03/15/2016
2004,North Salem,554001,1887,2670665,227,488847,3159512,03/15/2016
2004,Ossining,554201,5554,11405810,830,2705836,14111646,03/15/2016
2004,Briarcliff Manor,554202,1658,3572736,117,412953,3985689,03/15/2016
2004,Pelham,554401,2442,3604323,342,842870,4447193,03/15/2016
2004,Rye Neck,554801,1504,2394859,331,856584,3251443,03/15/2016
2004,Port Chester-Rye,554804,2777,4165234,1050,2435437,6600671,03/15/2016
2004,Blind Brook-Rye,554805,1640,2449485,176,437024,2886509,03/15/2016
2004,Scarsdale,555001,4604,6093201,217,512011,6605212,03/15/2016
2004,Somers,555201,4618,6245923,1040,2272219,8518142,03/15/2016
2004,Lakeland,555401,8333,16589140,1642,4377871,20967011,03/15/2016
2004,Yorktown,555402,5125,9728297,629,1935035,11663332,03/15/2016
2004,Attica,562201,2258,1209949,637,552616,1762565,03/15/2016
2004,Letchworth,562601,1404,750823,396,320414,1071237,03/15/2016
2004,Wyoming,563802,451,232749,92,75625,308374,03/15/2016
2004,Perry,564201,1252,684697,436,377916,1062613,03/15/2016
2004,Warsaw,564801,1355,921218,413,447819,1369037,03/15/2016
2004,Penn Yan,573001,2838,1225426,1159,766965,1992391,03/15/2016
2004,Dundee,573401,1135,530981,459,309105,840086,03/15/2016
2004,New York City School,650000,540457,118009441,97990,33849054,151858495,03/15/2016
2003,Albany,010100,9522,5964829,3815,3637539,9602368,03/15/2016
2003,Cohoes,010300,1942,1393770,847,907819,2301589,03/15/2016
2003,Watervliet,011800,1204,629850,558,450582,1080432,03/15/2016
2003,Berne-Knox-Westerlo,012001,1551,1076180,345,363164,1439344,03/15/2016
2003,Bethlehem,012206,6621,4879107,1164,1401812,6280919,03/15/2016
2003,Ravena-Coeymans-Selkirk,012402,2640,1615032,714,671287,2286319,03/15/2016
2003,South Colonie,012601,8269,4059180,2828,2223000,6282180,03/15/2016
2003,North Colonie,012605,7080,3161521,1714,1243127,4404648,03/15/2016
2003,Menands,012615,359,151307,114,76187,227494,03/15/2016
2003,Maplewood,012622,86,41283,62,45345,86628,03/15/2016
2003,Green Island,012801,259,199044,145,180232,379276,03/15/2016
2003,Guilderland,013002,6997,4357566,1491,1519672,5877238,03/15/2016
2003,Voorheesville,013403,1916,1286910,360,399778,1686688,03/15/2016
2003,Alfred-Almond,022001,829,610532,275,299910,910442,03/15/2016
2003,Andover,023001,457,370625,164,190698,561323,03/15/2016
2003,Genesee Valley,023202,701,315329,377,233162,548491,03/15/2016
2003,Belfast,023401,416,208974,173,115774,324748,03/15/2016
2003,Canaseraga,024002,387,211805,141,108262,320067,03/15/2016
2003,Cuba-Rushford,024801,1251,752388,528,460886,1213274,03/15/2016
2003,Friendship,025001,336,263490,163,160382,423872,03/15/2016
2003,Fillmore,025801,762,356283,253,168940,525223,03/15/2016
2003,Whitesville,026001,227,143420,100,79288,222708,03/15/2016
2003,Scio,026601,488,357837,186,186578,544415,03/15/2016
2003,Wellsville,027001,1642,947765,824,660506,1608271,03/15/2016
2003,Bolivar-Richburg,027602,970,393801,352,187564,581365,03/15/2016
2003,Binghamton,030200,5607,3538969,2777,2446542,5985511,03/15/2016
2003,Chenango Forks,032001,2161,1558336,596,651033,2209369,03/15/2016
2003,South Mountain-Hickory,032201,133,32698,25,10244,42942,03/15/2016
2003,Harpursville,032601,1109,535249,309,219869,755118,03/15/2016
2003,Susquehanna Valley,032801,2403,1906056,842,1019389,2925445,03/15/2016
2003,Chenango Valley,033001,2560,1820903,1182,1332689,3153592,03/15/2016
2003,Maine-Endwell,033801,3363,3258339,1379,1958209,5216548,03/15/2016
2003,Deposit,034201,692,364460,313,245101,609561,03/15/2016
2003,Whitney Point,034401,1676,937583,474,396076,1333659,03/15/2016
2003,Union-Endicott,034601,5320,4909143,2444,3388146,8297289,03/15/2016
2003,Johnson City,034602,2910,2171965,1681,1729131,3901096,03/15/2016
2003,Vestal,034801,5593,4436474,1817,2186259,6622733,03/15/2016
2003,Windsor,035001,2086,1351873,664,652755,2004628,03/15/2016
2003,Olean,041200,2775,1515713,1243,883954,2399667,03/15/2016
2003,Salamanca,041600,1137,472073,572,278527,750600,03/15/2016
2003,Allegany-Limestone,042001,1542,687889,520,320069,1007958,03/15/2016
2003,West Valley,042204,525,330850,167,157444,488294,03/15/2016
2003,Ellicottville,043601,717,284461,251,154341,438802,03/15/2016
2003,Franklinville,044001,889,499312,340,256279,755591,03/15/2016
2003,Hinsdale,044601,574,284589,221,151987,436576,03/15/2016
2003,Cattaraugus - Little Valley,046402,1460,803585,520,394625,1198210,03/15/2016
2003,Gowanda,047201,1459,813857,647,537433,1351290,03/15/2016
2003,Portville,047401,1103,647995,378,326742,974737,03/15/2016
2003,Randolph,047601,1206,488015,421,238795,726810,03/15/2016
2003,Yorkshire-Pioneer,048401,3122,1362715,970,614466,1977181,03/15/2016
2003,Auburn,050100,5016,3121801,2392,2229441,5351242,03/15/2016
2003,Weedsport,052201,1235,736449,250,337893,1074342,03/15/2016
2003,Cato-Meridian,052401,1407,854030,322,286571,1140601,03/15/2016
2003,Southern Cayuga,053001,1241,674147,394,323841,997988,03/15/2016
2003,Port Byron,053801,1400,921209,458,432731,1353940,03/15/2016
2003,Moravia,054201,1428,677166,342,240505,917671,03/15/2016
2003,Union Springs,055401,1243,925279,408,465474,1390753,03/15/2016
2003,Dunkirk,060300,2266,1782570,1282,1399982,3182552,03/15/2016
2003,Jamestown,060800,4831,2614669,1927,1415110,4029779,03/15/2016
2003,Southwestern,062201,2293,1511479,794,809623,2321102,03/15/2016
2003,Frewsburg,062401,1044,673594,358,355887,1029481,03/15/2016
2003,Cassadaga Valley,062601,1407,733161,498,378901,1112062,03/15/2016
2003,Chautauqua Lake,062803,1212,366846,442,213926,580772,03/15/2016
2003,Pine Valley,063001,816,581357,291,299359,880716,03/15/2016
2003,Clymer,063201,601,274091,245,176584,450675,03/15/2016
2003,Bemus Point,063601,1150,586622,414,320484,907106,03/15/2016
2003,Falconer,063801,1545,971221,534,512998,1484219,03/15/2016
2003,Silver Creek,064601,1238,733845,507,447787,1181632,03/15/2016
2003,Forestville,064603,849,441064,302,240738,681802,03/15/2016
2003,Panama,064801,808,455532,245,205343,660875,03/15/2016
2003,Fredonia,065801,2082,1349167,740,776872,2126039,03/15/2016
2003,Brocton,066001,793,622166,285,318467,940633,03/15/2016
2003,Ripley,066201,424,311937,177,175934,487871,03/15/2016
2003,Sherman,066601,539,289404,134,106589,395993,03/15/2016
2003,Westfield,067201,1021,738091,365,396396,1134487,03/15/2016
2003,Elmira,070400,7451,4487816,3265,2851375,7339191,03/15/2016
2003,Horseheads,073401,5362,3063302,1908,1728946,4792248,03/15/2016
2003,Elmira Heights,073402,1197,698368,606,538538,1236906,03/15/2016
2003,Norwich,081100,2218,1505361,824,776198,2281559,03/15/2016
2003,Afton,082001,820,561729,308,311528,873257,03/15/2016
2003,Bainbridge-Guilford,082201,1110,692037,401,359202,1051239,03/15/2016
2003,Greene,083001,1476,952350,458,451715,1404065,03/15/2016
2003,Unadilla Valley,083803,1091,539367,391,269123,808490,03/15/2016
2003,Georgetown-So Otselic Valley,084401,536,318408,129,97697,416105,03/15/2016
2003,Oxford Academy,084601,1061,671835,399,360542,1032377,03/15/2016
2003,Sherburne-Earlville,085601,1672,968917,585,500067,1468984,03/15/2016
2003,Plattsburgh,091300,1994,1369029,749,807554,2176583,03/15/2016
2003,Ausable Valley,092201,1859,947117,679,474523,1421640,03/15/2016
2003,Beekmantown,092401,2576,1252948,737,510268,1763216,03/15/2016
2003,Northeastern Clinton,092801,1950,1313392,580,552164,1865556,03/15/2016
2003,Chazy,093001,706,452803,180,171334,624137,03/15/2016
2003,Northern Adirondack,093601,1367,499912,426,205734,705646,03/15/2016
2003,Peru,094001,2575,1293223,548,408825,1702048,03/15/2016
2003,Saranac,094401,2225,1283823,663,567760,1851583,03/15/2016
2003,Hudson,100600,1956,1173296,1042,921832,2095128,03/15/2016
2003,Taconic Hills,102801,1980,910230,830,605556,1515786,03/15/2016
2003,Germantown,103602,835,442010,333,282321,724331,03/15/2016
2003,Chatham,103801,1825,938581,561,480778,1419359,03/15/2016
2003,Kinderhook,104401,2863,1535894,742,626601,2162495,03/15/2016
2003,New Lebanon,104801,861,473152,234,199857,673009,03/15/2016
2003,Cortland,110200,2951,1598938,1138,972356,2571294,03/15/2016
2003,Cincinnatus,112001,714,326345,245,149372,475717,03/15/2016
2003,Mc Graw,112204,711,375882,228,181890,557772,03/15/2016
2003,Homer,113001,2700,1750841,750,753185,2504026,03/15/2016
2003,Marathon,113401,892,569388,289,265583,834971,03/15/2016
2003,Andes,122002,236,92460,150,93273,185733,03/15/2016
2003,Downsville,122401,371,144118,213,115265,259383,03/15/2016
2003,Charlotte Valley,122601,553,265743,229,166358,432101,03/15/2016
2003,Delhi,122801,1178,594925,535,433623,1028548,03/15/2016
2003,Franklin,123201,443,211424,155,116416,327840,03/15/2016
2003,Hancock,123606,449,270927,245,209683,480610,03/15/2016
2003,Margaretville,124601,670,231045,344,187794,418839,03/15/2016
2003,Roxbury,124802,525,282221,265,212770,494991,03/15/2016
2003,Sidney,125001,1390,979218,681,710798,1690016,03/15/2016
2003,Stamford,125201,545,438873,202,248111,686984,03/15/2016
2003,South Kortright,125202,474,244207,227,185028,429235,03/15/2016
2003,Walton,125601,1166,477137,505,317851,794988,03/15/2016
2003,Beacon,130200,2903,1886876,898,948742,2835618,03/15/2016
2003,Poughkeepsie,131300,2657,1743424,1030,1056266,2799690,03/15/2016
2003,Dover,132602,1450,1350785,304,482523,1833308,03/15/2016
2003,Hyde Park,133201,5212,4115383,1480,1807930,5923313,03/15/2016
2003,Northeast,133801,920,569205,312,312624,881829,03/15/2016
2003,Pawling,134001,1684,1210797,354,422470,1633267,03/15/2016
2003,Pine Plains,134201,1716,871653,519,411630,1283283,03/15/2016
2003,Arlington,134601,10602,7690171,1836,2181356,9871527,03/15/2016
2003,Spackenkill,134602,1798,1275159,429,488742,1763901,03/15/2016
2003,Red Hook,134801,2082,1608026,610,769158,2377184,03/15/2016
2003,Rhinebeck,135001,1702,1039512,497,485727,1525239,03/15/2016
2003,Wappingers,135601,14198,7714132,3104,2790423,10504555,03/15/2016
2003,Millbrook,135801,1367,645290,324,255952,901242,03/15/2016
2003,Buffalo,140200,28153,11696128,10444,5538326,17234454,03/15/2016
2003,Lackawanna,140900,2085,590810,1563,579833,1170643,03/15/2016
2003,Tonawanda,141600,3062,1695658,1417,1228993,2924651,03/15/2016
2003,Alden,142001,2575,1690168,811,843952,2534120,03/15/2016
2003,Amherst,142201,5446,3661120,1552,1646250,5307370,03/15/2016
2003,Williamsville,142203,15783,9264589,3551,3314134,12578723,03/15/2016
2003,Sweet Home,142207,5088,2064805,2121,1410354,3475159,03/15/2016
2003,East Aurora,142401,2778,1486910,853,743533,2230443,03/15/2016
2003,Cheektowaga,143001,3429,1730949,1968,1467688,3198637,03/15/2016
2003,Cheektowaga-Maryvale,143002,3364,1719663,2229,1808755,3528418,03/15/2016
2003,Cleveland Hill,143003,2270,1642415,1113,1275658,2918073,03/15/2016
2003,Depew,143007,3299,2220572,1220,1323030,3543602,03/15/2016
2003,Cheektowaga-Sloan,143009,2095,1561401,1583,1889385,3450786,03/15/2016
2003,Clarence,143201,5810,2920804,1385,1003559,3924363,03/15/2016
2003,Springville-Griffith,143801,2844,1632189,885,788469,2420658,03/15/2016
2003,Eden,144001,2269,1091686,667,525542,1617228,03/15/2016
2003,Iroquois,144201,3942,1671695,1222,839260,2510955,03/15/2016
2003,Evans-Brant,144401,4002,2381100,1095,928873,3309973,03/15/2016
2003,Grand Island,144601,4525,2761794,949,925103,3686897,03/15/2016
2003,Hamburg,144801,5235,2709704,1501,1287370,3997074,03/15/2016
2003,Frontier,144804,7212,3322335,2290,1604798,4927133,03/15/2016
2003,Holland,145001,1592,684319,385,270190,954509,03/15/2016
2003,Lancaster,145201,8696,4344930,2711,2086622,6431552,03/15/2016
2003,Akron,145601,1825,932914,589,419892,1352806,03/15/2016
2003,North Collins,145801,897,515227,303,273048,788275,03/15/2016
2003,Orchard Park,146001,7297,3902499,1703,1488297,5390796,03/15/2016
2003,Kenmore,146401,13989,8922708,6612,6843048,15765756,03/15/2016
2003,West Seneca,146801,11447,6089710,4872,4067718,10157428,03/15/2016
2003,Crown Point,152203,396,156978,169,100307,257285,03/15/2016
2003,Elizabethtown-Lewis,152401,503,258509,167,133318,391827,03/15/2016
2003,Keene,153001,246,88056,85,49597,137653,03/15/2016
2003,Minerva,153401,216,121107,84,71034,192141,03/15/2016
2003,Moriah,153601,882,383777,502,298245,682022,03/15/2016
2003,Newcomb,153801,123,9237,68,7537,16774,03/15/2016
2003,Lake Placid,154002,1113,391765,329,169579,561344,03/15/2016
2003,Schroon Lake,154601,412,115469,208,91710,207179,03/15/2016
2003,Ticonderoga,154801,1120,371905,489,249895,621800,03/15/2016
2003,Westport,155001,324,184536,112,99609,284145,03/15/2016
2003,Willsboro,155201,494,240814,260,189315,430129,03/15/2016
2003,Tupper Lake,162001,1259,514355,520,266136,780491,03/15/2016
2003,Chateaugay,163401,697,369505,230,167489,536994,03/15/2016
2003,Salmon River,164201,775,354629,289,189356,543985,03/15/2016
2003,Saranac Lake,164601,2107,828789,637,360763,1189552,03/15/2016
2003,Malone,164801,2886,1558825,1079,794683,2353508,03/15/2016
2003,Brushton-Moira,165001,893,456714,323,232365,689079,03/15/2016
2003,St. Regis Falls,165401,434,185634,168,98922,284556,03/15/2016
2003,Gloversville,170500,3091,1932450,1429,1133003,3065453,03/15/2016
2003,Johnstown,170800,2110,1202571,772,650741,1853312,03/15/2016
2003,Broadalbin-Perth,172201,2141,879089,689,438901,1317990,03/15/2016
2003,Wheelerville,172401,348,166869,135,100113,266982,03/15/2016
2003,Mayfield,173001,1341,701446,474,368451,1069897,03/15/2016
2003,Northville,173201,615,288759,274,190697,479456,03/15/2016
2003,Oppenheim-Ephratah,173401,601,361025,185,151179,512204,03/15/2016
2003,Batavia,180200,2981,2096994,1168,1270472,3367466,03/15/2016
2003,Alexander,182202,1151,900893,322,387336,1288229,03/15/2016
2003,Byron-Bergen,183001,1558,1155183,433,441394,1596577,03/15/2016
2003,Elba,183401,594,453631,174,212174,665805,03/15/2016
2003,Le Roy,183601,1647,1084162,519,534058,1618220,03/15/2016
2003,Oakfield-Alabama,183801,1085,829644,385,453897,1283541,03/15/2016
2003,Pavilion,184001,1147,813826,264,286160,1099986,03/15/2016
2003,Pembroke,184202,1428,906357,448,435398,1341755,03/15/2016
2003,Cairo-Durham,192401,1692,762740,712,503378,1266118,03/15/2016
2003,Catskill,192601,2059,1231298,800,739559,1970857,03/15/2016
2003,Coxsackie-Athens,192801,1822,1035179,600,528439,1563618,03/15/2016
2003,Greenville,193201,1730,1118589,606,619595,1738184,03/15/2016
2003,Hunter-Tannersville,193601,661,292533,291,199092,491625,03/15/2016
2003,Windham-Ashland-Jewett,194601,556,191847,262,144106,335953,03/15/2016
2003,Piseco,202001,80,8016,38,6427,14443,03/15/2016
2003,Indian Lake,202601,318,90247,159,71772,162019,03/15/2016
2003,Inlet,202801,89,12055,41,9151,21206,03/15/2016
2003,Lake Pleasant,203001,190,57127,97,46296,103423,03/15/2016
2003,Long Lake,203201,165,38065,103,37210,75275,03/15/2016
2003,Raquette Lake,203202,26,1525,13,1299,2824,03/15/2016
2003,Wells,203601,223,89388,120,75780,165168,03/15/2016
2003,Little Falls,210900,1198,805293,652,623361,1428654,03/15/2016
2003,West Canada Valley,212402,972,489390,301,232887,722277,03/15/2016
2003,Frankfort-Schuyler,212602,1284,809621,598,584799,1394420,03/15/2016
2003,Ilion,212801,1580,646263,608,378294,1024557,03/15/2016
2003,Mohawk,212802,1055,569101,446,363873,932974,03/15/2016
2003,Herkimer,213001,1442,854081,832,686572,1540653,03/15/2016
2003,Dolgeville,213602,998,417119,431,249732,666851,03/15/2016
2003,Poland,213803,885,372575,292,189386,561961,03/15/2016
2003,Van Hornesville-Owen D. Young,215001,313,190936,120,112352,303288,03/15/2016
2003,Town Of Webb,215401,557,111734,273,86647,198381,03/15/2016
2003,Mount Markham,215601,1454,1002325,444,454057,1456382,03/15/2016
2003,Watertown,221800,3456,1415905,1431,850104,2266009,03/15/2016
2003,South Jefferson,222001,1994,835116,548,328528,1163644,03/15/2016
2003,Alexandria,222202,778,289663,279,157065,446728,03/15/2016
2003,Indian River,222401,1564,306138,419,111353,417491,03/15/2016
2003,General Brown,222601,1724,668932,511,300649,969581,03/15/2016
2003,Thousand Islands,223201,1398,655949,602,423840,1079789,03/15/2016
2003,Belleville-Henderson,223402,647,194973,300,132427,327400,03/15/2016
2003,Sackets Harbor,223801,544,271382,186,139741,411123,03/15/2016
2003,Lyme,224401,469,196475,245,157567,354042,03/15/2016
2003,La Fargeville,224601,556,220289,157,90840,311129,03/15/2016
2003,Carthage,226001,2300,1273896,787,622131,1896027,03/15/2016
2003,Copenhagen,232201,546,204345,138,77349,281694,03/15/2016
2003,Harrisville,232401,538,306589,192,131692,438281,03/15/2016
2003,Lowville,233601,1510,649850,549,330894,980744,03/15/2016
2003,South Lewis,234001,1454,632916,561,327185,960101,03/15/2016
2003,Beaver River,234401,1174,411882,366,182738,594620,03/15/2016
2003,Avon,242001,1167,912552,326,397308,1309860,03/15/2016
2003,Caledonia-Mumford,242201,1303,806245,355,350574,1156819,03/15/2016
2003,Geneseo,242601,1322,730984,321,287318,1018302,03/15/2016
2003,Livonia,243401,2531,1495300,572,524896,2020196,03/15/2016
2003,Mount Morris,243601,619,428598,255,264011,692609,03/15/2016
2003,Dansville,243801,2071,1039781,682,517970,1557751,03/15/2016
2003,Dalton-Nunda,244001,1141,785147,340,338103,1123250,03/15/2016
2003,York,245201,1105,605578,321,275474,881052,03/15/2016
2003,Oneida,251200,2712,1485893,931,784552,2270445,03/15/2016
2003,Brookfield,252009,296,144568,81,56570,201138,03/15/2016
2003,Cazenovia,252201,2170,1256650,525,487155,1743805,03/15/2016
2003,De Ruyter,252401,530,324710,184,161726,486436,03/15/2016
2003,Morrisville-Eaton,252601,953,512471,236,181883,694354,03/15/2016
2003,Hamilton,253201,894,522405,243,218221,740626,03/15/2016
2003,Canastota,253601,1827,1079024,654,591271,1670295,03/15/2016
2003,Madison,254001,608,403219,187,176912,580131,03/15/2016
2003,Stockbridge Valley,254601,515,285114,164,134435,419549,03/15/2016
2003,Chittenango,254801,3093,2184303,758,772235,2956538,03/15/2016
2003,Rochester,261400,25498,10928198,5545,3344637,14272835,03/15/2016
2003,Brighton,262001,5134,3749133,957,1152634,4901767,03/15/2016
2003,Gates-Chili,262601,7705,5573565,2859,3288546,8862111,03/15/2016
2003,Greece,262801,18161,12266661,5411,5906288,18172949,03/15/2016
2003,East Irondequoit,263401,6172,4725131,2687,3254369,7979500,03/15/2016
2003,West Irondequoit,263403,6200,5495914,2040,2974325,8470239,03/15/2016
2003,Honeoye Falls-Lima,263601,3180,2221882,509,585630,2807512,03/15/2016
2003,Spencerport,263801,5116,3848923,1214,1468498,5317421,03/15/2016
2003,Hilton,264001,5992,4063045,1133,1246659,5309704,03/15/2016
2003,Penfield,264201,7864,6139952,1473,1856300,7996252,03/15/2016
2003,Fairport,264401,9535,6229094,1951,2052684,8281778,03/15/2016
2003,East Rochester,264413,1645,1161587,665,709828,1871415,03/15/2016
2003,Pittsford,264601,8270,5406840,1058,1138048,6544888,03/15/2016
2003,Churchville-Chili,264801,5398,3951965,1213,1430093,5382058,03/15/2016
2003,Rush-Henrietta,265001,7962,4751852,2049,1989935,6741787,03/15/2016
2003,Brockport,265201,4741,3268899,782,845964,4114863,03/15/2016
2003,Webster,265401,11827,7594829,2938,3073771,10668600,03/15/2016
2003,Wheatland-Chili,265601,1276,967284,384,455309,1422593,03/15/2016
2003,Amsterdam,270100,3845,2779504,2109,2280121,5059625,03/15/2016
2003,Canajoharie,272201,1156,693566,465,431629,1125195,03/15/2016
2003,Fonda-Fultonville,272801,1757,1197149,595,559951,1757100,03/15/2016
2003,Fort Plain,273001,949,815224,393,477362,1292586,03/15/2016
2003,St. Johnsville,273802,564,297399,298,219076,516475,03/15/2016
2003,Glen Cove,280500,3123,2808988,1196,1650375,4459363,03/15/2016
2003,Long Beach,281000,6580,4338397,1034,1312827,5651224,03/15/2016
2003,Hempstead,282001,2695,4073303,494,1281123,5354426,03/15/2016
2003,Uniondale,282002,4516,3882868,871,1342494,5225362,03/15/2016
2003,East Meadow,282003,10294,10689339,2972,4863292,15552631,03/15/2016
2003,North Bellmore,282004,5564,5442472,1228,2145624,7588096,03/15/2016
2003,Levittown,282005,10502,13840722,2340,5618790,19459512,03/15/2016
2003,Seaford,282006,3689,3519891,842,1406619,4926510,03/15/2016
2003,Bellmore,282007,2980,2854682,507,854153,3708835,03/15/2016
2003,Roosevelt,282008,2046,2262742,349,686451,2949193,03/15/2016
2003,Freeport,282009,5147,6365766,928,2004989,8370755,03/15/2016
2003,Baldwin,282010,6810,7857719,1109,2226302,10084021,03/15/2016
2003,Oceanside,282011,8153,7234031,1722,2691528,9925559,03/15/2016
2003,Malverne,282012,2902,3222320,629,1295588,4517908,03/15/2016
2003,Valley Stream 13,282013,5693,6178320,1543,2844314,9022634,03/15/2016
2003,Hewlett-Woodmere,282014,4552,5052966,647,1219996,6272962,03/15/2016
2003,Lawrence,282015,5939,4225897,900,1233464,5459361,03/15/2016
2003,Elmont,282016,7117,6697979,1733,2928054,9626033,03/15/2016
2003,Franklin Square,282017,4718,3933656,1514,2272412,6206068,03/15/2016
2003,Garden City,282018,5413,3199156,742,790026,3989182,03/15/2016
2003,East Rockaway,282019,1908,2038939,518,973210,3012149,03/15/2016
2003,Lynbrook,282020,3622,3725777,774,1440188,5165965,03/15/2016
2003,Rockville Centre,282021,4551,3904607,679,1100392,5004999,03/15/2016
2003,Floral Park-Bellerose,282022,3943,3350202,862,1299023,4649225,03/15/2016
2003,Wantagh,282023,4229,4118746,739,1312523,5431269,03/15/2016
2003,Valley Stream 24,282024,2330,2090904,601,959184,3050088,03/15/2016
2003,Merrick,282025,4571,4090843,570,874333,4965176,03/15/2016
2003,Island Trees,282026,3166,3288115,775,1458888,4747003,03/15/2016
2003,West Hempstead,282027,3429,3321391,690,1217699,4539090,03/15/2016
2003,North Merrick,282029,3151,3130496,701,1269692,4400188,03/15/2016
2003,Valley Stream 30,282030,2706,1973050,687,927228,2900278,03/15/2016
2003,Island Park,282031,1470,1032754,309,369677,1402431,03/15/2016
2003,Westbury,282201,2787,3674209,641,1434844,5109053,03/15/2016
2003,East Williston,282202,2040,1939369,233,397107,2336476,03/15/2016
2003,Roslyn,282203,3912,3627325,363,627746,4255071,03/15/2016
2003,Port Washington,282204,5327,3633149,705,863325,4496474,03/15/2016
2003,New Hyde Park-Garden City,282205,4305,3132210,1323,1735934,4868144,03/15/2016
2003,Manhasset,282206,3562,1949749,343,362613,2312362,03/15/2016
2003,Great Neck,282207,8732,4227075,1052,929097,5156172,03/15/2016
2003,Herricks,282209,5684,4489761,1076,1672500,6162261,03/15/2016
2003,Mineola,282210,4103,3265072,1190,1745416,5010488,03/15/2016
2003,Carle Place,282211,1756,1439700,484,723714,2163414,03/15/2016
2003,North Shore,282401,3407,2136756,594,670361,2807117,03/15/2016
2003,Syosset,282402,7674,6721541,1134,1556939,8278480,03/15/2016
2003,Locust Valley,282403,3156,1892277,460,536691,2428968,03/15/2016
2003,Plainview-Old Bethpage,282404,6884,6410428,1321,2311720,8722148,03/15/2016
2003,Oyster Bay-East Norwich,282406,2459,1386919,370,401894,1788813,03/15/2016
2003,Jericho,282415,3176,2304708,312,418853,2723561,03/15/2016
2003,Hicksville,282417,7164,4694745,2117,2589478,7284223,03/15/2016
2003,Plainedge,282418,4300,4782004,1167,2384676,7166680,03/15/2016
2003,Bethpage,282421,3816,2958137,1437,1512303,4470440,03/15/2016
2003,Farmingdale,282422,7967,9259158,2072,4245363,13504521,03/15/2016
2003,Massapequa,282423,11115,9205939,2379,3660491,12866430,03/15/2016
2003,Lockport,290900,6087,5194193,1782,2115474,7309667,03/15/2016
2003,Niagara Falls,291100,7567,3674627,4111,2780385,6455012,03/15/2016
2003,North Tonawanda,291200,6044,4083027,2416,2598363,6681390,03/15/2016
2003,Lewiston-Porter,292401,3921,2514596,1360,1435422,3950018,03/15/2016
2003,Newfane,292801,2290,1911140,728,971727,2882867,03/15/2016
2003,Niagara-Wheatfield,293001,4659,2586084,1632,1369361,3955445,03/15/2016
2003,Starpoint,293201,3630,2338314,870,901765,3240079,03/15/2016
2003,Royalton-Hartland,293601,2005,1417187,584,657045,2074232,03/15/2016
2003,Barker,293801,1114,691616,323,311747,1003363,03/15/2016
2003,Wilson,294201,1781,1327236,560,664512,1991748,03/15/2016
2003,Rome,301300,5798,4004147,2703,2651525,6655672,03/15/2016
2003,Utica,301600,7218,4451406,4142,3629282,8080688,03/15/2016
2003,Adirondack,302601,1820,938877,641,451516,1390393,03/15/2016
2003,Camden,303001,2767,1527933,867,641673,2169606,03/15/2016
2003,Clinton,304001,1852,1475681,589,627222,2102903,03/15/2016
2003,New Hartford,304801,3627,2627587,1267,1433850,4061437,03/15/2016
2003,New York Mills,304804,781,526018,527,579546,1105564,03/15/2016
2003,Sauquoit Valley,305002,1371,844617,404,378554,1223171,03/15/2016
2003,Remsen,305201,732,472260,220,201239,673499,03/15/2016
2003,Waterville,305401,1093,662803,356,321124,983927,03/15/2016
2003,Holland Patent,305801,2062,1255167,595,549994,1805161,03/15/2016
2003,Sherrill,306000,2642,1630004,879,833914,2463918,03/15/2016
2003,Westmoreland,306801,1411,1264080,512,639773,1903853,03/15/2016
2003,Oriskany,307001,900,649914,335,372965,1022879,03/15/2016
2003,Whitesboro,307002,4720,3212917,1911,2023138,5236055,03/15/2016
2003,Syracuse,311500,15739,6928466,5686,3816226,10744692,03/15/2016
2003,West Genesee,312001,6912,4674083,2653,2816445,7490528,03/15/2016
2003,North Syracuse,312403,13315,9035888,3443,3388367,12424255,03/15/2016
2003,East Syracuse-Minoa,312601,4826,3317219,1760,1768327,5085546,03/15/2016
2003,Jamesville-Dewitt,312611,3942,2459099,844,835903,3295002,03/15/2016
2003,Jordan-Elbridge,312801,1744,1366720,527,574831,1941551,03/15/2016
2003,Fabius-Pompey,313001,1084,759592,251,274425,1034017,03/15/2016
2003,Westhill,313201,2535,1879309,963,1149311,3028620,03/15/2016
2003,Solvay,313202,1769,1247242,1030,1139010,2386252,03/15/2016
2003,La Fayette,313407,1027,591368,262,226100,817468,03/15/2016
2003,Baldwinsville,313601,7707,5331310,1689,1745739,7077049,03/15/2016
2003,Fayetteville-Manlius,313801,6205,4598606,1054,1252423,5851029,03/15/2016
2003,Marcellus,314001,2545,1539246,674,650639,2189885,03/15/2016
2003,Onondaga,314201,1386,1053489,429,491188,1544677,03/15/2016
2003,Liverpool,314801,10483,7924505,2884,3244267,11168772,03/15/2016
2003,Lyncourt,314804,778,652003,488,566574,1218577,03/15/2016
2003,Skaneateles,315001,2221,1197580,593,517091,1714671,03/15/2016
2003,Tully,315402,1334,788590,271,251397,1039987,03/15/2016
2003,Canandaigua,320200,4064,2377594,1033,960884,3338478,03/15/2016
2003,Geneva,320500,2570,1622234,1174,1115552,2737786,03/15/2016
2003,East Bloomfield,322601,1343,979092,304,338852,1317944,03/15/2016
2003,Gorham-Middlesex,323201,2080,1144397,610,525594,1669991,03/15/2016
2003,Manchester-Shortsville,323601,1160,942009,401,487859,1429868,03/15/2016
2003,Naples,323801,1318,732744,331,287227,1019971,03/15/2016
2003,Phelps-Clifton Springs,324001,2267,1679743,632,736875,2416618,03/15/2016
2003,Honeoye,324201,1490,806393,385,332267,1138660,03/15/2016
2003,Victor,324801,4137,2697631,683,697007,3394638,03/15/2016
2003,Middletown,330900,4845,3740420,1322,1554761,5295181,03/15/2016
2003,Newburgh,331100,8782,6911819,2566,3131712,10043531,03/15/2016
2003,Port Jervis,331300,2569,2232425,926,1166711,3399136,03/15/2016
2003,Washingtonville,332002,5101,3832551,622,774473,4607024,03/15/2016
2003,Chester,332201,1281,1040216,213,277618,1317834,03/15/2016
2003,Cornwall,332401,3233,2424596,559,667321,3091917,03/15/2016
2003,Pine Bush,332601,5578,4147937,943,1137391,5285328,03/15/2016
2003,Goshen,333001,2888,1899025,567,618555,2517580,03/15/2016
2003,Highland Falls,333601,775,490901,253,261511,752412,03/15/2016
2003,Minisink Valley,333801,4236,3138872,681,805729,3944601,03/15/2016
2003,Monroe-Woodbury,334001,8186,7016187,974,1474147,8490334,03/15/2016
2003,Kiryas Joel Village,334002,817,301901,44,26824,328725,03/15/2016
2003,Valley,334201,4880,3346630,1068,1168318,4514948,03/15/2016
2003,Tuxedo,335003,519,156869,92,52772,209641,03/15/2016
2003,Warwick Valley,335401,4935,3621343,805,967818,4589161,03/15/2016
2003,Greenwood Lake,335411,1393,1082924,254,324401,1407325,03/15/2016
2003,Florida,335415,1029,775373,263,325043,1100416,03/15/2016
2003,Albion,342001,2295,1436269,803,779716,2215985,03/15/2016
2003,Kendall,343007,1227,899041,266,308897,1207938,03/15/2016
2003,Holley,343204,1434,1219683,433,540895,1760578,03/15/2016
2003,Medina,343401,1959,1393332,765,842830,2236162,03/15/2016
2003,Lyndonville,343801,893,549983,313,295998,845981,03/15/2016
2003,Fulton,350400,3590,2679027,1260,1296050,3975077,03/15/2016
2003,Oswego,351200,5015,3535192,1736,1826042,5361234,03/15/2016
2003,Altmar Parish-Williamstown,352002,1541,946009,403,352304,1298313,03/15/2016
2003,Hannibal,353001,1660,914215,392,316222,1230437,03/15/2016
2003,Central Square,353201,5287,3059707,1235,1016659,4076366,03/15/2016
2003,Mexico,353401,2730,1685728,624,573842,2259570,03/15/2016
2003,Pulaski,355001,1250,784164,304,285214,1069378,03/15/2016
2003,Sandy Creek,355201,1172,717959,391,336679,1054638,03/15/2016
2003,Phoenix,355401,2700,2134010,666,775554,2909564,03/15/2016
2003,Oneonta,361200,2485,1657415,865,913867,2571282,03/15/2016
2003,Gilbertsville-Mt Upton,362202,654,322116,230,167263,489379,03/15/2016
2003,Cherry Valley-Springfield,362401,828,389775,379,265547,655322,03/15/2016
2003,Edmeston,362801,568,266546,216,157063,423609,03/15/2016
2003,Laurens,363401,552,351960,172,176005,527965,03/15/2016
2003,Schenevus,363601,543,339574,196,177282,516856,03/15/2016
2003,Milford,364001,612,372489,264,249748,622237,03/15/2016
2003,Morris,364201,524,331466,212,207483,538949,03/15/2016
2003,Otego-Unadilla,364801,1363,892344,525,497372,1389716,03/15/2016
2003,Cooperstown,365001,1193,569727,487,366213,935940,03/15/2016
2003,Richfield Springs,365601,753,311238,383,249234,560472,03/15/2016
2003,Worcester,366606,477,284243,226,205241,489484,03/15/2016
2003,Mahopac,372001,5816,5998996,785,1347040,7346036,03/15/2016
2003,Carmel,372002,6298,6123038,846,1357726,7480764,03/15/2016
2003,Haldane,372601,962,790631,263,333058,1123689,03/15/2016
2003,Garrison,372604,506,287197,71,67051,354248,03/15/2016
2003,Putnam Valley,372803,2516,3468955,306,671819,4140774,03/15/2016
2003,Brewster,373001,4725,4194179,786,1195138,5389317,03/15/2016
2003,Rensselaer,381400,1123,866006,394,401166,1267172,03/15/2016
2003,Troy,381700,4127,3164246,1500,1588668,4752914,03/15/2016
2003,Lansingburgh,381701,2554,1859644,930,968554,2828198,03/15/2016
2003,Berlin,382001,1461,905485,412,374925,1280410,03/15/2016
2003,Brunswick,382202,1712,1214286,446,486670,1700956,03/15/2016
2003,East Greenbush,382401,6331,4297846,1539,1643342,5941188,03/15/2016
2003,Hoosick Falls,382801,1556,904010,571,485790,1389800,03/15/2016
2003,North Greenbush,383201,328,73096,122,44194,117290,03/15/2016
2003,Wynantskill,383204,805,490589,295,284483,775072,03/15/2016
2003,Averill Park,384001,4209,2718615,953,947912,3666527,03/15/2016
2003,Hoosic Valley,384201,1442,985925,375,382428,1368353,03/15/2016
2003,Schodack,384401,1414,1085822,335,400065,1485887,03/15/2016
2003,Clarkstown,392001,11550,9427574,1665,2265314,11692888,03/15/2016
2003,Nanuet,392008,2324,1782350,607,766392,2548742,03/15/2016
2003,Haverstraw-Stony Point,392201,7822,9328788,1724,3094286,12423074,03/15/2016
2003,South Orangetown,392401,4091,3700903,991,1520640,5221543,03/15/2016
2003,Nyack,392404,3883,4352723,787,1558478,5911201,03/15/2016
2003,Pearl River,392408,2977,3096076,730,1289703,4385779,03/15/2016
2003,Ramapo,392601,5856,8017539,1055,2321292,10338831,03/15/2016
2003,East Ramapo,392602,12308,14288203,1672,3011418,17299621,03/15/2016
2003,Ogdensburg,401200,2112,1133867,730,466582,1600449,03/15/2016
2003,Brasher Falls,402001,1264,615572,415,286439,902011,03/15/2016
2003,Canton,402201,1630,979683,456,400692,1380375,03/15/2016
2003,Clifton-Fine,402601,469,188901,255,125206,314107,03/15/2016
2003,Colton-Pierrepont,402801,576,247718,208,132722,380440,03/15/2016
2003,Edwards-Knox,403401,712,224817,212,88443,313260,03/15/2016
2003,Gouverneur,404001,2084,861103,598,364300,1225403,03/15/2016
2003,Hammond,404201,360,123426,147,71950,195376,03/15/2016
2003,Hermon-Dekalb,404401,523,283114,178,135206,418320,03/15/2016
2003,Lisbon,405002,761,425626,243,195470,621096,03/15/2016
2003,Madrid-Waddington,405601,965,535300,311,248228,783528,03/15/2016
2003,Massena,405801,3288,1758635,1381,1119366,2878001,03/15/2016
2003,Morristown,406001,606,287343,208,146015,433358,03/15/2016
2003,Norwood-Norfolk,406201,1350,848057,471,397067,1245124,03/15/2016
2003,Heuvelton,406404,801,444640,248,196379,641019,03/15/2016
2003,Parishville-Hopkinton,406601,668,264882,162,82142,347024,03/15/2016
2003,Potsdam,407402,1874,1382475,555,588239,1970714,03/15/2016
2003,Mechanicville,411000,1267,672913,589,513657,1186570,03/15/2016
2003,Saratoga Springs,411500,8853,4571230,1682,1376014,5947244,03/15/2016
2003,Burnt Hills-Ballston Lake,412001,4628,3175853,1126,1264909,4440762,03/15/2016
2003,Shenendehowa,412402,12500,8161594,1788,1908099,10069693,03/15/2016
2003,Corinth,412601,1395,728114,499,376883,1104997,03/15/2016
2003,Edinburg,413001,313,81568,152,59821,141389,03/15/2016
2003,Galway,413201,1540,815321,337,266419,1081740,03/15/2016
2003,Ballston Spa,414201,5061,3654021,1007,1032743,4686764,03/15/2016
2003,South Glens Falls,414401,3347,2327708,1021,1021816,3349524,03/15/2016
2003,Schuylerville,415001,2050,1724040,464,583805,2307845,03/15/2016
2003,Stillwater,415201,1525,762647,371,296194,1058841,03/15/2016
2003,Waterford-Halfmoon,415401,896,691682,474,539746,1231428,03/15/2016
2003,Schenectady,421500,7420,6233399,3210,3845524,10078923,03/15/2016
2003,Duanesburg,422001,1190,744478,223,221009,965487,03/15/2016
2003,Scotia-Glenville,422202,4010,2962933,1087,1290554,4253487,03/15/2016
2003,Niskayuna,422401,5898,3631365,920,932475,4563840,03/15/2016
2003,Schalmont,422801,3109,2104910,864,916115,3021025,03/15/2016
2003,Rotterdam-Mohonasen,422803,4396,2593000,1945,1779977,4372977,03/15/2016
2003,Cobleskill-Richmondville,432602,2278,1114555,800,578136,1692691,03/15/2016
2003,Gilboa-Conesville,433401,529,235488,259,162026,397514,03/15/2016
2003,Jefferson,433601,412,199167,135,101027,300194,03/15/2016
2003,Middleburgh,433801,1166,733224,449,408717,1141941,03/15/2016
2003,Schoharie,434201,1424,939584,437,431272,1370856,03/15/2016
2003,Sharon Springs,434601,407,242989,163,144087,387076,03/15/2016
2003,Odessa-Montour,442001,1161,695552,406,358337,1053889,03/15/2016
2003,Watkins Glen,442401,1679,761429,703,471713,1233142,03/15/2016
2003,South Seneca,452801,1241,746223,497,426379,1172602,03/15/2016
2003,Romulus,453003,692,397348,231,205513,602861,03/15/2016
2003,Seneca Falls,453201,1891,1380720,780,862433,2243153,03/15/2016
2003,Waterloo,453801,2103,1129375,835,682899,1812274,03/15/2016
2003,Corning,460300,6768,4361125,2235,2053884,6415009,03/15/2016
2003,Hornell,460600,1698,867816,764,515652,1383468,03/15/2016
2003,Addison,462001,1380,935340,421,338669,1274009,03/15/2016
2003,Avoca,462201,752,365999,234,154102,520101,03/15/2016
2003,Bath,462402,1797,902654,641,496915,1399569,03/15/2016
2003,Bradford,462601,419,268238,135,126752,394990,03/15/2016
2003,Campbell-Savona,463002,1169,441975,353,199144,641119,03/15/2016
2003,Canisteo,463201,1052,618605,400,309450,928055,03/15/2016
2003,Greenwood,464601,254,153008,95,74007,227015,03/15/2016
2003,Arkport,465201,585,431003,220,269728,700731,03/15/2016
2003,Jasper-Troupsburg,465601,574,252896,193,117203,370099,03/15/2016
2003,Prattsburgh,466001,599,245043,195,113249,358292,03/15/2016
2003,Hammondsport,467201,1016,472262,416,289140,761402,03/15/2016
2003,Wayland-Cohocton,467401,2055,815153,612,354757,1169910,03/15/2016
2003,Babylon,472001,2546,2893103,396,724562,3617665,03/15/2016
2003,West Babylon,472002,5053,5331115,1080,1837063,7168178,03/15/2016
2003,North Babylon,472003,6017,6367392,1459,2520624,8888016,03/15/2016
2003,Lindenhurst,472004,7591,8073656,1789,3071613,11145269,03/15/2016
2003,Copiague,472005,4544,4983531,1148,1981227,6964758,03/15/2016
2003,Amityville,472006,3477,4102050,745,1393486,5495536,03/15/2016
2003,Deer Park,472007,4794,5390593,1478,2706240,8096833,03/15/2016
2003,Wyandanch,472009,899,945979,172,283700,1229679,03/15/2016
2003,Three Village,472201,8628,7994192,1332,2000978,9995170,03/15/2016
2003,Brookhaven-Comsewogue,472203,4144,3894487,774,1222017,5116504,03/15/2016
2003,South Country,472204,4525,4407441,756,1166772,5574213,03/15/2016
2003,Sachem,472205,16440,14953040,2309,3332563,18285603,03/15/2016
2003,Port Jefferson,472206,1535,930065,225,223075,1153140,03/15/2016
2003,Mount Sinai,472207,2433,2748000,342,627480,3375480,03/15/2016
2003,Miller Place,472208,3181,3658022,360,663934,4321956,03/15/2016
2003,Rocky Point,472209,3466,3949514,510,885903,4835417,03/15/2016
2003,Middle Country,472211,10709,9105010,2079,2794774,11899784,03/15/2016
2003,Longwood,472212,10821,11318230,3046,4623313,15941543,03/15/2016
2003,South Manor,472221,1772,1701490,211,328982,2030472,03/15/2016
2003,Patchogue-Medford,472224,8477,6989274,1654,2084699,9073973,03/15/2016
2003,William Floyd,472232,8087,7899285,1365,2017173,9916458,03/15/2016
2003,Center Moriches,472233,1422,1455073,263,422940,1878013,03/15/2016
2003,East Moriches,472234,1096,1047736,186,287762,1335498,03/15/2016
2003,East Hampton,472401,1349,233291,371,117151,350442,03/15/2016
2003,Wainscott,472402,125,10037,28,4454,14491,03/15/2016
2003,Amagansett,472403,268,31871,98,23223,55094,03/15/2016
2003,Springs,472404,948,274067,278,161236,435303,03/15/2016
2003,Sag Harbor,472405,1164,391396,564,346110,737506,03/15/2016
2003,Montauk,472406,702,107525,264,102110,209635,03/15/2016
2003,Elwood,472601,3096,2565547,611,880714,3446261,03/15/2016
2003,Cold Spring Harbor,472602,2105,1478078,145,177159,1655237,03/15/2016
2003,Huntington,472603,7265,6183420,1385,2021851,8205271,03/15/2016
2003,Northport-East Northport,472604,8655,5619581,1587,1789523,7409104,03/15/2016
2003,Half Hollow Hills,472605,9948,6810669,1302,1408184,8218853,03/15/2016
2003,Harborfields,472606,4584,4015489,736,1118566,5134055,03/15/2016
2003,Commack,472610,8988,8281500,1850,2901444,11182944,03/15/2016
2003,South Huntington,472613,8339,7528668,1861,2909167,10437835,03/15/2016
2003,Bay Shore,472801,5197,5382126,1087,1859542,7241668,03/15/2016
2003,Islip,472802,3687,3516205,684,1076207,4592412,03/15/2016
2003,East Islip,472803,5338,5236129,1036,1818853,7054982,03/15/2016
2003,Sayville,472804,3881,4202464,786,1401937,5604401,03/15/2016
2003,Bayport-Blue Point,472805,2865,2921868,491,821603,3743471,03/15/2016
2003,Hauppauge,472806,4825,2600653,965,853519,3454172,03/15/2016
2003,Connetquot,472807,8224,7932000,1457,2277292,10209292,03/15/2016
2003,West Islip,472809,6161,5959950,1304,2102020,8061970,03/15/2016
2003,Brentwood,472812,8320,6711449,2169,2906705,9618154,03/15/2016
2003,Central Islip,472813,4933,6260130,858,1769476,8029606,03/15/2016
2003,Fire Island,472814,91,9805,19,3403,13208,03/15/2016
2003,Shoreham-Wading River,473001,2880,2682667,757,1056232,3738899,03/15/2016
2003,Riverhead,473002,5940,4848883,2538,2748669,7597552,03/15/2016
2003,Shelter Island,473201,537,117870,255,93905,211775,03/15/2016
2003,Smithtown,473401,13019,11853691,2450,3588306,15441997,03/15/2016
2003,Kings Park,473405,5076,4144053,899,1221470,5365523,03/15/2016
2003,Remsenburg-Speonk,473601,392,103585,86,41281,144866,03/15/2016
2003,Westhampton Beach,473602,849,271995,256,144652,416647,03/15/2016
2003,Quogue,473603,227,23958,54,10186,34144,03/15/2016
2003,Hampton Bays,473605,1866,910179,798,691905,1602084,03/15/2016
2003,Southhampton,473606,1648,336125,625,230378,566503,03/15/2016
2003,Bridgehampton,473609,282,50939,107,35020,85959,03/15/2016
2003,Sagaponack,473610,81,3155,9,635,3790,03/15/2016
2003,Eastport,473611,1902,2159797,597,955600,3115397,03/15/2016
2003,Tuckahoe Common,473613,459,171250,185,125060,296310,03/15/2016
2003,East Quogue,473617,905,488765,293,262766,751531,03/15/2016
2003,Oysterponds,473802,343,89917,210,91834,181751,03/15/2016
2003,Fishers Island,473804,39,9902,9,3832,13734,03/15/2016
2003,Southold,473805,1425,725282,629,533529,1258811,03/15/2016
2003,Greenport,473810,594,355451,342,337315,692766,03/15/2016
2003,Mattituck-Cutchogue,473812,2092,1191619,724,687348,1878967,03/15/2016
2003,New Suffolk,473815,74,17522,42,16450,33972,03/15/2016
2003,Fallsburg,482801,1076,1000736,367,515540,1516276,03/15/2016
2003,Eldred,483401,909,467725,381,305165,772890,03/15/2016
2003,Liberty,483601,1430,1279243,554,765673,2044916,03/15/2016
2003,Tri-Valley,484201,1199,821820,313,311831,1133651,03/15/2016
2003,Roscoe,484401,329,155145,187,133353,288498,03/15/2016
2003,Livingston Manor,484402,592,288394,258,188803,477197,03/15/2016
2003,Monticello,484601,2937,1896488,1062,1069493,2965981,03/15/2016
2003,Sullivan West,484802,2022,1049391,910,745004,1794395,03/15/2016
2003,Waverly,492001,1697,712877,633,375060,1087937,03/15/2016
2003,Candor,492401,968,593575,354,321049,914624,03/15/2016
2003,Newark Valley,492602,1588,1103534,492,508780,1612314,03/15/2016
2003,Owego-Apalachin,493001,2815,1976855,1011,1029383,3006238,03/15/2016
2003,Spencer-Van Etten,493401,1288,602449,348,238310,840759,03/15/2016
2003,Tioga,493603,1139,469476,359,217060,686536,03/15/2016
2003,Ithaca,500700,7920,4797628,1582,1385916,6183544,03/15/2016
2003,Dryden,502401,2386,1609768,482,447676,2057444,03/15/2016
2003,Groton,502801,1247,718292,318,257941,976233,03/15/2016
2003,Lansing,503201,1574,920358,330,294970,1215328,03/15/2016
2003,Newfield,503401,1030,705877,232,189832,895709,03/15/2016
2003,Trumansburg,503601,1617,1033101,390,355753,1388854,03/15/2016
2003,Kingston,510800,8108,5424805,2976,3157864,8582669,03/15/2016
2003,Highland,513203,2069,1559383,543,652717,2212100,03/15/2016
2003,Rondout Valley,513401,3471,2895969,982,1207316,4103285,03/15/2016
2003,Marlboro,513601,2089,1224122,524,490170,1714292,03/15/2016
2003,New Paltz,513801,3037,2113787,643,739272,2853059,03/15/2016
2003,Onteora,514001,3240,1726945,1143,945756,2672701,03/15/2016
2003,Saugerties,514801,4061,2698552,1247,1299918,3998470,03/15/2016
2003,Wallkill,515201,3559,2685143,873,870752,3555895,03/15/2016
2003,Ellenville,515602,1497,1267629,583,625545,1893174,03/15/2016
2003,Glens Falls,520500,2644,1554407,856,784297,2338704,03/15/2016
2003,Bolton,522001,399,94475,142,54635,149110,03/15/2016
2003,Lake George,522201,1431,416510,429,205006,621516,03/15/2016
2003,North Warren,522402,954,323381,430,228875,552256,03/15/2016
2003,Johnsburg,523001,548,303480,235,195949,499429,03/15/2016
2003,Hadley-Luzerne,523201,1201,552036,513,357356,909392,03/15/2016
2003,Queensbury,523402,4067,2286493,982,853250,3139743,03/15/2016
2003,Glens Falls Common,523418,226,81423,107,58240,139663,03/15/2016
2003,Warrensburg,524001,1169,795616,389,395498,1191114,03/15/2016
2003,Argyle,532001,860,494998,241,211065,706063,03/15/2016
2003,Fort Ann,532802,713,500435,203,225404,725839,03/15/2016
2003,Fort Edward,533001,506,357514,221,249381,606895,03/15/2016
2003,Granville,533201,1409,880601,463,422687,1303288,03/15/2016
2003,Greenwich,533401,1334,883178,456,477879,1361057,03/15/2016
2003,Hartford,533801,679,444007,159,154647,598654,03/15/2016
2003,Hudson Falls,534401,2409,1469122,949,866164,2335286,03/15/2016
2003,Putnam,534601,152,39033,50,20665,59698,03/15/2016
2003,Salem,534801,820,495822,289,269843,765665,03/15/2016
2003,Cambridge,535010,1244,720625,494,440985,1161610,03/15/2016
2003,Whitehall,535201,852,427465,415,283012,710477,03/15/2016
2003,Newark,542001,2673,1824392,960,1026226,2850618,03/15/2016
2003,Clyde-Savannah,542401,1085,775744,451,458537,1234281,03/15/2016
2003,Lyons,542801,1126,671033,453,373498,1044531,03/15/2016
2003,Gananda,543002,1341,1012855,87,106252,1119107,03/15/2016
2003,Marion,543201,1312,968916,264,303779,1272695,03/15/2016
2003,Wayne,543401,3479,2194203,626,631506,2825709,03/15/2016
2003,Palmyra-Macedon,543601,2554,2132102,627,790341,2922443,03/15/2016
2003,Sodus,544201,1575,1110063,527,530275,1640338,03/15/2016
2003,Williamson,544602,1511,1058781,386,433979,1492760,03/15/2016
2003,North Rose-Wolcott,544801,1882,1049986,724,566414,1616400,03/15/2016
2003,Red Creek,544803,1193,497796,387,236119,733915,03/15/2016
2003,Mount Vernon,550800,4834,10188869,1500,4865235,15054104,03/15/2016
2003,New Rochelle,551000,8199,14711550,1558,4725779,19437329,03/15/2016
2003,Peekskill,551200,2814,5696913,611,1685917,7382830,03/15/2016
2003,Rye,551400,2920,3284606,403,784433,4069039,03/15/2016
2003,White Plains,551700,6290,11887588,1134,3135038,15022626,03/15/2016
2003,Yonkers,551800,16137,22426796,4382,9060635,31487431,03/15/2016
2003,Katonah-Lewisboro,552001,4717,7243827,453,1177810,8421637,03/15/2016
2003,Bedford,552002,4810,5204888,667,1177018,6381906,03/15/2016
2003,Croton-Harmon,552202,2031,3992397,325,964929,4957326,03/15/2016
2003,Hendrick Hudson,552203,3264,5044302,531,1118994,6163296,03/15/2016
2003,Eastchester,552401,2863,5590366,732,2097308,7687674,03/15/2016
2003,Tuckahoe,552402,1135,1875202,251,659642,2534844,03/15/2016
2003,Bronxville,552403,1141,2113548,66,325658,2439206,03/15/2016
2003,Tarrytowns,552601,2187,4013536,460,1344859,5358395,03/15/2016
2003,Irvington,552602,1744,3156452,210,679353,3835805,03/15/2016
2003,Dobbs Ferry,552603,1412,3302211,215,838268,4140479,03/15/2016
2003,Hastings On Hudson,552604,1559,3706663,296,1110361,4817024,03/15/2016
2003,Ardsley,552605,2401,4078288,360,1003810,5082098,03/15/2016
2003,Edgemont,552606,1600,3192031,120,389987,3582018,03/15/2016
2003,Greenburgh,552607,3951,6150445,860,1996281,8146726,03/15/2016
2003,Elmsford,552609,1233,1783191,315,730910,2514101,03/15/2016
2003,Harrison,552801,3455,3033410,637,1056963,4090373,03/15/2016
2003,Mamaroneck,553201,4439,5761318,616,1387788,7149106,03/15/2016
2003,Mount Pleasant,553401,2640,3496823,658,1469562,4966385,03/15/2016
2003,Pocantico Hills,553402,438,312659,89,106592,419251,03/15/2016
2003,Valhalla,553405,1767,2884167,420,1199059,4083226,03/15/2016
2003,Pleasantville,553409,1874,3468153,321,974676,4442829,03/15/2016
2003,Chappaqua,553604,4239,6352932,225,600401,6953333,03/15/2016
2003,Byram Hills,553801,2877,3112857,217,444791,3557648,03/15/2016
2003,North Salem,554001,1851,2561864,219,439845,3001709,03/15/2016
2003,Ossining,554201,5455,10762305,827,2569272,13331577,03/15/2016
2003,Briarcliff Manor,554202,1627,3328675,118,401009,3729684,03/15/2016
2003,Pelham,554401,2410,3455005,338,779246,4234251,03/15/2016
2003,Rye Neck,554801,1502,2288650,338,813578,3102228,03/15/2016
2003,Port Chester-Rye,554804,2772,3996779,1056,2348539,6345318,03/15/2016
2003,Blind Brook-Rye,554805,1640,2405907,175,423758,2829665,03/15/2016
2003,Scarsdale,555001,4557,5803168,210,475911,6279079,03/15/2016
2003,Somers,555201,4479,5817687,962,2004262,7821949,03/15/2016
2003,Lakeland,555401,8065,15468217,1621,4092660,19560877,03/15/2016
2003,Yorktown,555402,4986,9186046,621,1836358,11022404,03/15/2016
2003,Attica,562201,2233,1225810,617,547550,1773360,03/15/2016
2003,Letchworth,562601,1387,715119,395,305564,1020683,03/15/2016
2003,Wyoming,563802,454,226219,90,72692,298911,03/15/2016
2003,Perry,564201,1252,673110,434,367939,1041049,03/15/2016
2003,Warsaw,564801,1341,859379,408,416926,1276305,03/15/2016
2003,Penn Yan,573001,2752,1174722,1159,758942,1933664,03/15/2016
2003,Dundee,573401,1116,484578,457,283723,768301,03/15/2016
2003,New York City School,650000,471977,104674857,93358,32503644,137178501,03/15/2016
2002,Albany,010100,9096,5722854,3816,3660604,9383458,03/15/2016
2002,Cohoes,010300,1903,1342276,859,897873,2240149,03/15/2016
2002,Watervliet,011800,1173,580387,572,442038,1022425,03/15/2016
2002,Berne-Knox-Westerlo,012001,1509,976474,349,341834,1318308,03/15/2016
2002,Bethlehem,012206,6384,4754277,1168,1413971,6168248,03/15/2016
2002,Ravena-Coeymans-Selkirk,012402,2554,1544841,700,655327,2200168,03/15/2016
2002,South Colonie,012601,8041,3921651,2842,2190937,6112588,03/15/2016
2002,North Colonie,012605,6777,3051790,1733,1271474,4323264,03/15/2016
2002,Menands,012615,356,146693,112,72021,218714,03/15/2016
2002,Maplewood,012622,85,41360,64,47031,88391,03/15/2016
2002,Green Island,012801,262,205325,142,177245,382570,03/15/2016
2002,Guilderland,013002,6764,4259069,1546,1586580,5845649,03/15/2016
2002,Voorheesville,013403,1869,1193387,354,372262,1565649,03/15/2016
2002,Alfred-Almond,022001,806,571703,267,273856,845559,03/15/2016
2002,Andover,023001,441,335597,164,169143,504740,03/15/2016
2002,Genesee Valley,023202,667,279759,389,219472,499231,03/15/2016
2002,Belfast,023401,387,174956,178,105417,280373,03/15/2016
2002,Canaseraga,024002,380,207733,142,107974,315707,03/15/2016
2002,Cuba-Rushford,024801,1195,668814,528,420469,1089283,03/15/2016
2002,Friendship,025001,324,220768,170,140903,361671,03/15/2016
2002,Fillmore,025801,720,334451,274,173329,507780,03/15/2016
2002,Whitesville,026001,221,136220,96,75053,211273,03/15/2016
2002,Scio,026601,464,323933,193,177471,501404,03/15/2016
2002,Wellsville,027001,1590,942231,844,667167,1609398,03/15/2016
2002,Bolivar-Richburg,027602,920,342229,362,173552,515781,03/15/2016
2002,Binghamton,030200,5304,3296184,2779,2332409,5628593,03/15/2016
2002,Chenango Forks,032001,2138,1452090,571,591825,2043915,03/15/2016
2002,South Mountain-Hickory,032201,128,26182,24,8183,34365,03/15/2016
2002,Harpursville,032601,1040,481173,300,200986,682159,03/15/2016
2002,Susquehanna Valley,032801,2349,1868953,819,991332,2860285,03/15/2016
2002,Chenango Valley,033001,2540,1760428,1179,1295484,3055912,03/15/2016
2002,Maine-Endwell,033801,3312,3212547,1385,1976109,5188656,03/15/2016
2002,Deposit,034201,670,327618,317,228980,556598,03/15/2016
2002,Whitney Point,034401,1641,740080,473,316117,1056197,03/15/2016
2002,Union-Endicott,034601,5257,4668081,2403,3197243,7865324,03/15/2016
2002,Johnson City,034602,2889,2123194,1719,1705172,3828366,03/15/2016
2002,Vestal,034801,5523,4170213,1749,2019810,6190023,03/15/2016
2002,Windsor,035001,2033,1249016,671,617495,1866511,03/15/2016
2002,Olean,041200,2674,1341971,1311,859547,2201518,03/15/2016
2002,Salamanca,041600,1147,451233,581,261300,712533,03/15/2016
2002,Allegany-Limestone,042001,1523,602826,532,296934,899760,03/15/2016
2002,West Valley,042204,503,290075,168,146540,436615,03/15/2016
2002,Ellicottville,043601,642,270482,245,154480,424962,03/15/2016
2002,Franklinville,044001,859,451606,334,241725,693331,03/15/2016
2002,Hinsdale,044601,569,258469,216,137927,396396,03/15/2016
2002,Cattaraugus - Little Valley,046402,1414,721402,518,367679,1089081,03/15/2016
2002,Gowanda,047201,1416,626914,644,420181,1047095,03/15/2016
2002,Portville,047401,1074,586806,377,300763,887569,03/15/2016
2002,Randolph,047601,1184,478750,425,233920,712670,03/15/2016
2002,Yorkshire-Pioneer,048401,2915,1218938,931,575031,1793969,03/15/2016
2002,Auburn,050100,4912,2986387,2402,2215453,5201840,03/15/2016
2002,Weedsport,052201,1110,652123,342,310641,962764,03/15/2016
2002,Cato-Meridian,052401,1370,784892,309,265813,1050705,03/15/2016
2002,Southern Cayuga,053001,1219,598312,390,297610,895922,03/15/2016
2002,Port Byron,053801,1392,887992,440,402121,1290113,03/15/2016
2002,Moravia,054201,1394,638988,333,222146,861134,03/15/2016
2002,Union Springs,055401,1215,911512,400,454777,1366289,03/15/2016
2002,Dunkirk,060300,2204,1524721,1304,1232821,2757542,03/15/2016
2002,Jamestown,060800,4641,2337206,2001,1342899,3680105,03/15/2016
2002,Southwestern,062201,2243,1416616,822,796608,2213224,03/15/2016
2002,Frewsburg,062401,1004,693621,356,377878,1071499,03/15/2016
2002,Cassadaga Valley,062601,1346,699830,515,385051,1084881,03/15/2016
2002,Chautauqua Lake,062803,1156,338288,461,213740,552028,03/15/2016
2002,Pine Valley,063001,776,479836,291,254300,734136,03/15/2016
2002,Clymer,063201,590,266321,252,179241,445562,03/15/2016
2002,Bemus Point,063601,1095,542748,428,321839,864587,03/15/2016
2002,Falconer,063801,1498,880834,546,498508,1379342,03/15/2016
2002,Silver Creek,064601,1213,678041,524,432087,1110128,03/15/2016
2002,Forestville,064603,829,418914,299,230696,649610,03/15/2016
2002,Panama,064801,785,441359,256,210228,651587,03/15/2016
2002,Fredonia,065801,2027,1228866,748,731110,1959976,03/15/2016
2002,Brocton,066001,766,570322,278,295440,865762,03/15/2016
2002,Ripley,066201,406,278331,184,167305,445636,03/15/2016
2002,Sherman,066601,525,268502,147,110862,379364,03/15/2016
2002,Westfield,067201,973,711072,390,424660,1135732,03/15/2016
2002,Elmira,070400,7230,4160718,3353,2766815,6927533,03/15/2016
2002,Horseheads,073401,5242,2679582,1897,1556340,4235922,03/15/2016
2002,Elmira Heights,073402,1153,613772,634,512289,1126061,03/15/2016
2002,Norwich,081100,2169,1435855,835,769587,2205442,03/15/2016
2002,Afton,082001,797,518923,296,278177,797100,03/15/2016
2002,Bainbridge-Guilford,082201,1089,677979,388,339300,1017279,03/15/2016
2002,Greene,083001,1460,905600,444,416760,1322360,03/15/2016
2002,Unadilla Valley,083803,1086,502655,383,246276,748931,03/15/2016
2002,Georgetown-So Otselic Valley,084401,508,292716,140,106161,398877,03/15/2016
2002,Oxford Academy,084601,1023,637944,390,340065,978009,03/15/2016
2002,Sherburne-Earlville,085601,1651,961389,569,484085,1445474,03/15/2016
2002,Plattsburgh,091300,1863,1215471,762,771319,1986790,03/15/2016
2002,Ausable Valley,092201,1769,839886,686,441135,1281021,03/15/2016
2002,Beekmantown,092401,2476,1185564,711,478262,1663826,03/15/2016
2002,Northeastern Clinton,092801,1901,1263185,581,527516,1790701,03/15/2016
2002,Chazy,093001,685,420146,190,172469,592615,03/15/2016
2002,Northern Adirondack,093601,1324,475150,426,196350,671500,03/15/2016
2002,Peru,094001,2444,1389513,553,455640,1845153,03/15/2016
2002,Saranac,094401,2159,1191131,656,524321,1715452,03/15/2016
2002,Hudson,100600,1908,1098668,1013,864947,1963615,03/15/2016
2002,Taconic Hills,102801,1938,936566,813,617992,1554558,03/15/2016
2002,Germantown,103602,804,400294,317,251672,651966,03/15/2016
2002,Chatham,103801,1786,844682,541,432086,1276768,03/15/2016
2002,Kinderhook,104401,2831,1485360,724,596553,2081913,03/15/2016
2002,New Lebanon,104801,844,430476,247,196817,627293,03/15/2016
2002,Cortland,110200,2850,1485416,1167,958530,2443946,03/15/2016
2002,Cincinnatus,112001,690,281498,245,135175,416673,03/15/2016
2002,Mc Graw,112204,679,333594,224,162168,495762,03/15/2016
2002,Homer,113001,2643,1535643,753,674191,2209834,03/15/2016
2002,Marathon,113401,852,512935,280,241039,753974,03/15/2016
2002,Andes,122002,238,93723,151,93620,187343,03/15/2016
2002,Downsville,122401,372,138028,202,102124,240152,03/15/2016
2002,Charlotte Valley,122601,539,225346,217,138240,363586,03/15/2016
2002,Delhi,122801,1136,544987,549,423360,968347,03/15/2016
2002,Franklin,123201,421,208487,162,125294,333781,03/15/2016
2002,Hancock,123606,441,273177,239,206348,479525,03/15/2016
2002,Margaretville,124601,655,219165,334,175636,394801,03/15/2016
2002,Roxbury,124802,518,278971,269,221204,500175,03/15/2016
2002,Sidney,125001,1353,921222,696,685097,1606319,03/15/2016
2002,Stamford,125201,526,386090,198,218682,604772,03/15/2016
2002,South Kortright,125202,464,229165,227,176444,405609,03/15/2016
2002,Walton,125601,1171,438395,492,280571,718966,03/15/2016
2002,Beacon,130200,2775,1754420,885,904041,2658461,03/15/2016
2002,Poughkeepsie,131300,2638,1749047,966,978964,2728011,03/15/2016
2002,Dover,132602,1391,1131291,314,434135,1565426,03/15/2016
2002,Hyde Park,133201,5156,3913464,1434,1672660,5586124,03/15/2016
2002,Northeast,133801,889,499959,315,280727,780686,03/15/2016
2002,Pawling,134001,1588,1159672,353,426305,1585977,03/15/2016
2002,Pine Plains,134201,1638,854795,508,412545,1267340,03/15/2016
2002,Arlington,134601,10320,7149587,1751,1976927,9126514,03/15/2016
2002,Spackenkill,134602,1777,1247518,409,464926,1712444,03/15/2016
2002,Red Hook,134801,2051,1536692,575,699044,2235736,03/15/2016
2002,Rhinebeck,135001,1647,938305,478,445452,1383757,03/15/2016
2002,Wappingers,135601,13787,7393092,2951,2636814,10029906,03/15/2016
2002,Millbrook,135801,1334,646718,300,240710,887428,03/15/2016
2002,Buffalo,140200,28270,10723167,11054,5361018,16084185,03/15/2016
2002,Lackawanna,140900,2027,528032,1602,548527,1076559,03/15/2016
2002,Tonawanda,141600,2905,1535063,1444,1189941,2725004,03/15/2016
2002,Alden,142001,2539,1644917,788,804652,2449569,03/15/2016
2002,Amherst,142201,5346,3542430,1555,1622265,5164695,03/15/2016
2002,Williamsville,142203,15358,8942791,3406,3145710,12088501,03/15/2016
2002,Sweet Home,142207,4971,1972820,2088,1363375,3336195,03/15/2016
2002,East Aurora,142401,2737,1402025,847,707014,2109039,03/15/2016
2002,Cheektowaga,143001,3366,1599602,2001,1406424,3006026,03/15/2016
2002,Cheektowaga-Maryvale,143002,3349,1677261,2247,1780992,3458253,03/15/2016
2002,Cleveland Hill,143003,2191,1512947,1165,1270198,2783145,03/15/2016
2002,Depew,143007,3272,2062545,1198,1217421,3279966,03/15/2016
2002,Cheektowaga-Sloan,143009,2044,1390160,1624,1767368,3157528,03/15/2016
2002,Clarence,143201,5609,2762443,1340,940926,3703369,03/15/2016
2002,Springville-Griffith,143801,2767,1437064,895,727981,2165045,03/15/2016
2002,Eden,144001,2209,1014882,651,489688,1504570,03/15/2016
2002,Iroquois,144201,3866,1651319,1205,826663,2477982,03/15/2016
2002,Evans-Brant,144401,3948,2312275,1080,899960,3212235,03/15/2016
2002,Grand Island,144601,4410,2577708,943,882415,3460123,03/15/2016
2002,Hamburg,144801,5070,2684620,1499,1309257,3993877,03/15/2016
2002,Frontier,144804,6929,3293456,2256,1622638,4916094,03/15/2016
2002,Holland,145001,1559,662542,377,260996,923538,03/15/2016
2002,Lancaster,145201,8439,4121674,2648,2015173,6136847,03/15/2016
2002,Akron,145601,1764,884214,598,418902,1303116,03/15/2016
2002,North Collins,145801,868,545444,302,292942,838386,03/15/2016
2002,Orchard Park,146001,7088,3836209,1700,1496286,5332495,03/15/2016
2002,Kenmore,146401,13737,8879171,6716,6998937,15878108,03/15/2016
2002,West Seneca,146801,11328,6051297,4906,4073216,10124513,03/15/2016
2002,Crown Point,152203,378,148718,175,97706,246424,03/15/2016
2002,Elizabethtown-Lewis,152401,497,254721,175,127985,382706,03/15/2016
2002,Keene,153001,243,87151,96,55819,142970,03/15/2016
2002,Minerva,153401,198,99960,83,62712,162672,03/15/2016
2002,Moriah,153601,844,334379,521,274174,608553,03/15/2016
2002,Newcomb,153801,122,9202,74,7740,16942,03/15/2016
2002,Lake Placid,154002,1089,378714,330,171060,549774,03/15/2016
2002,Schroon Lake,154601,410,108383,200,82432,190815,03/15/2016
2002,Ticonderoga,154801,1124,330280,477,212546,542826,03/15/2016
2002,Westport,155001,325,179185,124,107964,287149,03/15/2016
2002,Willsboro,155201,499,233554,246,173403,406957,03/15/2016
2002,Tupper Lake,162001,1240,506820,517,272012,778832,03/15/2016
2002,Chateaugay,163401,656,318312,239,156903,475215,03/15/2016
2002,Salmon River,164201,736,314047,305,185018,499065,03/15/2016
2002,Saranac Lake,164601,2036,805927,639,362928,1168855,03/15/2016
2002,Malone,164801,2805,1457965,1106,776871,2234836,03/15/2016
2002,Brushton-Moira,165001,862,423673,314,212259,635932,03/15/2016
2002,St. Regis Falls,165401,418,164449,167,90143,254592,03/15/2016
2002,Gloversville,170500,2948,1914983,1445,1167810,3082793,03/15/2016
2002,Johnstown,170800,2075,1169510,775,630899,1800409,03/15/2016
2002,Broadalbin-Perth,172201,2098,831173,699,430484,1261657,03/15/2016
2002,Wheelerville,172401,331,144733,127,83313,228046,03/15/2016
2002,Mayfield,173001,1308,668290,467,346084,1014374,03/15/2016
2002,Northville,173201,584,250209,251,159288,409497,03/15/2016
2002,Oppenheim-Ephratah,173401,584,313967,188,134146,448113,03/15/2016
2002,Batavia,180200,2911,1942792,1167,1198982,3141774,03/15/2016
2002,Alexander,182202,1111,821652,316,361283,1182935,03/15/2016
2002,Byron-Bergen,183001,1519,1104937,408,420167,1525104,03/15/2016
2002,Elba,183401,586,411840,177,197667,609507,03/15/2016
2002,Le Roy,183601,1633,1023041,533,522929,1545970,03/15/2016
2002,Oakfield-Alabama,183801,1064,809099,393,457527,1266626,03/15/2016
2002,Pavilion,184001,1135,767826,262,269377,1037203,03/15/2016
2002,Pembroke,184202,1381,856007,462,434616,1290623,03/15/2016
2002,Cairo-Durham,192401,1646,820520,722,557575,1378095,03/15/2016
2002,Catskill,192601,2014,1184628,812,726638,1911266,03/15/2016
2002,Coxsackie-Athens,192801,1768,931796,598,485190,1416986,03/15/2016
2002,Greenville,193201,1684,1019612,596,577270,1596882,03/15/2016
2002,Hunter-Tannersville,193601,639,289758,279,196539,486297,03/15/2016
2002,Windham-Ashland-Jewett,194601,555,174785,253,126274,301059,03/15/2016
2002,Piseco,202001,80,8334,42,7268,15602,03/15/2016
2002,Indian Lake,202601,323,93662,151,69680,163342,03/15/2016
2002,Inlet,202801,86,11198,39,8354,19552,03/15/2016
2002,Lake Pleasant,203001,182,53980,93,45035,99015,03/15/2016
2002,Long Lake,203201,167,40170,103,38057,78227,03/15/2016
2002,Raquette Lake,203202,28,1707,11,1139,2846,03/15/2016
2002,Wells,203601,207,74914,119,66390,141304,03/15/2016
2002,Little Falls,210900,1146,728322,675,613045,1341367,03/15/2016
2002,West Canada Valley,212402,928,468892,316,241486,710378,03/15/2016
2002,Frankfort-Schuyler,212602,1273,774516,608,569598,1344114,03/15/2016
2002,Ilion,212801,1528,615841,632,383319,999160,03/15/2016
2002,Mohawk,212802,1039,557224,450,364749,921973,03/15/2016
2002,Herkimer,213001,1411,787902,836,644654,1432556,03/15/2016
2002,Dolgeville,213602,968,413877,443,262562,676439,03/15/2016
2002,Poland,213803,867,371142,280,180474,551616,03/15/2016
2002,Van Hornesville-Owen D. Young,215001,304,184337,121,111679,296016,03/15/2016
2002,Town Of Webb,215401,557,113936,270,86431,200367,03/15/2016
2002,Mount Markham,215601,1386,988595,465,482090,1470685,03/15/2016
2002,Watertown,221800,3438,1356252,1442,820855,2177107,03/15/2016
2002,South Jefferson,222001,1951,748694,545,296024,1044718,03/15/2016
2002,Alexandria,222202,746,276449,287,156964,433413,03/15/2016
2002,Indian River,222401,1487,281911,413,104298,386209,03/15/2016
2002,General Brown,222601,1664,649941,490,282090,932031,03/15/2016
2002,Thousand Islands,223201,1350,602113,574,381490,983603,03/15/2016
2002,Belleville-Henderson,223402,613,179774,289,122278,302052,03/15/2016
2002,Sackets Harbor,223801,524,255020,186,136508,391528,03/15/2016
2002,Lyme,224401,459,178584,243,145297,323881,03/15/2016
2002,La Fargeville,224601,523,209269,158,91951,301220,03/15/2016
2002,Carthage,226001,2233,1162803,788,577929,1740732,03/15/2016
2002,Copenhagen,232201,526,201909,130,72089,273998,03/15/2016
2002,Harrisville,232401,533,281242,185,118777,400019,03/15/2016
2002,Lowville,233601,1492,598534,541,304034,902568,03/15/2016
2002,South Lewis,234001,1416,590830,565,314622,905452,03/15/2016
2002,Beaver River,234401,1143,368894,352,167363,536257,03/15/2016
2002,Avon,242001,1108,863864,328,396228,1260092,03/15/2016
2002,Caledonia-Mumford,242201,1272,763478,355,342801,1106279,03/15/2016
2002,Geneseo,242601,1293,696080,314,273560,969640,03/15/2016
2002,Livonia,243401,2478,1397553,572,496816,1894369,03/15/2016
2002,Mount Morris,243601,587,393324,276,271514,664838,03/15/2016
2002,Dansville,243801,2002,1001033,695,507434,1508467,03/15/2016
2002,Dalton-Nunda,244001,1108,743751,335,324451,1068202,03/15/2016
2002,York,245201,1074,604620,311,273741,878361,03/15/2016
2002,Oneida,251200,2644,1372993,930,734848,2107841,03/15/2016
2002,Brookfield,252009,285,139015,83,56281,195296,03/15/2016
2002,Cazenovia,252201,2085,1178281,506,453042,1631323,03/15/2016
2002,De Ruyter,252401,519,290246,181,149078,439324,03/15/2016
2002,Morrisville-Eaton,252601,919,491055,237,181868,672923,03/15/2016
2002,Hamilton,253201,874,513043,241,211648,724691,03/15/2016
2002,Canastota,253601,1754,1006510,628,542012,1548522,03/15/2016
2002,Madison,254001,588,400320,190,180787,581107,03/15/2016
2002,Stockbridge Valley,254601,488,265783,161,127384,393167,03/15/2016
2002,Chittenango,254801,3033,2160171,731,743069,2903240,03/15/2016
2002,Rochester,261400,25193,10465789,5601,3257321,13723110,03/15/2016
2002,Brighton,262001,5051,3559624,960,1094041,4653665,03/15/2016
2002,Gates-Chili,262601,7564,5263618,2841,3146776,8410394,03/15/2016
2002,Greece,262801,17753,11745801,5328,5696891,17442692,03/15/2016
2002,East Irondequoit,263401,5969,4374692,2750,3165917,7540609,03/15/2016
2002,West Irondequoit,263403,6027,5067783,2037,2811817,7879600,03/15/2016
2002,Honeoye Falls-Lima,263601,3113,2086321,498,539066,2625387,03/15/2016
2002,Spencerport,263801,5069,3711631,1179,1402666,5114297,03/15/2016
2002,Hilton,264001,5762,3687841,1087,1129222,4817063,03/15/2016
2002,Penfield,264201,7634,5722634,1443,1747172,7469806,03/15/2016
2002,Fairport,264401,9279,5774800,1814,1819541,7594341,03/15/2016
2002,East Rochester,264413,1610,1073020,653,659004,1732024,03/15/2016
2002,Pittsford,264601,8051,5091325,1000,1038137,6129462,03/15/2016
2002,Churchville-Chili,264801,5198,3699682,1187,1358487,5058169,03/15/2016
2002,Rush-Henrietta,265001,7753,4405350,1991,1841814,6247164,03/15/2016
2002,Brockport,265201,4588,3006577,756,780788,3787365,03/15/2016
2002,Webster,265401,11368,6930779,2816,2798642,9729421,03/15/2016
2002,Wheatland-Chili,265601,1208,919638,373,443986,1363624,03/15/2016
2002,Amsterdam,270100,3745,2692043,2153,2297175,4989218,03/15/2016
2002,Canajoharie,272201,1106,654229,470,422145,1076374,03/15/2016
2002,Fonda-Fultonville,272801,1695,1127043,552,538381,1665424,03/15/2016
2002,Fort Plain,273001,912,767803,395,470190,1237993,03/15/2016
2002,St. Johnsville,273802,563,295064,294,213407,508471,03/15/2016
2002,Glen Cove,280500,2994,2442568,1180,1857980,4300548,03/15/2016
2002,Long Beach,281000,6340,3703900,1031,1132417,4836317,03/15/2016
2002,Hempstead,282001,2628,3841751,504,1281229,5122980,03/15/2016
2002,Uniondale,282002,4382,3700507,882,1312956,5013463,03/15/2016
2002,East Meadow,282003,10129,9937150,2948,4420825,14357975,03/15/2016
2002,North Bellmore,282004,5465,4840293,1204,1900980,6741273,03/15/2016
2002,Levittown,282005,10276,12564658,2311,5081409,17646067,03/15/2016
2002,Seaford,282006,3614,3249970,835,1318088,4568058,03/15/2016
2002,Bellmore,282007,2910,2640227,491,776319,3416546,03/15/2016
2002,Roosevelt,282008,1972,2168135,362,699121,2867256,03/15/2016
2002,Freeport,282009,4888,5359920,903,1726110,7086030,03/15/2016
2002,Baldwin,282010,6624,7287698,1096,2119566,9407264,03/15/2016
2002,Oceanside,282011,7949,6849838,1684,2557355,9407193,03/15/2016
2002,Malverne,282012,2830,2926112,619,1178587,4104699,03/15/2016
2002,Valley Stream 13,282013,5607,5259626,1532,2458250,7717876,03/15/2016
2002,Hewlett-Woodmere,282014,4421,4613692,644,1151618,5765310,03/15/2016
2002,Lawrence,282015,5815,4252281,872,1225824,5478105,03/15/2016
2002,Elmont,282016,6801,6160435,1792,2854149,9014584,03/15/2016
2002,Franklin Square,282017,4592,3433742,1548,2069125,5502867,03/15/2016
2002,Garden City,282018,5381,3036127,681,706681,3742808,03/15/2016
2002,East Rockaway,282019,1859,1879883,501,898687,2778570,03/15/2016
2002,Lynbrook,282020,3536,3382152,773,1344648,4726800,03/15/2016
2002,Rockville Centre,282021,4461,3554742,646,977267,4532009,03/15/2016
2002,Floral Park-Bellerose,282022,3821,3021210,883,1244609,4265819,03/15/2016
2002,Wantagh,282023,4190,3917298,723,1236230,5153528,03/15/2016
2002,Valley Stream 24,282024,2251,1919497,621,935900,2855397,03/15/2016
2002,Merrick,282025,4497,3692112,558,789613,4481725,03/15/2016
2002,Island Trees,282026,3077,3022732,780,1380837,4403569,03/15/2016
2002,West Hempstead,282027,3321,3015968,707,1155582,4171550,03/15/2016
2002,North Merrick,282029,3074,2770322,706,1167231,3937553,03/15/2016
2002,Valley Stream 30,282030,2600,1965257,709,975235,2940492,03/15/2016
2002,Island Park,282031,1423,1013769,309,371247,1385016,03/15/2016
2002,Westbury,282201,2680,3254815,634,1313369,4568184,03/15/2016
2002,East Williston,282202,1996,1768077,232,367899,2135976,03/15/2016
2002,Roslyn,282203,3802,3374040,352,580497,3954537,03/15/2016
2002,Port Washington,282204,5182,3442404,669,798487,4240891,03/15/2016
2002,New Hyde Park-Garden City,282205,4184,2854779,1326,1622668,4477447,03/15/2016
2002,Manhasset,282206,3493,1754196,313,311727,2065923,03/15/2016
2002,Great Neck,282207,8541,4076185,977,860129,4936314,03/15/2016
2002,Herricks,282209,5615,4207143,1028,1520368,5727511,03/15/2016
2002,Mineola,282210,3994,2875110,1175,1570639,4445749,03/15/2016
2002,Carle Place,282211,1703,1325935,481,684267,2010202,03/15/2016
2002,North Shore,282401,3334,2035889,570,617427,2653316,03/15/2016
2002,Syosset,282402,7428,5963429,960,1352518,7315947,03/15/2016
2002,Locust Valley,282403,3088,1786450,438,487152,2273602,03/15/2016
2002,Plainview-Old Bethpage,282404,6535,5680996,1276,2099745,7780741,03/15/2016
2002,Oyster Bay-East Norwich,282406,2336,1302546,369,397188,1699734,03/15/2016
2002,Jericho,282415,3119,2151140,294,376050,2527190,03/15/2016
2002,Hicksville,282417,6930,4312702,2171,2502680,6815382,03/15/2016
2002,Plainedge,282418,4228,4182547,1153,2096169,6278716,03/15/2016
2002,Bethpage,282421,3705,2801321,1413,1463047,4264368,03/15/2016
2002,Farmingdale,282422,7718,8511616,2084,4061632,12573248,03/15/2016
2002,Massapequa,282423,10934,8522645,2336,3379192,11901837,03/15/2016
2002,Lockport,290900,5916,4962233,1746,2027931,6990164,03/15/2016
2002,Niagara Falls,291100,7294,3481181,4243,2770733,6251914,03/15/2016
2002,North Tonawanda,291200,5910,3878594,2429,2526760,6405354,03/15/2016
2002,Lewiston-Porter,292401,3849,2425171,1330,1374754,3799925,03/15/2016
2002,Newfane,292801,2236,1813427,730,944245,2757672,03/15/2016
2002,Niagara-Wheatfield,293001,4517,2308108,1596,1289952,3598060,03/15/2016
2002,Starpoint,293201,3500,2144579,862,846660,2991239,03/15/2016
2002,Royalton-Hartland,293601,1978,1377096,593,653946,2031042,03/15/2016
2002,Barker,293801,1086,625493,340,304801,930294,03/15/2016
2002,Wilson,294201,1681,1214491,561,635366,1849857,03/15/2016
2002,Rome,301300,5749,3867677,2595,2471834,6339511,03/15/2016
2002,Utica,301600,6755,3691492,4350,3330964,7022456,03/15/2016
2002,Adirondack,302601,1776,914429,627,435653,1350082,03/15/2016
2002,Camden,303001,2711,1398934,852,584982,1983916,03/15/2016
2002,Clinton,304001,1753,1338641,601,617632,1956273,03/15/2016
2002,New Hartford,304801,3513,2497849,1282,1418327,3916176,03/15/2016
2002,New York Mills,304804,777,532939,541,605804,1138743,03/15/2016
2002,Sauquoit Valley,305002,1344,771159,401,344902,1116061,03/15/2016
2002,Remsen,305201,716,435647,215,182815,618462,03/15/2016
2002,Waterville,305401,1081,617151,349,295378,912529,03/15/2016
2002,Holland Patent,305801,1996,1214808,585,534283,1749091,03/15/2016
2002,Sherrill,306000,2603,1503153,874,774741,2277894,03/15/2016
2002,Westmoreland,306801,1543,1312960,594,734540,2047500,03/15/2016
2002,Oriskany,307001,893,598255,330,341217,939472,03/15/2016
2002,Whitesboro,307002,4664,3060798,1898,1938702,4999500,03/15/2016
2002,Syracuse,311500,15674,6708159,5879,3858386,10566545,03/15/2016
2002,West Genesee,312001,6753,4321075,2629,2614464,6935539,03/15/2016
2002,North Syracuse,312403,12943,8182801,3360,3126045,11308846,03/15/2016
2002,East Syracuse-Minoa,312601,4673,3136082,1681,1648808,4784890,03/15/2016
2002,Jamesville-Dewitt,312611,3787,2266737,791,753826,3020563,03/15/2016
2002,Jordan-Elbridge,312801,1722,1282905,515,527143,1810048,03/15/2016
2002,Fabius-Pompey,313001,1073,650255,238,222429,872684,03/15/2016
2002,Westhill,313201,2443,1710506,983,1083297,2793803,03/15/2016
2002,Solvay,313202,1769,1044927,1033,958146,2003073,03/15/2016
2002,La Fayette,313407,1004,581526,248,215278,796804,03/15/2016
2002,Baldwinsville,313601,7542,5078651,1601,1584777,6663428,03/15/2016
2002,Fayetteville-Manlius,313801,6036,4441870,1004,1173042,5614912,03/15/2016
2002,Marcellus,314001,2535,1491361,648,607947,2099308,03/15/2016
2002,Onondaga,314201,1355,1022130,423,469523,1491653,03/15/2016
2002,Liverpool,314801,10349,7621949,2842,3125534,10747483,03/15/2016
2002,Lyncourt,314804,770,545959,494,490889,1036848,03/15/2016
2002,Skaneateles,315001,2168,1164472,560,486511,1650983,03/15/2016
2002,Tully,315402,1253,713017,263,231166,944183,03/15/2016
2002,Canandaigua,320200,3959,2205788,1029,908331,3114119,03/15/2016
2002,Geneva,320500,2526,1543594,1167,1054549,2598143,03/15/2016
2002,East Bloomfield,322601,1295,904415,296,322309,1226724,03/15/2016
2002,Gorham-Middlesex,323201,1988,1115317,613,513338,1628655,03/15/2016
2002,Manchester-Shortsville,323601,1127,908187,400,474473,1382660,03/15/2016
2002,Naples,323801,1285,703205,342,287652,990857,03/15/2016
2002,Phelps-Clifton Springs,324001,2218,1774948,627,768067,2543015,03/15/2016
2002,Honeoye,324201,1422,780495,367,316890,1097385,03/15/2016
2002,Victor,324801,3905,2452172,633,627502,3079674,03/15/2016
2002,Middletown,330900,4600,3593752,1328,1553327,5147079,03/15/2016
2002,Newburgh,331100,8520,5847577,2563,2873619,8721196,03/15/2016
2002,Port Jervis,331300,2496,1917241,926,1031611,2948852,03/15/2016
2002,Washingtonville,332002,4841,3701630,630,795856,4497486,03/15/2016
2002,Chester,332201,1206,892095,217,256889,1148984,03/15/2016
2002,Cornwall,332401,3102,2221106,551,632212,2853318,03/15/2016
2002,Pine Bush,332601,5287,4080376,957,1181653,5262029,03/15/2016
2002,Goshen,333001,2765,1718544,565,572256,2290800,03/15/2016
2002,Highland Falls,333601,738,426976,251,236889,663865,03/15/2016
2002,Minisink Valley,333801,4008,2790425,674,751032,3541457,03/15/2016
2002,Monroe-Woodbury,334001,7858,5943176,982,1318015,7261191,03/15/2016
2002,Kiryas Joel Village,334002,772,300197,46,29523,329720,03/15/2016
2002,Valley,334201,4687,2929365,1071,1083102,4012467,03/15/2016
2002,Tuxedo,335003,490,139595,91,49080,188675,03/15/2016
2002,Warwick Valley,335401,4711,3346044,759,890855,4236899,03/15/2016
2002,Greenwood Lake,335411,1326,971033,257,307647,1278680,03/15/2016
2002,Florida,335415,973,724306,255,310382,1034688,03/15/2016
2002,Albion,342001,2317,1350798,822,732974,2083772,03/15/2016
2002,Kendall,343007,1209,821317,256,273041,1094358,03/15/2016
2002,Holley,343204,1404,1050431,421,458982,1509413,03/15/2016
2002,Medina,343401,1885,1221533,767,764309,1985842,03/15/2016
2002,Lyndonville,343801,873,447982,307,241220,689202,03/15/2016
2002,Fulton,350400,3504,2515189,1259,1249843,3765032,03/15/2016
2002,Oswego,351200,4894,3126608,1724,1718993,4845601,03/15/2016
2002,Altmar Parish-Williamstown,352002,1479,884221,387,326566,1210787,03/15/2016
2002,Hannibal,353001,1611,812085,385,282764,1094849,03/15/2016
2002,Central Square,353201,5023,2875752,1209,966914,3842666,03/15/2016
2002,Mexico,353401,2585,1378206,609,473075,1851281,03/15/2016
2002,Pulaski,355001,1130,668282,315,278797,947079,03/15/2016
2002,Sandy Creek,355201,1118,625892,388,299030,924922,03/15/2016
2002,Phoenix,355401,2673,2067008,623,700279,2767287,03/15/2016
2002,Oneonta,361200,2420,1649555,882,945178,2594733,03/15/2016
2002,Gilbertsville-Mt Upton,362202,630,290928,213,151439,442367,03/15/2016
2002,Cherry Valley-Springfield,362401,789,337472,377,239082,576554,03/15/2016
2002,Edmeston,362801,547,246007,220,152173,398180,03/15/2016
2002,Laurens,363401,556,329463,168,155609,485072,03/15/2016
2002,Schenevus,363601,543,322415,190,160391,482806,03/15/2016
2002,Milford,364001,612,366346,244,224970,591316,03/15/2016
2002,Morris,364201,491,310053,217,210474,520527,03/15/2016
2002,Otego-Unadilla,364801,1323,800852,523,466434,1267286,03/15/2016
2002,Cooperstown,365001,1161,560238,485,366576,926814,03/15/2016
2002,Richfield Springs,365601,732,287838,386,238728,526566,03/15/2016
2002,Worcester,366606,459,273761,220,196726,470487,03/15/2016
2002,Mahopac,372001,5543,5634109,797,1344129,6978238,03/15/2016
2002,Carmel,372002,6011,5619645,838,1295804,6915449,03/15/2016
2002,Haldane,372601,958,752301,251,299304,1051605,03/15/2016
2002,Garrison,372604,496,271577,66,60157,331734,03/15/2016
2002,Putnam Valley,372803,2389,3153074,302,628158,3781232,03/15/2016
2002,Brewster,373001,4377,3764585,760,1123141,4887726,03/15/2016
2002,Rensselaer,381400,1089,867562,400,415653,1283215,03/15/2016
2002,Troy,381700,4029,2449968,1518,1300100,3750068,03/15/2016
2002,Lansingburgh,381701,2508,1782056,925,935360,2717416,03/15/2016
2002,Berlin,382001,1428,882183,393,358856,1241039,03/15/2016
2002,Brunswick,382202,1664,1142523,441,466229,1608752,03/15/2016
2002,East Greenbush,382401,6125,3973674,1507,1535598,5509272,03/15/2016
2002,Hoosick Falls,382801,1545,824643,563,437638,1262281,03/15/2016
2002,North Greenbush,383201,305,80957,117,50761,131718,03/15/2016
2002,Wynantskill,383204,782,454113,288,265119,719232,03/15/2016
2002,Averill Park,384001,4077,2569721,915,878578,3448299,03/15/2016
2002,Hoosic Valley,384201,1403,953926,368,369088,1323014,03/15/2016
2002,Schodack,384401,1387,988504,329,368642,1357146,03/15/2016
2002,Clarkstown,392001,11276,8579193,1625,2155228,10734421,03/15/2016
2002,Nanuet,392008,2243,1666933,620,785122,2452055,03/15/2016
2002,Haverstraw-Stony Point,392201,7591,8658374,1692,2916054,11574428,03/15/2016
2002,South Orangetown,392401,3961,3547496,983,1494113,5041609,03/15/2016
2002,Nyack,392404,3673,3937963,801,1537440,5475403,03/15/2016
2002,Pearl River,392408,2918,2850729,728,1208483,4059212,03/15/2016
2002,Ramapo,392601,5764,7344398,1021,2110463,9454861,03/15/2016
2002,East Ramapo,392602,12055,13429490,1645,2842232,16271722,03/15/2016
2002,Ogdensburg,401200,2074,1090942,764,471779,1562721,03/15/2016
2002,Brasher Falls,402001,1218,582569,417,274622,857191,03/15/2016
2002,Canton,402201,1635,914941,449,363581,1278522,03/15/2016
2002,Clifton-Fine,402601,467,191156,254,127619,318775,03/15/2016
2002,Colton-Pierrepont,402801,556,205410,214,118078,323488,03/15/2016
2002,Edwards-Knox,403401,682,160753,204,63397,224150,03/15/2016
2002,Gouverneur,404001,1769,760581,601,337369,1097950,03/15/2016
2002,Hammond,404201,353,115653,141,64242,179895,03/15/2016
2002,Hermon-Dekalb,404401,504,249598,176,120543,370141,03/15/2016
2002,Lisbon,405002,741,387089,240,179161,566250,03/15/2016
2002,Madrid-Waddington,405601,932,499273,315,237804,737077,03/15/2016
2002,Massena,405801,3202,1635866,1350,1040565,2676431,03/15/2016
2002,Morristown,406001,602,282659,205,140179,422838,03/15/2016
2002,Norwood-Norfolk,406201,1335,753816,470,352446,1106262,03/15/2016
2002,Heuvelton,406404,793,439179,227,174951,614130,03/15/2016
2002,Parishville-Hopkinton,406601,654,248567,162,77073,325640,03/15/2016
2002,Potsdam,407402,1847,1298743,543,544170,1842913,03/15/2016
2002,Mechanicville,411000,1220,651447,585,510213,1161660,03/15/2016
2002,Saratoga Springs,411500,8503,4525844,1696,1412496,5938340,03/15/2016
2002,Burnt Hills-Ballston Lake,412001,4560,2947823,1100,1158531,4106354,03/15/2016
2002,Shenendehowa,412402,11894,7760710,1698,1805823,9566533,03/15/2016
2002,Corinth,412601,1337,656953,500,368378,1025331,03/15/2016
2002,Edinburg,413001,308,75848,154,55974,131822,03/15/2016
2002,Galway,413201,1472,734354,339,253338,987692,03/15/2016
2002,Ballston Spa,414201,4857,3463300,979,1005109,4468409,03/15/2016
2002,South Glens Falls,414401,3170,2053475,1001,925975,2979450,03/15/2016
2002,Schuylerville,415001,1967,1506132,461,531346,2037478,03/15/2016
2002,Stillwater,415201,1476,733293,350,274561,1007854,03/15/2016
2002,Waterford-Halfmoon,415401,865,644837,487,536240,1181077,03/15/2016
2002,Schenectady,421500,7231,5731307,3121,3474042,9205349,03/15/2016
2002,Duanesburg,422001,1147,728956,208,207150,936106,03/15/2016
2002,Scotia-Glenville,422202,3859,2626961,1108,1209961,3836922,03/15/2016
2002,Niskayuna,422401,5729,3597314,919,946582,4543896,03/15/2016
2002,Schalmont,422801,3039,1997517,909,918508,2916025,03/15/2016
2002,Rotterdam-Mohonasen,422803,4221,2423762,2051,1778186,4201948,03/15/2016
2002,Cobleskill-Richmondville,432602,2257,1052649,793,549418,1602067,03/15/2016
2002,Gilboa-Conesville,433401,516,224683,271,163672,388355,03/15/2016
2002,Jefferson,433601,391,171195,137,93461,264656,03/15/2016
2002,Middleburgh,433801,1147,643341,435,378054,1021395,03/15/2016
2002,Schoharie,434201,1376,861449,449,417700,1279149,03/15/2016
2002,Sharon Springs,434601,399,234939,149,128572,363511,03/15/2016
2002,Odessa-Montour,442001,1124,600647,399,310505,911152,03/15/2016
2002,Watkins Glen,442401,1619,674131,714,435221,1109352,03/15/2016
2002,South Seneca,452801,1205,604313,485,348499,952812,03/15/2016
2002,Romulus,453003,663,356791,220,183653,540444,03/15/2016
2002,Seneca Falls,453201,1834,1217794,764,771405,1989199,03/15/2016
2002,Waterloo,453801,2062,1054839,782,600971,1655810,03/15/2016
2002,Corning,460300,6681,4139104,2229,1951910,6091014,03/15/2016
2002,Hornell,460600,1652,779386,762,458777,1238163,03/15/2016
2002,Addison,462001,1352,871965,421,327292,1199257,03/15/2016
2002,Avoca,462201,742,355845,226,147945,503790,03/15/2016
2002,Bath,462402,1763,812762,657,468440,1281202,03/15/2016
2002,Bradford,462601,403,234043,131,104812,338855,03/15/2016
2002,Campbell-Savona,463002,1132,368975,331,155948,524923,03/15/2016
2002,Canisteo,463201,1037,624089,374,295793,919882,03/15/2016
2002,Greenwood,464601,258,143565,91,62686,206251,03/15/2016
2002,Arkport,465201,584,435939,209,225764,661703,03/15/2016
2002,Jasper-Troupsburg,465601,544,235081,193,115213,350294,03/15/2016
2002,Prattsburgh,466001,580,230445,196,106059,336504,03/15/2016
2002,Hammondsport,467201,1018,463898,403,271248,735146,03/15/2016
2002,Wayland-Cohocton,467401,2004,776905,604,334120,1111025,03/15/2016
2002,Babylon,472001,2447,2705554,397,699071,3404625,03/15/2016
2002,West Babylon,472002,4860,4980459,1118,1846031,6826490,03/15/2016
2002,North Babylon,472003,5787,5995128,1465,2481420,8476548,03/15/2016
2002,Lindenhurst,472004,7331,7674555,1774,3001392,10675947,03/15/2016
2002,Copiague,472005,4325,4605819,1147,1919117,6524936,03/15/2016
2002,Amityville,472006,3327,3709045,749,1321875,5030920,03/15/2016
2002,Deer Park,472007,4587,5034436,1501,2681394,7715830,03/15/2016
2002,Wyandanch,472009,832,844391,164,261847,1106238,03/15/2016
2002,Three Village,472201,8184,7429314,1275,1873660,9302974,03/15/2016
2002,Brookhaven-Comsewogue,472203,3918,3408635,762,1051836,4460471,03/15/2016
2002,South Country,472204,4258,3943161,733,1066314,5009475,03/15/2016
2002,Sachem,472205,15874,14438655,2275,3256568,17695223,03/15/2016
2002,Port Jefferson,472206,1464,881463,221,215277,1096740,03/15/2016
2002,Mount Sinai,472207,2293,2541848,337,605101,3146949,03/15/2016
2002,Miller Place,472208,3010,3218371,363,620541,3838912,03/15/2016
2002,Rocky Point,472209,3211,3406920,521,838414,4245334,03/15/2016
2002,Middle Country,472211,10293,8125821,2036,2530544,10656365,03/15/2016
2002,Longwood,472212,10124,9858577,3006,4229238,14087815,03/15/2016
2002,South Manor,472221,1673,1585844,206,316282,1902126,03/15/2016
2002,Patchogue-Medford,472224,8042,6253643,1650,1947017,8200660,03/15/2016
2002,William Floyd,472232,7398,7011656,1325,1879114,8890770,03/15/2016
2002,Center Moriches,472233,1332,1271596,254,377182,1648778,03/15/2016
2002,East Moriches,472234,1041,954491,182,267204,1221695,03/15/2016
2002,East Hampton,472401,1372,236191,342,105975,342166,03/15/2016
2002,Wainscott,472402,126,10080,27,4304,14384,03/15/2016
2002,Amagansett,472403,267,31628,97,22617,54245,03/15/2016
2002,Springs,472404,957,269890,268,151306,421196,03/15/2016
2002,Sag Harbor,472405,1167,379869,534,317039,696908,03/15/2016
2002,Montauk,472406,709,113678,237,95389,209067,03/15/2016
2002,Elwood,472601,3041,2454067,628,879328,3333395,03/15/2016
2002,Cold Spring Harbor,472602,2069,1361941,153,174813,1536754,03/15/2016
2002,Huntington,472603,7120,5938073,1414,2011142,7949215,03/15/2016
2002,Northport-East Northport,472604,8562,5364227,1609,1744347,7108574,03/15/2016
2002,Half Hollow Hills,472605,9763,6536909,1324,1395269,7932178,03/15/2016
2002,Harborfields,472606,4512,3817986,755,1104557,4922543,03/15/2016
2002,Commack,472610,8902,7650482,1790,2625141,10275623,03/15/2016
2002,South Huntington,472613,8175,7175164,1935,2919698,10094862,03/15/2016
2002,Bay Shore,472801,4974,5084330,1119,1883333,6967663,03/15/2016
2002,Islip,472802,3578,3173576,687,1009721,4183297,03/15/2016
2002,East Islip,472803,5251,5062080,1046,1817921,6880001,03/15/2016
2002,Sayville,472804,3773,3984157,815,1419325,5403482,03/15/2016
2002,Bayport-Blue Point,472805,2768,2898735,473,805132,3703867,03/15/2016
2002,Hauppauge,472806,4728,2391035,916,758252,3149287,03/15/2016
2002,Connetquot,472807,7988,7511748,1458,2195694,9707442,03/15/2016
2002,West Islip,472809,6034,5511839,1314,1997922,7509761,03/15/2016
2002,Brentwood,472812,7944,6653340,2221,3080255,9733595,03/15/2016
2002,Central Islip,472813,4701,5697850,858,1679697,7377547,03/15/2016
2002,Fire Island,472814,91,9937,17,3094,13031,03/15/2016
2002,Shoreham-Wading River,473001,2771,2570868,737,1022769,3593637,03/15/2016
2002,Riverhead,473002,5645,4431044,2517,2576467,7007511,03/15/2016
2002,Shelter Island,473201,533,112042,247,86805,198847,03/15/2016
2002,Smithtown,473401,12740,11167298,2330,3299653,14466951,03/15/2016
2002,Kings Park,473405,5003,3801542,839,1070049,4871591,03/15/2016
2002,Remsenburg-Speonk,473601,376,99465,87,41686,141151,03/15/2016
2002,Westhampton Beach,473602,825,255791,245,134076,389867,03/15/2016
2002,Quogue,473603,219,24004,50,9926,33930,03/15/2016
2002,Hampton Bays,473605,1825,857757,756,629951,1487708,03/15/2016
2002,Southhampton,473606,1632,328166,613,222584,550750,03/15/2016
2002,Bridgehampton,473609,288,54317,103,35187,89504,03/15/2016
2002,Sagaponack,473610,85,3530,8,602,4132,03/15/2016
2002,Eastport,473611,1695,1923049,561,882933,2805982,03/15/2016
2002,Tuckahoe Common,473613,446,166979,176,119353,286332,03/15/2016
2002,East Quogue,473617,901,484340,269,237799,722139,03/15/2016
2002,Oysterponds,473802,343,89888,202,88341,178229,03/15/2016
2002,Fishers Island,473804,40,10003,8,3347,13350,03/15/2016
2002,Southold,473805,1341,692634,654,561020,1253654,03/15/2016
2002,Greenport,473810,570,317158,344,310807,627965,03/15/2016
2002,Mattituck-Cutchogue,473812,2031,1151910,739,696001,1847911,03/15/2016
2002,New Suffolk,473815,72,19344,44,19351,38695,03/15/2016
2002,Fallsburg,482801,1038,946110,378,513394,1459504,03/15/2016
2002,Eldred,483401,868,469852,360,302729,772581,03/15/2016
2002,Liberty,483601,1375,1163569,530,697573,1861142,03/15/2016
2002,Tri-Valley,484201,1165,739060,301,278062,1017122,03/15/2016
2002,Roscoe,484401,329,140585,184,118494,259079,03/15/2016
2002,Livingston Manor,484402,584,264136,262,178583,442719,03/15/2016
2002,Monticello,484601,2822,1741586,1107,1053818,2795404,03/15/2016
2002,Sullivan West,484802,1980,964520,912,694551,1659071,03/15/2016
2002,Waverly,492001,1628,637829,652,357500,995329,03/15/2016
2002,Candor,492401,1009,553410,346,299215,852625,03/15/2016
2002,Newark Valley,492602,1545,1024336,483,468937,1493273,03/15/2016
2002,Owego-Apalachin,493001,2773,1936694,999,1009146,2945840,03/15/2016
2002,Spencer-Van Etten,493401,1207,564044,365,245343,809387,03/15/2016
2002,Tioga,493603,1102,433956,350,202578,636534,03/15/2016
2002,Ithaca,500700,7481,4680952,1613,1454981,6135933,03/15/2016
2002,Dryden,502401,2247,1546961,473,445218,1992179,03/15/2016
2002,Groton,502801,1183,648604,320,244282,892886,03/15/2016
2002,Lansing,503201,1496,896757,337,307282,1204039,03/15/2016
2002,Newfield,503401,945,638954,246,195471,834425,03/15/2016
2002,Trumansburg,503601,1556,983919,404,363672,1347591,03/15/2016
2002,Kingston,510800,7913,4947904,3003,2937538,7885442,03/15/2016
2002,Highland,513203,1978,1487721,552,657111,2144832,03/15/2016
2002,Rondout Valley,513401,3343,2798455,972,1197664,3996119,03/15/2016
2002,Marlboro,513601,2008,1065008,519,448656,1513664,03/15/2016
2002,New Paltz,513801,2944,2046787,642,723373,2770160,03/15/2016
2002,Onteora,514001,3171,1619978,1123,892366,2512344,03/15/2016
2002,Saugerties,514801,3960,2592698,1234,1264756,3857454,03/15/2016
2002,Wallkill,515201,3373,2431835,870,843999,3275834,03/15/2016
2002,Ellenville,515602,1469,1197326,591,591818,1789144,03/15/2016
2002,Glens Falls,520500,2552,1441209,841,739465,2180674,03/15/2016
2002,Bolton,522001,391,93547,130,50156,143703,03/15/2016
2002,Lake George,522201,1409,407255,422,197480,604735,03/15/2016
2002,North Warren,522402,938,323033,428,229279,552312,03/15/2016
2002,Johnsburg,523001,536,295848,234,193036,488884,03/15/2016
2002,Hadley-Luzerne,523201,1153,536510,501,353923,890433,03/15/2016
2002,Queensbury,523402,3919,2046947,933,750165,2797112,03/15/2016
2002,Glens Falls Common,523418,219,78112,111,60516,138628,03/15/2016
2002,Warrensburg,524001,1156,809700,383,394552,1204252,03/15/2016
2002,Argyle,532001,845,457821,232,188023,645844,03/15/2016
2002,Fort Ann,532802,691,407350,202,187733,595083,03/15/2016
2002,Fort Edward,533001,489,324036,220,232637,556673,03/15/2016
2002,Granville,533201,1367,789997,453,378697,1168694,03/15/2016
2002,Greenwich,533401,1294,817941,456,453490,1271431,03/15/2016
2002,Hartford,533801,670,408272,155,139398,547670,03/15/2016
2002,Hudson Falls,534401,2342,1364531,961,833003,2197534,03/15/2016
2002,Putnam,534601,145,38770,46,19343,58113,03/15/2016
2002,Salem,534801,787,459657,285,253364,713021,03/15/2016
2002,Cambridge,535010,1212,697161,480,422556,1119717,03/15/2016
2002,Whitehall,535201,823,408917,423,289863,698780,03/15/2016
2002,Newark,542001,2631,1735992,948,968383,2704375,03/15/2016
2002,Clyde-Savannah,542401,1052,717634,441,430476,1148110,03/15/2016
2002,Lyons,542801,1118,656380,448,358270,1014650,03/15/2016
2002,Gananda,543002,1276,920372,80,92750,1013122,03/15/2016
2002,Marion,543201,1287,922199,261,290973,1213172,03/15/2016
2002,Wayne,543401,3407,2012251,601,566689,2578940,03/15/2016
2002,Palmyra-Macedon,543601,2502,2023131,610,738974,2762105,03/15/2016
2002,Sodus,544201,1552,1127880,539,557161,1685041,03/15/2016
2002,Williamson,544602,1465,995813,380,413605,1409418,03/15/2016
2002,North Rose-Wolcott,544801,1866,984186,670,500155,1484341,03/15/2016
2002,Red Creek,544803,1170,463832,374,212419,676251,03/15/2016
2002,Mount Vernon,550800,4682,8872713,1506,4432178,13304891,03/15/2016
2002,New Rochelle,551000,7939,13602006,1558,4487555,18089561,03/15/2016
2002,Peekskill,551200,2645,4660714,597,1466330,6127044,03/15/2016
2002,Rye,551400,2835,2980962,384,714530,3695492,03/15/2016
2002,White Plains,551700,6056,11130253,1130,2995052,14125305,03/15/2016
2002,Yonkers,551800,15510,21017660,4606,9394807,30412467,03/15/2016
2002,Katonah-Lewisboro,552001,4588,6939577,445,1151408,8090985,03/15/2016
2002,Bedford,552002,4669,4942945,657,1126627,6069572,03/15/2016
2002,Croton-Harmon,552202,1951,3673728,315,923500,4597228,03/15/2016
2002,Hendrick Hudson,552203,3142,4649971,561,1115922,5765893,03/15/2016
2002,Eastchester,552401,2799,4986044,757,2031062,7017106,03/15/2016
2002,Tuckahoe,552402,1124,1759476,250,613623,2373099,03/15/2016
2002,Bronxville,552403,1127,1987155,67,323450,2310605,03/15/2016
2002,Tarrytowns,552601,2121,3615672,467,1281793,4897465,03/15/2016
2002,Irvington,552602,1691,2852178,214,643341,3495519,03/15/2016
2002,Dobbs Ferry,552603,1348,3004785,221,836258,3841043,03/15/2016
2002,Hastings On Hudson,552604,1504,3370977,305,1101459,4472436,03/15/2016
2002,Ardsley,552605,2334,3743578,386,1039133,4782711,03/15/2016
2002,Edgemont,552606,1552,2836801,132,396564,3233365,03/15/2016
2002,Greenburgh,552607,3787,5467755,886,1951021,7418776,03/15/2016
2002,Elmsford,552609,1194,1592111,336,733531,2325642,03/15/2016
2002,Harrison,552801,3150,2685167,635,1017879,3703046,03/15/2016
2002,Mamaroneck,553201,4292,5273114,608,1334238,6607352,03/15/2016
2002,Mount Pleasant,553401,2617,3341712,648,1389758,4731470,03/15/2016
2002,Pocantico Hills,553402,426,273500,90,88652,362152,03/15/2016
2002,Valhalla,553405,1694,2684211,410,1137463,3821674,03/15/2016
2002,Pleasantville,553409,1821,3194497,321,918293,4112790,03/15/2016
2002,Chappaqua,553604,4159,5994595,223,567809,6562404,03/15/2016
2002,Byram Hills,553801,2767,2826079,218,430813,3256892,03/15/2016
2002,North Salem,554001,1784,2394084,215,429238,2823322,03/15/2016
2002,Ossining,554201,5281,9441731,826,2283164,11724895,03/15/2016
2002,Briarcliff Manor,554202,1580,2945265,113,351101,3296366,03/15/2016
2002,Pelham,554401,2330,3220262,345,761233,3981495,03/15/2016
2002,Rye Neck,554801,1471,2200591,327,793834,2994425,03/15/2016
2002,Port Chester-Rye,554804,2645,3809923,1102,2464811,6274734,03/15/2016
2002,Blind Brook-Rye,554805,1568,2209510,194,451325,2660835,03/15/2016
2002,Scarsdale,555001,4483,5521886,192,421200,5943086,03/15/2016
2002,Somers,555201,4247,5480736,947,1943471,7424207,03/15/2016
2002,Lakeland,555401,7914,14241478,1606,3820164,18061642,03/15/2016
2002,Yorktown,555402,4897,8339023,587,1591567,9930590,03/15/2016
2002,Attica,562201,2188,1053899,614,474477,1528376,03/15/2016
2002,Letchworth,562601,1371,691217,393,294630,985847,03/15/2016
2002,Wyoming,563802,447,227673,93,76666,304339,03/15/2016
2002,Perry,564201,1212,624271,457,365735,990006,03/15/2016
2002,Warsaw,564801,1333,807773,411,394321,1202094,03/15/2016
2002,Penn Yan,573001,2686,1135083,1119,726790,1861873,03/15/2016
2002,Dundee,573401,1082,470605,441,274769,745374,03/15/2016
2002,New York City School,650000,436371,89615422,87270,30033251,119648673,03/15/2016
2001,Albany,010100,8941,5458237,3941,3630295,9088532,03/15/2016
2001,Cohoes,010300,1799,1209954,889,874889,2084843,03/15/2016
2001,Watervliet,011800,1165,575975,581,444294,1020269,03/15/2016
2001,Berne-Knox-Westerlo,012001,1447,850820,360,325906,1176726,03/15/2016
2001,Bethlehem,012206,6115,4527793,1198,1443846,5971639,03/15/2016
2001,Ravena-Coeymans-Selkirk,012402,2451,1463875,718,652848,2116723,03/15/2016
2001,South Colonie,012601,7784,3637047,2956,2173146,5810193,03/15/2016
2001,North Colonie,012605,6497,2815465,1784,1261231,4076696,03/15/2016
2001,Menands,012615,339,131200,115,69112,200312,03/15/2016
2001,Maplewood,012622,73,33623,66,46301,79924,03/15/2016
2001,Green Island,012801,252,177112,152,171188,348300,03/15/2016
2001,Guilderland,013002,6593,4117736,1562,1585281,5703017,03/15/2016
2001,Voorheesville,013403,1790,1120525,369,378860,1499385,03/15/2016
2001,Alfred-Almond,022001,805,532020,261,251404,783424,03/15/2016
2001,Andover,023001,418,267243,167,146162,413405,03/15/2016
2001,Genesee Valley,023202,658,253616,370,187866,441482,03/15/2016
2001,Belfast,023401,381,156732,174,94952,251684,03/15/2016
2001,Canaseraga,024002,370,196436,141,101394,297830,03/15/2016
2001,Cuba-Rushford,024801,1156,461899,507,285700,747599,03/15/2016
2001,Friendship,025001,308,160556,161,102369,262925,03/15/2016
2001,Fillmore,025801,697,295160,259,153117,448277,03/15/2016
2001,Whitesville,026001,230,135226,90,67791,203017,03/15/2016
2001,Scio,026601,463,272421,182,140436,412857,03/15/2016
2001,Wellsville,027001,1553,864252,833,614484,1478736,03/15/2016
2001,Bolivar-Richburg,027602,906,288348,359,145070,433418,03/15/2016
2001,Binghamton,030200,5175,3159954,2849,2320173,5480127,03/15/2016
2001,Chenango Forks,032001,2123,1384700,550,561177,1945877,03/15/2016
2001,South Mountain-Hickory,032201,116,30514,28,12277,42791,03/15/2016
2001,Harpursville,032601,1012,402850,294,170973,573823,03/15/2016
2001,Susquehanna Valley,032801,2299,1608998,811,873972,2482970,03/15/2016
2001,Chenango Valley,033001,2486,1697275,1187,1286010,2983285,03/15/2016
2001,Maine-Endwell,033801,3212,2832805,1390,1798937,4631742,03/15/2016
2001,Deposit,034201,650,285351,321,206118,491469,03/15/2016
2001,Whitney Point,034401,1604,684771,468,296047,980818,03/15/2016
2001,Union-Endicott,034601,5141,4212294,2424,2909433,7121727,03/15/2016
2001,Johnson City,034602,2804,2017059,1739,1664376,3681435,03/15/2016
2001,Vestal,034801,5428,3664343,1759,1801264,5465607,03/15/2016
2001,Windsor,035001,1970,1122871,670,570186,1693057,03/15/2016
2001,Olean,041200,2555,1189991,1336,799309,1989300,03/15/2016
2001,Salamanca,041600,1138,436339,565,243941,680280,03/15/2016
2001,Allegany-Limestone,042001,1498,541124,522,268814,809938,03/15/2016
2001,West Valley,042204,473,229132,163,116399,345531,03/15/2016
2001,Ellicottville,043601,620,247728,254,151093,398821,03/15/2016
2001,Franklinville,044001,813,383595,326,206868,590463,03/15/2016
2001,Hinsdale,044601,537,235643,207,128430,364073,03/15/2016
2001,Cattaraugus - Little Valley,046402,1356,669609,510,354417,1024026,03/15/2016
2001,Gowanda,047201,1378,583901,656,408631,992532,03/15/2016
2001,Portville,047401,1032,472680,372,248405,721085,03/15/2016
2001,Randolph,047601,1137,448272,429,237084,685356,03/15/2016
2001,Yorkshire-Pioneer,048401,2822,1106569,922,539103,1645672,03/15/2016
2001,Auburn,050100,4805,2703226,2406,2055266,4758492,03/15/2016
2001,Weedsport,052201,1049,564793,347,292037,856830,03/15/2016
2001,Cato-Meridian,052401,1281,693896,292,237043,930939,03/15/2016
2001,Southern Cayuga,053001,1172,516981,410,280162,797143,03/15/2016
2001,Port Byron,053801,1375,791709,443,358705,1150414,03/15/2016
2001,Moravia,054201,1302,537568,338,198842,736410,03/15/2016
2001,Union Springs,055401,1171,805163,409,427219,1232382,03/15/2016
2001,Dunkirk,060300,2110,1313474,1381,1167199,2480673,03/15/2016
2001,Jamestown,060800,4568,2303758,1998,1337885,3641643,03/15/2016
2001,Southwestern,062201,2207,1332679,823,758186,2090865,03/15/2016
2001,Frewsburg,062401,997,661891,346,350047,1011938,03/15/2016
2001,Cassadaga Valley,062601,1310,647361,494,347601,994962,03/15/2016
2001,Chautauqua Lake,062803,1146,330634,455,206013,536647,03/15/2016
2001,Pine Valley,063001,737,422072,284,226109,648181,03/15/2016
2001,Clymer,063201,562,249278,244,170962,420240,03/15/2016
2001,Bemus Point,063601,1083,521647,417,303185,824832,03/15/2016
2001,Falconer,063801,1456,863339,563,513140,1376479,03/15/2016
2001,Silver Creek,064601,1192,614852,522,397373,1012225,03/15/2016
2001,Forestville,064603,794,374116,293,209765,583881,03/15/2016
2001,Panama,064801,750,389552,258,196411,585963,03/15/2016
2001,Fredonia,065801,1991,1102835,748,653980,1756815,03/15/2016
2001,Brocton,066001,737,532480,264,277792,810272,03/15/2016
2001,Ripley,066201,379,267508,185,166307,433815,03/15/2016
2001,Sherman,066601,508,251916,144,102472,354388,03/15/2016
2001,Westfield,067201,934,621092,359,350174,971266,03/15/2016
2001,Elmira,070400,6936,3934447,3421,2766520,6700967,03/15/2016
2001,Horseheads,073401,5007,2500593,1908,1524263,4024856,03/15/2016
2001,Elmira Heights,073402,1129,578026,622,477490,1055516,03/15/2016
2001,Norwich,081100,2093,1343247,823,720707,2063954,03/15/2016
2001,Afton,082001,783,490090,299,269014,759104,03/15/2016
2001,Bainbridge-Guilford,082201,1057,644261,389,324644,968905,03/15/2016
2001,Greene,083001,1426,836515,435,388045,1224560,03/15/2016
2001,Unadilla Valley,083803,1067,486601,360,222588,709189,03/15/2016
2001,Georgetown-So Otselic Valley,084401,497,269893,139,97765,367658,03/15/2016
2001,Oxford Academy,084601,992,594807,393,322495,917302,03/15/2016
2001,Sherburne-Earlville,085601,1594,924764,561,461402,1386166,03/15/2016
2001,Plattsburgh,091300,1765,1092860,761,733507,1826367,03/15/2016
2001,Ausable Valley,092201,1725,760283,697,406375,1166658,03/15/2016
2001,Beekmantown,092401,2429,1132319,691,444743,1577062,03/15/2016
2001,Northeastern Clinton,092801,1817,1075196,591,471931,1547127,03/15/2016
2001,Chazy,093001,657,386591,199,172084,558675,03/15/2016
2001,Northern Adirondack,093601,1281,420153,418,175836,595989,03/15/2016
2001,Peru,094001,2351,1188640,557,409307,1597947,03/15/2016
2001,Saranac,094401,2103,1146734,656,507189,1653923,03/15/2016
2001,Hudson,100600,1901,1075126,1008,880613,1955739,03/15/2016
2001,Taconic Hills,102801,1922,940971,832,637634,1578605,03/15/2016
2001,Germantown,103602,781,365483,329,245279,610762,03/15/2016
2001,Chatham,103801,1758,803747,545,416621,1220368,03/15/2016
2001,Kinderhook,104401,2790,1410922,742,584414,1995336,03/15/2016
2001,New Lebanon,104801,833,399126,248,182864,581990,03/15/2016
2001,Cortland,110200,2754,1381659,1134,897448,2279107,03/15/2016
2001,Cincinnatus,112001,691,278062,222,116148,394210,03/15/2016
2001,Mc Graw,112204,656,310356,223,155379,465735,03/15/2016
2001,Homer,113001,2596,1418920,735,617184,2036104,03/15/2016
2001,Marathon,113401,837,470447,264,208841,679288,03/15/2016
2001,Andes,122002,227,88838,162,99479,188317,03/15/2016
2001,Downsville,122401,356,118050,201,87038,205088,03/15/2016
2001,Charlotte Valley,122601,521,216307,214,134251,350558,03/15/2016
2001,Delhi,122801,1095,494270,533,385881,880151,03/15/2016
2001,Franklin,123201,408,197903,167,127245,325148,03/15/2016
2001,Hancock,123606,422,249591,248,202227,451818,03/15/2016
2001,Margaretville,124601,631,184941,340,155487,340428,03/15/2016
2001,Roxbury,124802,504,262920,262,208523,471443,03/15/2016
2001,Sidney,125001,1324,859432,686,634505,1493937,03/15/2016
2001,Stamford,125201,506,325831,193,186863,512694,03/15/2016
2001,South Kortright,125202,439,214313,223,169567,383880,03/15/2016
2001,Walton,125601,1114,409316,515,287907,697223,03/15/2016
2001,Beacon,130200,2661,1603424,943,922178,2525602,03/15/2016
2001,Poughkeepsie,131300,2568,1677785,1017,1008386,2686171,03/15/2016
2001,Dover,132602,1316,990304,315,408657,1398961,03/15/2016
2001,Hyde Park,133201,5038,3662358,1465,1627742,5290100,03/15/2016
2001,Northeast,133801,878,484375,307,267965,752340,03/15/2016
2001,Pawling,134001,1475,948880,359,386714,1335594,03/15/2016
2001,Pine Plains,134201,1564,783563,517,406120,1189683,03/15/2016
2001,Arlington,134601,9908,6633973,1802,1964354,8598327,03/15/2016
2001,Spackenkill,134602,1696,1107952,440,465006,1572958,03/15/2016
2001,Red Hook,134801,1967,1414326,588,685840,2100166,03/15/2016
2001,Rhinebeck,135001,1638,875635,485,444489,1320124,03/15/2016
2001,Wappingers,135601,13403,6892786,2974,2584044,9476830,03/15/2016
2001,Millbrook,135801,1307,644540,301,253810,898350,03/15/2016
2001,Buffalo,140200,27282,9949338,11501,5430047,15379385,03/15/2016
2001,Lackawanna,140900,1934,488136,1618,538963,1027099,03/15/2016
2001,Tonawanda,141600,2864,1446685,1440,1128896,2575581,03/15/2016
2001,Alden,142001,2467,1510264,806,774466,2284730,03/15/2016
2001,Amherst,142201,5185,3403177,1653,1705799,5108976,03/15/2016
2001,Williamsville,142203,14855,8362372,3453,3092279,11454651,03/15/2016
2001,Sweet Home,142207,4867,1838358,2121,1307311,3145669,03/15/2016
2001,East Aurora,142401,2654,1358209,844,697733,2055942,03/15/2016
2001,Cheektowaga,143001,3331,1532392,2100,1405602,2937994,03/15/2016
2001,Cheektowaga-Maryvale,143002,3293,1659338,2297,1829212,3488550,03/15/2016
2001,Cleveland Hill,143003,2127,1402732,1222,1277324,2680056,03/15/2016
2001,Depew,143007,3214,1962940,1255,1223131,3186071,03/15/2016
2001,Cheektowaga-Sloan,143009,1985,1285561,1711,1766516,3052077,03/15/2016
2001,Clarence,143201,5348,2556509,1330,898921,3455430,03/15/2016
2001,Springville-Griffith,143801,2699,1344533,876,679599,2024132,03/15/2016
2001,Eden,144001,2156,915658,657,456496,1372154,03/15/2016
2001,Iroquois,144201,3808,1637999,1179,808520,2446519,03/15/2016
2001,Evans-Brant,144401,3822,2121080,1100,863316,2984396,03/15/2016
2001,Grand Island,144601,4365,2532113,939,865681,3397794,03/15/2016
2001,Hamburg,144801,4956,2605035,1497,1296848,3901883,03/15/2016
2001,Frontier,144804,6647,3093244,2261,1590578,4683822,03/15/2016
2001,Holland,145001,1521,654942,376,263714,918656,03/15/2016
2001,Lancaster,145201,8089,3939156,2673,2015861,5955017,03/15/2016
2001,Akron,145601,1745,835166,583,386030,1221196,03/15/2016
2001,North Collins,145801,837,540406,314,322160,862566,03/15/2016
2001,Orchard Park,146001,6964,3776874,1633,1436521,5213395,03/15/2016
2001,Kenmore,146401,13553,8512459,6797,6872336,15384795,03/15/2016
2001,West Seneca,146801,10873,5707371,4956,4012350,9719721,03/15/2016
2001,Crown Point,152203,365,139504,180,96824,236328,03/15/2016
2001,Elizabethtown-Lewis,152401,478,232432,171,118898,351330,03/15/2016
2001,Keene,153001,232,82396,88,50455,132851,03/15/2016
2001,Minerva,153401,187,90566,87,62858,153424,03/15/2016
2001,Moriah,153601,843,325075,513,261789,586864,03/15/2016
2001,Newcomb,153801,127,9190,73,7283,16473,03/15/2016
2001,Lake Placid,154002,1060,363956,341,175103,539059,03/15/2016
2001,Schroon Lake,154601,404,105640,200,81514,187154,03/15/2016
2001,Ticonderoga,154801,1122,316077,465,203083,519160,03/15/2016
2001,Westport,155001,280,158290,141,121866,280156,03/15/2016
2001,Willsboro,155201,459,193325,274,160820,354145,03/15/2016
2001,Tupper Lake,162001,1193,478158,537,271517,749675,03/15/2016
2001,Chateaugay,163401,635,288626,235,142328,430954,03/15/2016
2001,Salmon River,164201,708,292685,310,178177,470862,03/15/2016
2001,Saranac Lake,164601,1993,770618,635,353169,1123787,03/15/2016
2001,Malone,164801,2751,1391556,1106,748493,2140049,03/15/2016
2001,Brushton-Moira,165001,832,348879,309,178655,527534,03/15/2016
2001,St. Regis Falls,165401,422,156020,166,83664,239684,03/15/2016
2001,Gloversville,170500,2825,1801841,1395,1154630,2956471,03/15/2016
2001,Johnstown,170800,2010,1137858,797,638926,1776784,03/15/2016
2001,Broadalbin-Perth,172201,2086,796347,711,416724,1213071,03/15/2016
2001,Wheelerville,172401,331,138163,128,80871,219034,03/15/2016
2001,Mayfield,173001,1272,641064,460,333079,974143,03/15/2016
2001,Northville,173201,557,239285,274,174932,414217,03/15/2016
2001,Oppenheim-Ephratah,173401,551,276988,197,128259,405247,03/15/2016
2001,Batavia,180200,2812,1734220,1191,1124875,2859095,03/15/2016
2001,Alexander,182202,1100,795207,305,336540,1131747,03/15/2016
2001,Byron-Bergen,183001,1508,1066016,415,410729,1476745,03/15/2016
2001,Elba,183401,572,373266,181,186978,560244,03/15/2016
2001,Le Roy,183601,1607,1007733,545,521555,1529288,03/15/2016
2001,Oakfield-Alabama,183801,1045,795114,391,452275,1247389,03/15/2016
2001,Pavilion,184001,1125,764739,263,268200,1032939,03/15/2016
2001,Pembroke,184202,1363,808786,451,409734,1218520,03/15/2016
2001,Cairo-Durham,192401,1618,795114,720,546044,1341158,03/15/2016
2001,Catskill,192601,1964,1087362,840,702838,1790200,03/15/2016
2001,Coxsackie-Athens,192801,1753,839936,599,438069,1278005,03/15/2016
2001,Greenville,193201,1634,922111,582,521354,1443465,03/15/2016
2001,Hunter-Tannersville,193601,624,271038,285,190212,461250,03/15/2016
2001,Windham-Ashland-Jewett,194601,555,176031,261,132412,308443,03/15/2016
2001,Piseco,202001,78,9026,43,8238,17264,03/15/2016
2001,Indian Lake,202601,304,86616,163,72994,159610,03/15/2016
2001,Inlet,202801,90,10934,39,7794,18728,03/15/2016
2001,Lake Pleasant,203001,172,47232,104,46231,93463,03/15/2016
2001,Long Lake,203201,160,37864,113,40735,78599,03/15/2016
2001,Raquette Lake,203202,26,1540,14,1244,2784,03/15/2016
2001,Wells,203601,200,66323,118,60377,126700,03/15/2016
2001,Little Falls,210900,1122,667265,668,561837,1229102,03/15/2016
2001,West Canada Valley,212402,907,446061,299,218910,664971,03/15/2016
2001,Frankfort-Schuyler,212602,1254,710477,598,519535,1230012,03/15/2016
2001,Ilion,212801,1505,585581,640,369019,954600,03/15/2016
2001,Mohawk,212802,1013,484646,463,333340,817986,03/15/2016
2001,Herkimer,213001,1370,735048,865,626386,1361434,03/15/2016
2001,Dolgeville,213602,918,362854,446,243145,605999,03/15/2016
2001,Poland,213803,843,351698,287,178509,530207,03/15/2016
2001,Van Hornesville-Owen D. Young,215001,300,180487,110,100103,280590,03/15/2016
2001,Town Of Webb,215401,559,116996,272,88667,205663,03/15/2016
2001,Mount Markham,215601,1369,848948,449,408894,1257842,03/15/2016
2001,Watertown,221800,3293,1292664,1488,845087,2137751,03/15/2016
2001,South Jefferson,222001,1859,725096,558,306204,1031300,03/15/2016
2001,Alexandria,222202,711,260727,291,157131,417858,03/15/2016
2001,Indian River,222401,1408,263144,412,105453,368597,03/15/2016
2001,General Brown,222601,1592,600883,498,273191,874074,03/15/2016
2001,Thousand Islands,223201,1279,558493,582,380167,938660,03/15/2016
2001,Belleville-Henderson,223402,592,172385,289,121384,293769,03/15/2016
2001,Sackets Harbor,223801,521,251935,181,129357,381292,03/15/2016
2001,Lyme,224401,428,161722,237,138865,300587,03/15/2016
2001,La Fargeville,224601,481,190461,157,88276,278737,03/15/2016
2001,Carthage,226001,2127,1086738,810,577363,1664101,03/15/2016
2001,Copenhagen,232201,507,193055,128,69306,262361,03/15/2016
2001,Harrisville,232401,518,260989,176,106956,367945,03/15/2016
2001,Lowville,233601,1444,543166,559,293617,836783,03/15/2016
2001,South Lewis,234001,1403,560813,572,304519,865332,03/15/2016
2001,Beaver River,234401,1130,345381,350,154904,500285,03/15/2016
2001,Avon,242001,1054,826560,304,346285,1172845,03/15/2016
2001,Caledonia-Mumford,242201,1263,706185,358,317444,1023629,03/15/2016
2001,Geneseo,242601,1250,674914,317,275765,950679,03/15/2016
2001,Livonia,243401,2425,1309338,544,449399,1758737,03/15/2016
2001,Mount Morris,243601,574,365646,274,254557,620203,03/15/2016
2001,Dansville,243801,1959,948964,683,483423,1432387,03/15/2016
2001,Dalton-Nunda,244001,1089,644302,324,264415,908717,03/15/2016
2001,York,245201,1066,591451,312,268067,859518,03/15/2016
2001,Oneida,251200,2582,1244035,939,688148,1932183,03/15/2016
2001,Brookfield,252009,271,122857,80,51145,174002,03/15/2016
2001,Cazenovia,252201,2056,1129299,501,432598,1561897,03/15/2016
2001,De Ruyter,252401,499,267502,172,135007,402509,03/15/2016
2001,Morrisville-Eaton,252601,897,450535,236,167140,617675,03/15/2016
2001,Hamilton,253201,848,484778,242,207642,692420,03/15/2016
2001,Canastota,253601,1721,898824,610,473978,1372802,03/15/2016
2001,Madison,254001,567,359715,192,171413,531128,03/15/2016
2001,Stockbridge Valley,254601,479,237673,152,108613,346286,03/15/2016
2001,Chittenango,254801,2970,2043438,719,720070,2763508,03/15/2016
2001,Rochester,261400,24728,9749645,5906,3255953,13005598,03/15/2016
2001,Brighton,262001,4943,3511862,972,1113089,4624951,03/15/2016
2001,Gates-Chili,262601,7399,5009809,2891,3116053,8125862,03/15/2016
2001,Greece,262801,17118,10668627,5425,5454198,16122825,03/15/2016
2001,East Irondequoit,263401,5726,4051754,2835,3136548,7188302,03/15/2016
2001,West Irondequoit,263403,5822,4463533,2140,2673480,7137013,03/15/2016
2001,Honeoye Falls-Lima,263601,3046,1920806,488,493377,2414183,03/15/2016
2001,Spencerport,263801,4927,3285714,1174,1274780,4560494,03/15/2016
2001,Hilton,264001,5522,3360610,1060,1045645,4406255,03/15/2016
2001,Penfield,264201,7492,5374311,1424,1666583,7040894,03/15/2016
2001,Fairport,264401,8931,5617487,1767,1771458,7388945,03/15/2016
2001,East Rochester,264413,1551,976547,685,659427,1635974,03/15/2016
2001,Pittsford,264601,7904,4804126,977,977594,5781720,03/15/2016
2001,Churchville-Chili,264801,5041,3381594,1153,1237635,4619229,03/15/2016
2001,Rush-Henrietta,265001,7613,4133400,1963,1696713,5830113,03/15/2016
2001,Brockport,265201,4478,2749761,745,720991,3470752,03/15/2016
2001,Webster,265401,11116,6442482,2751,2592792,9035274,03/15/2016
2001,Wheatland-Chili,265601,1177,816310,371,400754,1217064,03/15/2016
2001,Amsterdam,270100,3609,2670630,2228,2421593,5092223,03/15/2016
2001,Canajoharie,272201,1067,626268,487,419487,1045755,03/15/2016
2001,Fonda-Fultonville,272801,1620,980990,551,483078,1464068,03/15/2016
2001,Fort Plain,273001,862,664993,407,434538,1099531,03/15/2016
2001,St. Johnsville,273802,552,300552,306,225908,526460,03/15/2016
2001,Glen Cove,280500,2917,2752250,1222,1885365,4637615,03/15/2016
2001,Long Beach,281000,6111,3406404,1077,1128583,4534987,03/15/2016
2001,Hempstead,282001,2491,3384280,528,1233680,4617960,03/15/2016
2001,Uniondale,282002,4218,3330140,936,1288927,4619067,03/15/2016
2001,East Meadow,282003,9903,9241402,3026,4330777,13572179,03/15/2016
2001,North Bellmore,282004,5324,4603923,1254,1926795,6530718,03/15/2016
2001,Levittown,282005,9941,11684628,2366,4994898,16679526,03/15/2016
2001,Seaford,282006,3506,3093073,857,1319253,4412326,03/15/2016
2001,Bellmore,282007,2846,2503333,493,748682,3252015,03/15/2016
2001,Roosevelt,282008,1900,2081087,385,731146,2812233,03/15/2016
2001,Freeport,282009,4669,4472272,913,1514493,5986765,03/15/2016
2001,Baldwin,282010,6405,6498944,1129,2000420,8499364,03/15/2016
2001,Oceanside,282011,7711,6362218,1719,2493387,8855605,03/15/2016
2001,Malverne,282012,2723,2721680,650,1194328,3916008,03/15/2016
2001,Valley Stream 13,282013,5408,4901434,1555,2484884,7386318,03/15/2016
2001,Hewlett-Woodmere,282014,4359,4143719,645,1047575,5191294,03/15/2016
2001,Lawrence,282015,5669,4053281,906,1241527,5294808,03/15/2016
2001,Elmont,282016,6599,5306216,1857,2614025,7920241,03/15/2016
2001,Franklin Square,282017,4464,3278703,1615,2105923,5384626,03/15/2016
2001,Garden City,282018,5289,2691041,740,706681,3397722,03/15/2016
2001,East Rockaway,282019,1757,1669739,523,873810,2543549,03/15/2016
2001,Lynbrook,282020,3419,3130130,799,1322153,4452283,03/15/2016
2001,Rockville Centre,282021,4362,3430003,641,945999,4376002,03/15/2016
2001,Floral Park-Bellerose,282022,3721,2831880,900,1224305,4056185,03/15/2016
2001,Wantagh,282023,4104,3776709,744,1248899,5025608,03/15/2016
2001,Valley Stream 24,282024,2159,1718039,657,922949,2640988,03/15/2016
2001,Merrick,282025,4409,3495547,588,807257,4302804,03/15/2016
2001,Island Trees,282026,2987,2642180,795,1266113,3908293,03/15/2016
2001,West Hempstead,282027,3224,2745396,744,1137998,3883394,03/15/2016
2001,North Merrick,282029,2971,2560289,717,1144533,3704822,03/15/2016
2001,Valley Stream 30,282030,2535,1817774,755,984524,2802298,03/15/2016
2001,Island Park,282031,1378,944043,315,362121,1306164,03/15/2016
2001,Westbury,282201,2601,2881865,657,1233171,4115036,03/15/2016
2001,East Williston,282202,1962,1638654,254,379865,2018519,03/15/2016
2001,Roslyn,282203,3708,2968399,368,547467,3515866,03/15/2016
2001,Port Washington,282204,5088,3289046,702,814201,4103247,03/15/2016
2001,New Hyde Park-Garden City,282205,4056,2638735,1418,1651902,4290637,03/15/2016
2001,Manhasset,282206,3424,1653261,339,326338,1979599,03/15/2016
2001,Great Neck,282207,8238,3816193,1046,886245,4702438,03/15/2016
2001,Herricks,282209,5492,4009729,1097,1582454,5592183,03/15/2016
2001,Mineola,282210,3860,2595501,1226,1534738,4130239,03/15/2016
2001,Carle Place,282211,1651,1235758,497,676260,1912018,03/15/2016
2001,North Shore,282401,3245,1824087,616,616546,2440633,03/15/2016
2001,Syosset,282402,7252,5429290,989,1357577,6786867,03/15/2016
2001,Locust Valley,282403,3036,1711820,457,496235,2208055,03/15/2016
2001,Plainview-Old Bethpage,282404,6359,5362926,1361,2167316,7530242,03/15/2016
2001,Oyster Bay-East Norwich,282406,2278,1234322,397,414581,1648903,03/15/2016
2001,Jericho,282415,3065,1893056,325,371833,2264889,03/15/2016
2001,Hicksville,282417,6759,4082716,2264,2522302,6605018,03/15/2016
2001,Plainedge,282418,4134,3968349,1206,2122477,6090826,03/15/2016
2001,Bethpage,282421,3646,2707883,1431,1473181,4181064,03/15/2016
2001,Farmingdale,282422,7515,7723625,2158,3934894,11658519,03/15/2016
2001,Massapequa,282423,10681,8013800,2410,3352142,11365942,03/15/2016
2001,Lockport,290900,5750,4345506,1771,1846508,6192014,03/15/2016
2001,Niagara Falls,291100,7050,3440971,4371,2867020,6307991,03/15/2016
2001,North Tonawanda,291200,5718,3820702,2513,2646669,6467371,03/15/2016
2001,Lewiston-Porter,292401,3753,2347827,1316,1347590,3695417,03/15/2016
2001,Newfane,292801,2164,1688109,726,897762,2585871,03/15/2016
2001,Niagara-Wheatfield,293001,4297,2208051,1550,1222410,3430461,03/15/2016
2001,Starpoint,293201,3254,1921671,851,805491,2727162,03/15/2016
2001,Royalton-Hartland,293601,1895,1237645,591,611658,1849303,03/15/2016
2001,Barker,293801,1002,546608,337,286580,833188,03/15/2016
2001,Wilson,294201,1636,1120699,567,616008,1736707,03/15/2016
2001,Rome,301300,5619,3708175,2624,2428738,6136913,03/15/2016
2001,Utica,301600,6633,3692137,4289,3274490,6966627,03/15/2016
2001,Adirondack,302601,1726,872456,628,424200,1296656,03/15/2016
2001,Camden,303001,2603,1284297,874,564041,1848338,03/15/2016
2001,Clinton,304001,1674,1101003,563,548235,1649238,03/15/2016
2001,New Hartford,304801,3469,2355347,1270,1395808,3751155,03/15/2016
2001,New York Mills,304804,756,513927,557,631171,1145098,03/15/2016
2001,Sauquoit Valley,305002,1279,704958,423,354846,1059804,03/15/2016
2001,Remsen,305201,680,398718,207,171887,570605,03/15/2016
2001,Waterville,305401,1080,610967,342,283320,894287,03/15/2016
2001,Holland Patent,305801,1951,1156465,568,503927,1660392,03/15/2016
2001,Sherrill,306000,2527,1373610,875,716739,2090349,03/15/2016
2001,Westmoreland,306801,1359,1106540,501,566828,1673368,03/15/2016
2001,Oriskany,307001,884,561264,340,327692,888956,03/15/2016
2001,Whitesboro,307002,4605,2916493,1907,1911269,4827762,03/15/2016
2001,Syracuse,311500,15047,5976170,6219,3787517,9763687,03/15/2016
2001,West Genesee,312001,6643,4142026,2654,2559091,6701117,03/15/2016
2001,North Syracuse,312403,12582,7652121,3424,3013717,10665838,03/15/2016
2001,East Syracuse-Minoa,312601,4511,2968624,1710,1636850,4605474,03/15/2016
2001,Jamesville-Dewitt,312611,3673,2197841,802,761405,2959246,03/15/2016
2001,Jordan-Elbridge,312801,1702,1218310,529,513937,1732247,03/15/2016
2001,Fabius-Pompey,313001,1047,614383,247,222897,837280,03/15/2016
2001,Westhill,313201,2353,1632057,1002,1115119,2747176,03/15/2016
2001,Solvay,313202,1707,1005664,1057,966552,1972216,03/15/2016
2001,La Fayette,313407,987,557446,251,215935,773381,03/15/2016
2001,Baldwinsville,313601,7176,4464613,1639,1494323,5958936,03/15/2016
2001,Fayetteville-Manlius,313801,5874,4243655,1023,1174686,5418341,03/15/2016
2001,Marcellus,314001,2473,1409187,659,594187,2003374,03/15/2016
2001,Onondaga,314201,1318,987769,438,481105,1468874,03/15/2016
2001,Liverpool,314801,10103,7283961,2842,3048005,10331966,03/15/2016
2001,Lyncourt,314804,740,459351,508,446262,905613,03/15/2016
2001,Skaneateles,315001,2076,1100521,568,479506,1580027,03/15/2016
2001,Tully,315402,1250,616202,262,202077,818279,03/15/2016
2001,Canandaigua,320200,3878,2087421,1005,856729,2944150,03/15/2016
2001,Geneva,320500,2454,1418078,1191,1008678,2426756,03/15/2016
2001,East Bloomfield,322601,1263,853473,286,301048,1154521,03/15/2016
2001,Gorham-Middlesex,323201,1936,1078810,609,508594,1587404,03/15/2016
2001,Manchester-Shortsville,323601,1098,907144,399,477157,1384301,03/15/2016
2001,Naples,323801,1244,610345,335,250959,861304,03/15/2016
2001,Phelps-Clifton Springs,324001,2172,1731902,612,741741,2473643,03/15/2016
2001,Honeoye,324201,1393,681515,357,275171,956686,03/15/2016
2001,Victor,324801,3579,2167120,612,574174,2741294,03/15/2016
2001,Middletown,330900,4471,3407732,1357,1529515,4937247,03/15/2016
2001,Newburgh,331100,8196,5485656,2611,2792203,8277859,03/15/2016
2001,Port Jervis,331300,2430,1775605,942,994553,2770158,03/15/2016
2001,Washingtonville,332002,4609,3357842,608,732415,4090257,03/15/2016
2001,Chester,332201,1141,790657,215,243201,1033858,03/15/2016
2001,Cornwall,332401,2946,2022613,568,622287,2644900,03/15/2016
2001,Pine Bush,332601,5084,3807303,943,1124309,4931612,03/15/2016
2001,Goshen,333001,2662,1518432,555,517256,2035688,03/15/2016
2001,Highland Falls,333601,696,369355,274,236876,606231,03/15/2016
2001,Minisink Valley,333801,3784,2492595,678,717090,3209685,03/15/2016
2001,Monroe-Woodbury,334001,7572,5399282,968,1241520,6640802,03/15/2016
2001,Kiryas Joel Village,334002,634,251948,41,27276,279224,03/15/2016
2001,Valley,334201,4468,2791511,1072,1076901,3868412,03/15/2016
2001,Tuxedo,335003,452,121595,87,44178,165773,03/15/2016
2001,Warwick Valley,335401,4548,3085954,792,886962,3972916,03/15/2016
2001,Greenwood Lake,335411,1304,895378,258,288376,1183754,03/15/2016
2001,Florida,335415,952,639249,259,284518,923767,03/15/2016
2001,Albion,342001,2180,1233330,853,766629,1999959,03/15/2016
2001,Kendall,343007,1181,742216,257,252542,994758,03/15/2016
2001,Holley,343204,1366,979367,405,422423,1401790,03/15/2016
2001,Medina,343401,1822,1083910,787,711334,1795244,03/15/2016
2001,Lyndonville,343801,842,395462,317,224685,620147,03/15/2016
2001,Fulton,350400,3407,2238778,1299,1178274,3417052,03/15/2016
2001,Oswego,351200,4795,2278674,1754,1450584,3729258,03/15/2016
2001,Altmar Parish-Williamstown,352002,1410,751757,372,286145,1037902,03/15/2016
2001,Hannibal,353001,1541,726482,395,267910,994392,03/15/2016
2001,Central Square,353201,4774,2702089,1253,915645,3617734,03/15/2016
2001,Mexico,353401,2520,1183179,592,414766,1597945,03/15/2016
2001,Pulaski,355001,1090,629135,327,279755,908890,03/15/2016
2001,Sandy Creek,355201,1059,544871,376,263831,808702,03/15/2016
2001,Phoenix,355401,2564,1800760,618,628724,2429484,03/15/2016
2001,Oneonta,361200,2345,1552757,890,924271,2477028,03/15/2016
2001,Gilbertsville-Mt Upton,362202,612,261997,223,137303,399300,03/15/2016
2001,Cherry Valley-Springfield,362401,769,312669,377,227645,540314,03/15/2016
2001,Edmeston,362801,527,221775,212,136104,357879,03/15/2016
2001,Laurens,363401,530,308846,170,150727,459573,03/15/2016
2001,Schenevus,363601,528,295459,184,144320,439779,03/15/2016
2001,Milford,364001,604,344086,244,211502,555588,03/15/2016
2001,Morris,364201,492,291068,208,187887,478955,03/15/2016
2001,Otego-Unadilla,364801,1277,751752,518,443787,1195539,03/15/2016
2001,Cooperstown,365001,1135,542533,458,341007,883540,03/15/2016
2001,Richfield Springs,365601,725,273362,381,225902,499264,03/15/2016
2001,Worcester,366606,443,250303,219,184367,434670,03/15/2016
2001,Mahopac,372001,5236,5080749,795,1279207,6359956,03/15/2016
2001,Carmel,372002,5644,5266874,854,1316767,6583641,03/15/2016
2001,Haldane,372601,897,706609,267,320995,1027604,03/15/2016
2001,Garrison,372604,477,250199,60,52478,302677,03/15/2016
2001,Putnam Valley,372803,2207,2653538,305,579236,3232774,03/15/2016
2001,Brewster,373001,4073,3537574,747,1105677,4643251,03/15/2016
2001,Rensselaer,381400,1047,828668,408,421128,1249796,03/15/2016
2001,Troy,381700,3959,2284912,1535,1215909,3500821,03/15/2016
2001,Lansingburgh,381701,2418,1640392,983,937579,2577971,03/15/2016
2001,Berlin,382001,1412,813001,395,336000,1149001,03/15/2016
2001,Brunswick,382202,1617,1049437,449,448086,1497523,03/15/2016
2001,East Greenbush,382401,5909,3803555,1544,1554741,5358296,03/15/2016
2001,Hoosick Falls,382801,1506,736435,564,385360,1121795,03/15/2016
2001,North Greenbush,383201,273,75744,115,51852,127596,03/15/2016
2001,Wynantskill,383204,774,442355,288,258841,701196,03/15/2016
2001,Averill Park,384001,3942,2393183,941,868560,3261743,03/15/2016
2001,Hoosic Valley,384201,1369,869458,370,343847,1213305,03/15/2016
2001,Schodack,384401,1326,921965,346,376350,1298315,03/15/2016
2001,Clarkstown,392001,11008,8357428,1639,2165901,10523329,03/15/2016
2001,Nanuet,392008,2197,1547833,629,754378,2302211,03/15/2016
2001,Haverstraw-Stony Point,392201,7331,7382993,1691,2611492,9994485,03/15/2016
2001,South Orangetown,392401,3839,3285069,985,1428078,4713147,03/15/2016
2001,Nyack,392404,3529,3734051,802,1518144,5252195,03/15/2016
2001,Pearl River,392408,2850,2781584,740,1225979,4007563,03/15/2016
2001,Ramapo,392601,5691,6930690,1053,2063406,8994096,03/15/2016
2001,East Ramapo,392602,11824,13020953,1709,2937893,15958846,03/15/2016
2001,Ogdensburg,401200,2033,1071802,766,473847,1545649,03/15/2016
2001,Brasher Falls,402001,1210,567607,397,257053,824660,03/15/2016
2001,Canton,402201,1589,865958,436,339346,1205304,03/15/2016
2001,Clifton-Fine,402601,475,171574,252,109870,281444,03/15/2016
2001,Colton-Pierrepont,402801,541,191433,204,105704,297137,03/15/2016
2001,Edwards-Knox,403401,684,151261,217,62125,213386,03/15/2016
2001,Gouverneur,404001,1690,695687,603,320310,1015997,03/15/2016
2001,Hammond,404201,326,100068,148,63370,163438,03/15/2016
2001,Hermon-Dekalb,404401,483,235172,171,115096,350268,03/15/2016
2001,Lisbon,405002,711,360375,245,173061,533436,03/15/2016
2001,Madrid-Waddington,405601,910,496024,309,233161,729185,03/15/2016
2001,Massena,405801,3116,1543726,1403,1042939,2586665,03/15/2016
2001,Morristown,406001,577,245078,209,129821,374899,03/15/2016
2001,Norwood-Norfolk,406201,1295,677569,455,301867,979436,03/15/2016
2001,Heuvelton,406404,760,403719,228,163359,567078,03/15/2016
2001,Parishville-Hopkinton,406601,632,226905,160,75074,301979,03/15/2016
2001,Potsdam,407402,1753,1141643,555,512823,1654466,03/15/2016
2001,Mechanicville,411000,1197,585625,591,470571,1056196,03/15/2016
2001,Saratoga Springs,411500,8143,4389054,1660,1383743,5772797,03/15/2016
2001,Burnt Hills-Ballston Lake,412001,4461,2860036,1096,1144022,4004058,03/15/2016
2001,Shenendehowa,412402,11377,7393700,1687,1773765,9167465,03/15/2016
2001,Corinth,412601,1231,610997,510,366832,977829,03/15/2016
2001,Edinburg,413001,293,69507,154,54013,123520,03/15/2016
2001,Galway,413201,1463,678873,322,225001,903874,03/15/2016
2001,Ballston Spa,414201,4682,3316594,982,990055,4306649,03/15/2016
2001,South Glens Falls,414401,3067,1775749,990,814946,2590695,03/15/2016
2001,Schuylerville,415001,1912,1475625,453,513138,1988763,03/15/2016
2001,Stillwater,415201,1421,743133,361,293568,1036701,03/15/2016
2001,Waterford-Halfmoon,415401,823,609562,492,525256,1134818,03/15/2016
2001,Schenectady,421500,6868,5096378,3507,3619646,8716024,03/15/2016
2001,Duanesburg,422001,1094,645190,215,196504,841694,03/15/2016
2001,Scotia-Glenville,422202,3816,2616505,1118,1219432,3835937,03/15/2016
2001,Niskayuna,422401,5563,3537167,960,999697,4536864,03/15/2016
2001,Schalmont,422801,3034,1822834,921,845036,2667870,03/15/2016
2001,Rotterdam-Mohonasen,422803,4127,2218076,2163,1741250,3959326,03/15/2016
2001,Cobleskill-Richmondville,432602,2208,968763,769,495938,1464701,03/15/2016
2001,Gilboa-Conesville,433401,488,203651,272,156507,360158,03/15/2016
2001,Jefferson,433601,382,154743,133,82062,236805,03/15/2016
2001,Middleburgh,433801,1138,595256,420,334414,929670,03/15/2016
2001,Schoharie,434201,1358,735184,427,347169,1082353,03/15/2016
2001,Sharon Springs,434601,401,229222,138,112902,342124,03/15/2016
2001,Odessa-Montour,442001,1085,464742,404,249643,714385,03/15/2016
2001,Watkins Glen,442401,1559,634503,691,433856,1068359,03/15/2016
2001,South Seneca,452801,1173,538451,496,326343,864794,03/15/2016
2001,Romulus,453003,614,301563,228,169542,471105,03/15/2016
2001,Seneca Falls,453201,1803,1122051,749,703395,1825446,03/15/2016
2001,Waterloo,453801,1974,1032277,756,583353,1615630,03/15/2016
2001,Corning,460300,6358,3946049,2267,1960619,5906668,03/15/2016
2001,Hornell,460600,1590,698864,784,437035,1135899,03/15/2016
2001,Addison,462001,1276,801457,428,343564,1145021,03/15/2016
2001,Avoca,462201,717,348943,230,154407,503350,03/15/2016
2001,Bath,462402,1704,746796,660,441367,1188163,03/15/2016
2001,Bradford,462601,388,188992,134,91449,280441,03/15/2016
2001,Campbell-Savona,463002,1089,325583,319,137885,463468,03/15/2016
2001,Canisteo,463201,1008,577734,370,272522,850256,03/15/2016
2001,Greenwood,464601,204,124022,143,55921,179943,03/15/2016
2001,Arkport,465201,555,370756,212,196537,567293,03/15/2016
2001,Jasper-Troupsburg,465601,509,199769,190,103543,303312,03/15/2016
2001,Prattsburgh,466001,550,208673,202,105207,313880,03/15/2016
2001,Hammondsport,467201,974,439574,394,257323,696897,03/15/2016
2001,Wayland-Cohocton,467401,1933,662749,612,299016,961765,03/15/2016
2001,Babylon,472001,2362,2472175,403,676835,3149010,03/15/2016
2001,West Babylon,472002,4729,4656781,1119,1781691,6438472,03/15/2016
2001,North Babylon,472003,5485,5311378,1503,2393465,7704843,03/15/2016
2001,Lindenhurst,472004,7147,6924503,1820,2858645,9783148,03/15/2016
2001,Copiague,472005,4128,4105600,1169,1824354,5929954,03/15/2016
2001,Amityville,472006,3221,3334846,771,1268575,4603421,03/15/2016
2001,Deer Park,472007,4456,4535973,1505,2512763,7048736,03/15/2016
2001,Wyandanch,472009,784,731031,174,250171,981202,03/15/2016
2001,Three Village,472201,7872,6589183,1235,1690641,8279824,03/15/2016
2001,Brookhaven-Comsewogue,472203,3761,3054057,726,981927,4035984,03/15/2016
2001,South Country,472204,4021,3434788,742,1001938,4436726,03/15/2016
2001,Sachem,472205,15332,13289317,2211,3175186,16464503,03/15/2016
2001,Port Jefferson,472206,1426,833678,222,212561,1046239,03/15/2016
2001,Mount Sinai,472207,2203,2222257,331,562487,2784744,03/15/2016
2001,Miller Place,472208,2885,2935947,355,594602,3530549,03/15/2016
2001,Rocky Point,472209,3006,2856172,532,808668,3664840,03/15/2016
2001,Middle Country,472211,9848,7148265,2007,2427165,9575430,03/15/2016
2001,Longwood,472212,9547,8694352,2924,4050230,12744582,03/15/2016
2001,South Manor,472221,1577,1437213,204,302828,1740041,03/15/2016
2001,Patchogue-Medford,472224,7756,5490839,1655,1892369,7383208,03/15/2016
2001,William Floyd,472232,6909,6153300,1337,1779397,7932697,03/15/2016
2001,Center Moriches,472233,1253,1102581,262,361200,1463781,03/15/2016
2001,East Moriches,472234,1009,893394,182,260326,1153720,03/15/2016
2001,East Hampton,472401,1338,230128,353,110446,340574,03/15/2016
2001,Wainscott,472402,131,10175,24,3839,14014,03/15/2016
2001,Amagansett,472403,265,31241,93,21830,53071,03/15/2016
2001,Springs,472404,934,256997,265,148344,405341,03/15/2016
2001,Sag Harbor,472405,1127,349599,569,326348,675947,03/15/2016
2001,Montauk,472406,702,112545,230,93355,205900,03/15/2016
2001,Elwood,472601,2922,2240923,632,864526,3105449,03/15/2016
2001,Cold Spring Harbor,472602,2006,1233899,157,171084,1404983,03/15/2016
2001,Huntington,472603,6768,5289466,1439,1969602,7259068,03/15/2016
2001,Northport-East Northport,472604,8324,4900830,1658,1733798,6634628,03/15/2016
2001,Half Hollow Hills,472605,9345,5956893,1359,1395380,7352273,03/15/2016
2001,Harborfields,472606,4353,3395490,779,1078398,4473888,03/15/2016
2001,Commack,472610,8675,6732550,1850,2519049,9251599,03/15/2016
2001,South Huntington,472613,7823,6461919,1985,2898316,9360235,03/15/2016
2001,Bay Shore,472801,4734,4598975,1118,1821516,6420491,03/15/2016
2001,Islip,472802,3477,2794201,687,931864,3726065,03/15/2016
2001,East Islip,472803,5121,4628640,1038,1706200,6334840,03/15/2016
2001,Sayville,472804,3673,3625349,809,1339440,4964789,03/15/2016
2001,Bayport-Blue Point,472805,2696,2697783,487,805239,3503022,03/15/2016
2001,Hauppauge,472806,4597,2192836,893,726447,2919283,03/15/2016
2001,Connetquot,472807,7688,6850764,1421,2070431,8921195,03/15/2016
2001,West Islip,472809,5843,5136705,1340,1996616,7133321,03/15/2016
2001,Brentwood,472812,7612,6381645,2272,3202970,9584615,03/15/2016
2001,Central Islip,472813,4458,5238305,858,1642990,6881295,03/15/2016
2001,Fire Island,472814,93,8681,18,2854,11535,03/15/2016
2001,Shoreham-Wading River,473001,2671,2419411,709,953335,3372746,03/15/2016
2001,Riverhead,473002,5323,4222885,2511,2591272,6814157,03/15/2016
2001,Shelter Island,473201,507,106546,262,92200,198746,03/15/2016
2001,Smithtown,473401,12320,10058619,2363,3190963,13249582,03/15/2016
2001,Kings Park,473405,4866,3497412,894,1102667,4600079,03/15/2016
2001,Remsenburg-Speonk,473601,364,94149,87,40951,135100,03/15/2016
2001,Westhampton Beach,473602,784,243975,251,137910,381885,03/15/2016
2001,Quogue,473603,209,23571,53,10877,34448,03/15/2016
2001,Hampton Bays,473605,1740,803339,812,671348,1474687,03/15/2016
2001,Southhampton,473606,1602,327192,631,234404,561596,03/15/2016
2001,Bridgehampton,473609,279,52331,110,37547,89878,03/15/2016
2001,Sagaponack,473610,86,3601,9,686,4287,03/15/2016
2001,Eastport,473611,1517,1635957,526,792325,2428282,03/15/2016
2001,Tuckahoe Common,473613,425,146808,176,110638,257446,03/15/2016
2001,East Quogue,473617,864,462318,280,247940,710258,03/15/2016
2001,Oysterponds,473802,311,82555,214,94371,176926,03/15/2016
2001,Fishers Island,473804,40,10014,12,4874,14888,03/15/2016
2001,Southold,473805,1297,659068,636,532624,1191692,03/15/2016
2001,Greenport,473810,528,303118,352,327011,630129,03/15/2016
2001,Mattituck-Cutchogue,473812,1950,1072574,761,689949,1762523,03/15/2016
2001,New Suffolk,473815,64,16881,43,18588,35469,03/15/2016
2001,Fallsburg,482801,989,822345,391,480843,1303188,03/15/2016
2001,Eldred,483401,815,406838,383,296548,703386,03/15/2016
2001,Liberty,483601,1285,974998,541,627363,1602361,03/15/2016
2001,Tri-Valley,484201,1111,620573,312,242601,863174,03/15/2016
2001,Roscoe,484401,317,131571,190,119373,250944,03/15/2016
2001,Livingston Manor,484402,572,252195,249,164771,416966,03/15/2016
2001,Monticello,484601,2718,1605839,1117,1017560,2623399,03/15/2016
2001,Sullivan West,484802,1904,868811,919,647726,1516537,03/15/2016
2001,Waverly,492001,1532,581605,658,343719,925324,03/15/2016
2001,Candor,492401,943,490145,331,250217,740362,03/15/2016
2001,Newark Valley,492602,1505,938596,473,436089,1374685,03/15/2016
2001,Owego-Apalachin,493001,2722,1810559,976,916279,2726838,03/15/2016
2001,Spencer-Van Etten,493401,1159,460892,362,207245,668137,03/15/2016
2001,Tioga,493603,1087,415929,350,194272,610201,03/15/2016
2001,Ithaca,500700,8014,4854384,1615,1405514,6259898,03/15/2016
2001,Dryden,502401,2353,1587177,466,429929,2017106,03/15/2016
2001,Groton,502801,1268,667153,292,212175,879328,03/15/2016
2001,Lansing,503201,1530,889278,328,284889,1174167,03/15/2016
2001,Newfield,503401,987,584144,242,171859,756003,03/15/2016
2001,Trumansburg,503601,1566,929021,399,339416,1268437,03/15/2016
2001,Kingston,510800,7621,4447789,3064,2787553,7235342,03/15/2016
2001,Highland,513203,1921,1447114,560,663739,2110853,03/15/2016
2001,Rondout Valley,513401,3196,2576277,991,1160035,3736312,03/15/2016
2001,Marlboro,513601,1910,945906,534,434339,1380245,03/15/2016
2001,New Paltz,513801,2879,2005726,633,720042,2725768,03/15/2016
2001,Onteora,514001,3049,1530033,1133,867276,2397309,03/15/2016
2001,Saugerties,514801,3824,2291718,1242,1155921,3447639,03/15/2016
2001,Wallkill,515201,3227,2317946,858,851564,3169510,03/15/2016
2001,Ellenville,515602,1433,1120438,611,571563,1692001,03/15/2016
2001,Glens Falls,520500,2415,1276060,872,712858,1988918,03/15/2016
2001,Bolton,522001,379,89831,137,52017,141848,03/15/2016
2001,Lake George,522201,1325,368403,432,194150,562553,03/15/2016
2001,North Warren,522402,894,307732,413,221211,528943,03/15/2016
2001,Johnsburg,523001,505,280726,233,190565,471291,03/15/2016
2001,Hadley-Luzerne,523201,1103,476038,497,323851,799889,03/15/2016
2001,Queensbury,523402,3720,1815540,961,719520,2535060,03/15/2016
2001,Glens Falls Common,523418,206,75631,114,63030,138661,03/15/2016
2001,Warrensburg,524001,1095,761291,388,397953,1159244,03/15/2016
2001,Argyle,532001,811,389437,255,176498,565935,03/15/2016
2001,Fort Ann,532802,687,364616,182,150745,515361,03/15/2016
2001,Fort Edward,533001,454,277726,230,222720,500446,03/15/2016
2001,Granville,533201,1288,703291,483,381616,1084907,03/15/2016
2001,Greenwich,533401,1249,768270,463,442756,1211026,03/15/2016
2001,Hartford,533801,646,325483,158,115971,441454,03/15/2016
2001,Hudson Falls,534401,2267,1272492,976,808085,2080577,03/15/2016
2001,Putnam,534601,142,36368,45,18202,54570,03/15/2016
2001,Salem,534801,751,382702,284,220805,603507,03/15/2016
2001,Cambridge,535010,1173,654614,470,393843,1048457,03/15/2016
2001,Whitehall,535201,802,391093,429,283962,675055,03/15/2016
2001,Newark,542001,2603,1649787,935,906675,2556462,03/15/2016
2001,Clyde-Savannah,542401,1023,635687,442,393043,1028730,03/15/2016
2001,Lyons,542801,1100,616954,455,344311,961265,03/15/2016
2001,Gananda,543002,1198,842556,80,90713,933269,03/15/2016
2001,Marion,543201,1260,871720,266,285142,1156862,03/15/2016
2001,Wayne,543401,3251,1788833,577,505938,2294771,03/15/2016
2001,Palmyra-Macedon,543601,2419,1797969,603,667655,2465624,03/15/2016
2001,Sodus,544201,1504,1062501,558,550439,1612940,03/15/2016
2001,Williamson,544602,1436,919745,384,390010,1309755,03/15/2016
2001,North Rose-Wolcott,544801,1814,913982,672,476497,1390479,03/15/2016
2001,Red Creek,544803,1092,398651,361,188755,587406,03/15/2016
2001,Mount Vernon,550800,4438,8247206,1494,4222153,12469359,03/15/2016
2001,New Rochelle,551000,7562,12344586,1541,4315173,16659759,03/15/2016
2001,Peekskill,551200,2517,4123087,605,1340845,5463932,03/15/2016
2001,Rye,551400,2788,2772083,387,667963,3440046,03/15/2016
2001,White Plains,551700,5740,9979075,1173,2956638,12935713,03/15/2016
2001,Yonkers,551800,14339,19333266,5417,10648369,29981635,03/15/2016
2001,Katonah-Lewisboro,552001,4416,6518416,466,1175331,7693747,03/15/2016
2001,Bedford,552002,4466,4590656,675,1126303,5716959,03/15/2016
2001,Croton-Harmon,552202,1885,3256992,316,811383,4068375,03/15/2016
2001,Hendrick Hudson,552203,3036,4187052,553,1021106,5208158,03/15/2016
2001,Eastchester,552401,2759,4613333,782,1925792,6539125,03/15/2016
2001,Tuckahoe,552402,1104,1696435,256,608341,2304776,03/15/2016
2001,Bronxville,552403,1128,1864816,62,299022,2163838,03/15/2016
2001,Tarrytowns,552601,2045,3301509,473,1266339,4567848,03/15/2016
2001,Irvington,552602,1649,2484948,237,650678,3135626,03/15/2016
2001,Dobbs Ferry,552603,1263,2651859,222,802185,3454044,03/15/2016
2001,Hastings On Hudson,552604,1448,3019350,306,1044175,4063525,03/15/2016
2001,Ardsley,552605,2284,3405477,393,1016374,4421851,03/15/2016
2001,Edgemont,552606,1503,2629169,136,405509,3034678,03/15/2016
2001,Greenburgh,552607,3625,4942708,900,1915916,6858624,03/15/2016
2001,Elmsford,552609,1149,1441450,350,740163,2181613,03/15/2016
2001,Harrison,552801,3022,2623743,634,1060065,3683808,03/15/2016
2001,Mamaroneck,553201,4236,5100437,626,1355589,6456026,03/15/2016
2001,Mount Pleasant,553401,2579,3047089,666,1363232,4410321,03/15/2016
2001,Pocantico Hills,553402,421,242891,89,80845,323736,03/15/2016
2001,Valhalla,553405,1555,2218097,403,1053062,3271159,03/15/2016
2001,Pleasantville,553409,1778,2783644,324,827783,3611427,03/15/2016
2001,Chappaqua,553604,4125,5859785,215,538740,6398525,03/15/2016
2001,Byram Hills,553801,2618,2530117,207,393514,2923631,03/15/2016
2001,North Salem,554001,1723,2249943,214,411552,2661495,03/15/2016
2001,Ossining,554201,5037,8520440,861,2288737,10809177,03/15/2016
2001,Briarcliff Manor,554202,1548,2825276,122,385499,3210775,03/15/2016
2001,Pelham,554401,2190,3047095,375,823558,3870653,03/15/2016
2001,Rye Neck,554801,1385,1926379,355,799781,2726160,03/15/2016
2001,Port Chester-Rye,554804,2439,3373627,1149,2508839,5882466,03/15/2016
2001,Blind Brook-Rye,554805,1439,1880983,197,437131,2318114,03/15/2016
2001,Scarsdale,555001,4364,5187088,222,469602,5656690,03/15/2016
2001,Somers,555201,3966,4895298,953,1855003,6750301,03/15/2016
2001,Lakeland,555401,7570,12601462,1599,3520213,16121675,03/15/2016
2001,Yorktown,555402,4779,7722211,601,1581458,9303669,03/15/2016
2001,Attica,562201,2171,961316,622,442314,1403630,03/15/2016
2001,Letchworth,562601,1353,640905,394,271554,912459,03/15/2016
2001,Wyoming,563802,440,199559,93,68275,267834,03/15/2016
2001,Perry,564201,1215,610633,453,353292,963925,03/15/2016
2001,Warsaw,564801,1323,776170,406,376356,1152526,03/15/2016
2001,Penn Yan,573001,2579,1062539,1122,703933,1766472,03/15/2016
2001,Dundee,573401,1031,417245,436,255974,673219,03/15/2016
2001,New York City School,650000,414252,80177184,99804,32250765,112427949,03/15/2016
2000,Albany,010100,8631,3369066,4074,3600147,6969213,03/15/2016
2000,Cohoes,010300,1736,770437,895,884506,1654943,03/15/2016
2000,Watervliet,011800,1158,363236,620,454201,817437,03/15/2016
2000,Berne-Knox-Westerlo,012001,1407,512373,366,309570,821943,03/15/2016
2000,Bethlehem,012206,5855,2564770,1224,1305265,3870035,03/15/2016
2000,Ravena-Coeymans-Selkirk,012402,2409,875635,742,610335,1485970,03/15/2016
2000,South Colonie,012601,7581,2255519,2989,2095599,4351118,03/15/2016
2000,North Colonie,012605,6288,1769838,1824,1256747,3026585,03/15/2016
2000,Menands,012615,329,80801,114,65740,146541,03/15/2016
2000,Maplewood,012622,69,18258,70,43111,61369,03/15/2016
2000,Green Island,012801,233,103955,152,161513,265468,03/15/2016
2000,Guilderland,013002,6447,2572276,1576,1531778,4104054,03/15/2016
2000,Voorheesville,013403,1783,702134,378,365063,1067197,03/15/2016
2000,Alfred-Almond,022001,769,313357,261,223426,536783,03/15/2016
2000,Andover,023001,386,157200,164,131001,288201,03/15/2016
2000,Genesee Valley,023202,647,150211,361,158498,308709,03/15/2016
2000,Belfast,023401,360,99254,182,94134,193388,03/15/2016
2000,Canaseraga,024002,345,121694,145,99637,221331,03/15/2016
2000,Cuba-Rushford,024801,1098,236578,514,230912,467490,03/15/2016
2000,Friendship,025001,284,91389,166,92275,183664,03/15/2016
2000,Fillmore,025801,647,176425,273,151035,327460,03/15/2016
2000,Whitesville,026001,225,86864,90,60699,147563,03/15/2016
2000,Scio,026601,433,177983,182,137553,315536,03/15/2016
2000,Wellsville,027001,1509,506698,826,538987,1045685,03/15/2016
2000,Bolivar-Richburg,027602,852,170924,358,123553,294477,03/15/2016
2000,Binghamton,030200,4965,2051547,3008,2461355,4512902,03/15/2016
2000,Chenango Forks,032001,2064,974862,554,574866,1549728,03/15/2016
2000,South Mountain-Hickory,032201,112,11978,30,8020,19998,03/15/2016
2000,Harpursville,032601,974,308912,281,191725,500637,03/15/2016
2000,Susquehanna Valley,032801,2248,1052360,819,885128,1937488,03/15/2016
2000,Chenango Valley,033001,2401,1126536,1245,1336883,2463419,03/15/2016
2000,Maine-Endwell,033801,3137,1667718,1415,1629384,3297102,03/15/2016
2000,Deposit,034201,622,188159,324,212908,401067,03/15/2016
2000,Whitney Point,034401,1531,438560,467,288051,726611,03/15/2016
2000,Union-Endicott,034601,5025,2619524,2457,2772203,5391727,03/15/2016
2000,Johnson City,034602,2711,1291666,1794,1649717,2941383,03/15/2016
2000,Vestal,034801,5343,2316805,1751,1737275,4054080,03/15/2016
2000,Windsor,035001,1894,686304,693,551436,1237740,03/15/2016
2000,Olean,041200,2495,776735,1373,803384,1580119,03/15/2016
2000,Salamanca,041600,1033,251789,575,229089,480878,03/15/2016
2000,Allegany-Limestone,042001,1372,315636,522,257196,572832,03/15/2016
2000,West Valley,042204,455,131436,152,97492,228928,03/15/2016
2000,Ellicottville,043601,601,141534,257,133673,275207,03/15/2016
2000,Franklinville,044001,761,225738,331,192723,418461,03/15/2016
2000,Hinsdale,044601,526,142937,199,110416,253353,03/15/2016
2000,Cattaraugus - Little Valley,046402,1253,437443,507,355379,792822,03/15/2016
2000,Gowanda,047201,1331,360595,663,393483,754078,03/15/2016
2000,Portville,047401,968,269597,367,218704,488301,03/15/2016
2000,Randolph,047601,1093,321808,419,248808,570616,03/15/2016
2000,Yorkshire-Pioneer,048401,2669,694947,901,512450,1207397,03/15/2016
2000,Auburn,050100,4658,1616540,2460,1927798,3544338,03/15/2016
2000,Weedsport,052201,1019,356484,343,284073,640557,03/15/2016
2000,Cato-Meridian,052401,1206,348497,284,185557,534054,03/15/2016
2000,Southern Cayuga,053001,1098,314441,416,270713,585154,03/15/2016
2000,Port Byron,053801,1317,458854,437,314961,773815,03/15/2016
2000,Moravia,054201,1221,328202,328,187011,515213,03/15/2016
2000,Union Springs,055401,1129,491639,408,400059,891698,03/15/2016
2000,Dunkirk,060300,2085,818064,1429,1105953,1924017,03/15/2016
2000,Jamestown,060800,4477,1511849,2061,1331365,2843214,03/15/2016
2000,Southwestern,062201,2196,849359,821,713339,1562698,03/15/2016
2000,Frewsburg,062401,988,415765,344,325834,741599,03/15/2016
2000,Cassadaga Valley,062601,1289,440566,498,352468,793034,03/15/2016
2000,Chautauqua Lake,062803,1101,237284,454,225184,462468,03/15/2016
2000,Pine Valley,063001,693,268781,261,207283,476064,03/15/2016
2000,Clymer,063201,543,151196,242,155220,306416,03/15/2016
2000,Bemus Point,063601,1026,319846,433,322255,642101,03/15/2016
2000,Falconer,063801,1436,506456,564,444031,950487,03/15/2016
2000,Silver Creek,064601,1123,363754,541,383505,747259,03/15/2016
2000,Forestville,064603,731,216164,305,205326,421490,03/15/2016
2000,Panama,064801,745,278805,254,203618,482423,03/15/2016
2000,Fredonia,065801,1809,618369,776,628612,1246981,03/15/2016
2000,Brocton,066001,696,270894,270,218015,488909,03/15/2016
2000,Ripley,066201,354,173055,190,168468,341523,03/15/2016
2000,Sherman,066601,476,157039,151,103700,260739,03/15/2016
2000,Westfield,067201,890,373920,346,317808,691728,03/15/2016
2000,Elmira,070400,6851,2538925,3512,2768441,5307366,03/15/2016
2000,Horseheads,073401,4896,1618250,1903,1478460,3096710,03/15/2016
2000,Elmira Heights,073402,1101,367685,638,462547,830232,03/15/2016
2000,Norwich,081100,2009,885638,854,736020,1621658,03/15/2016
2000,Afton,082001,772,322224,308,268821,591045,03/15/2016
2000,Bainbridge-Guilford,082201,1019,369971,399,294330,664301,03/15/2016
2000,Greene,083001,1389,532098,431,367257,899355,03/15/2016
2000,Unadilla Valley,083803,1012,305389,382,222284,527673,03/15/2016
2000,Georgetown-So Otselic Valley,084401,476,170393,140,96018,266411,03/15/2016
2000,Oxford Academy,084601,967,392404,383,300582,692986,03/15/2016
2000,Sherburne-Earlville,085601,1533,606733,576,465644,1072377,03/15/2016
2000,Plattsburgh,091300,1721,708059,750,706391,1414450,03/15/2016
2000,Ausable Valley,092201,1677,443478,699,358465,801943,03/15/2016
2000,Beekmantown,092401,2333,711132,674,415990,1127122,03/15/2016
2000,Northeastern Clinton,092801,1733,649992,586,434746,1084738,03/15/2016
2000,Chazy,093001,607,221309,198,153375,374684,03/15/2016
2000,Northern Adirondack,093601,1229,298039,414,180269,478308,03/15/2016
2000,Peru,094001,2274,756352,562,401019,1157371,03/15/2016
2000,Saranac,094401,2054,720466,640,470820,1191286,03/15/2016
2000,Hudson,100600,1778,656223,1097,924680,1580903,03/15/2016
2000,Taconic Hills,102801,1849,626774,832,657726,1284500,03/15/2016
2000,Germantown,103602,759,249717,325,249543,499260,03/15/2016
2000,Chatham,103801,1707,505814,561,407392,913206,03/15/2016
2000,Kinderhook,104401,2695,899440,745,573033,1472473,03/15/2016
2000,New Lebanon,104801,809,256998,254,186142,443140,03/15/2016
2000,Cortland,110200,2634,859653,1147,883248,1742901,03/15/2016
2000,Cincinnatus,112001,644,182527,220,117762,300289,03/15/2016
2000,Mc Graw,112204,629,193107,225,148406,341513,03/15/2016
2000,Homer,113001,2517,842918,748,571658,1414576,03/15/2016
2000,Marathon,113401,803,294552,275,207243,501795,03/15/2016
2000,Andes,122002,213,57514,153,97731,155245,03/15/2016
2000,Downsville,122401,323,70088,193,80220,150308,03/15/2016
2000,Charlotte Valley,122601,502,133624,214,128841,262465,03/15/2016
2000,Delhi,122801,1063,239697,551,296117,535814,03/15/2016
2000,Franklin,123201,397,127539,178,133719,261258,03/15/2016
2000,Hancock,123606,413,155586,236,177991,333577,03/15/2016
2000,Margaretville,124601,615,106522,346,139936,246458,03/15/2016
2000,Roxbury,124802,484,171734,266,210076,381810,03/15/2016
2000,Sidney,125001,1256,539452,697,628625,1168077,03/15/2016
2000,Stamford,125201,468,195555,198,181296,376851,03/15/2016
2000,South Kortright,125202,432,141452,217,164256,305708,03/15/2016
2000,Walton,125601,1066,263832,534,297962,561794,03/15/2016
2000,Beacon,130200,2500,990898,943,880599,1871497,03/15/2016
2000,Poughkeepsie,131300,2423,1052761,1054,1045510,2098271,03/15/2016
2000,Dover,132602,1268,621003,326,409875,1030878,03/15/2016
2000,Hyde Park,133201,4875,2326188,1506,1631602,3957790,03/15/2016
2000,Northeast,133801,840,307913,319,272738,580651,03/15/2016
2000,Pawling,134001,1379,566129,372,381140,947269,03/15/2016
2000,Pine Plains,134201,1504,501385,536,419229,920614,03/15/2016
2000,Arlington,134601,9369,4054023,1844,1958166,6012189,03/15/2016
2000,Spackenkill,134602,1671,673307,452,453939,1127246,03/15/2016
2000,Red Hook,134801,1922,891749,604,683370,1575119,03/15/2016
2000,Rhinebeck,135001,1611,549568,509,455353,1004921,03/15/2016
2000,Wappingers,135601,12943,4579622,2977,2667902,7247524,03/15/2016
2000,Millbrook,135801,1272,413833,305,256543,670376,03/15/2016
2000,Buffalo,140200,26048,6901822,12166,6344310,13246132,03/15/2016
2000,Lackawanna,140900,1860,297958,1643,543771,841729,03/15/2016
2000,Tonawanda,141600,2800,918895,1472,1118195,2037090,03/15/2016
2000,Alden,142001,2394,865904,795,679787,1545691,03/15/2016
2000,Amherst,142201,5121,2192174,1667,1678478,3870652,03/15/2016
2000,Williamsville,142203,14491,5359965,3408,3003288,8363253,03/15/2016
2000,Sweet Home,142207,4810,1178522,2109,1261554,2440076,03/15/2016
2000,East Aurora,142401,2551,838795,842,669600,1508395,03/15/2016
2000,Cheektowaga,143001,3219,958576,2114,1360086,2318662,03/15/2016
2000,Cheektowaga-Maryvale,143002,3200,1084963,2360,1889849,2974812,03/15/2016
2000,Cleveland Hill,143003,2017,850995,1302,1293355,2144350,03/15/2016
2000,Depew,143007,3141,1256136,1267,1209621,2465757,03/15/2016
2000,Cheektowaga-Sloan,143009,1894,814145,1786,1832220,2646365,03/15/2016
2000,Clarence,143201,5165,1584144,1326,856504,2440648,03/15/2016
2000,Springville-Griffith,143801,2604,792888,898,632118,1425006,03/15/2016
2000,Eden,144001,2089,571980,661,455387,1027367,03/15/2016
2000,Iroquois,144201,3631,1017377,1191,792859,1810236,03/15/2016
2000,Evans-Brant,144401,3658,1290205,1119,883794,2173999,03/15/2016
2000,Grand Island,144601,4329,1538480,948,800915,2339395,03/15/2016
2000,Hamburg,144801,4733,1674386,1534,1314428,2988814,03/15/2016
2000,Frontier,144804,6382,2003934,2238,1571866,3575800,03/15/2016
2000,Holland,145001,1464,400545,373,248896,649441,03/15/2016
2000,Lancaster,145201,7801,2556017,2674,2012113,4568130,03/15/2016
2000,Akron,145601,1801,535939,609,377243,913182,03/15/2016
2000,North Collins,145801,783,354502,305,327486,681988,03/15/2016
2000,Orchard Park,146001,6429,2241548,1640,1384065,3625613,03/15/2016
2000,Kenmore,146401,13358,4151412,6960,5239007,9390419,03/15/2016
2000,West Seneca,146801,10724,3383705,4864,3518530,6902235,03/15/2016
2000,Crown Point,152203,359,92501,186,99493,191994,03/15/2016
2000,Elizabethtown-Lewis,152401,469,135087,179,108118,243205,03/15/2016
2000,Keene,153001,219,52207,97,55699,107906,03/15/2016
2000,Minerva,153401,185,58069,87,62306,120375,03/15/2016
2000,Moriah,153601,822,212436,501,252073,464509,03/15/2016
2000,Newcomb,153801,121,5675,79,7778,13453,03/15/2016
2000,Lake Placid,154002,1010,224562,351,174356,398918,03/15/2016
2000,Schroon Lake,154601,373,64937,201,80634,145571,03/15/2016
2000,Ticonderoga,154801,1040,202243,477,203809,406052,03/15/2016
2000,Westport,155001,287,107134,145,122489,229623,03/15/2016
2000,Willsboro,155201,451,119643,291,162350,281993,03/15/2016
2000,Tupper Lake,162001,1160,293780,534,250009,543789,03/15/2016
2000,Chateaugay,163401,581,181613,246,147204,328817,03/15/2016
2000,Salmon River,164201,682,194577,286,164193,358770,03/15/2016
2000,Saranac Lake,164601,1924,488193,659,357779,845972,03/15/2016
2000,Malone,164801,2659,848033,1100,694600,1542633,03/15/2016
2000,Brushton-Moira,165001,792,229395,297,168969,398364,03/15/2016
2000,St. Regis Falls,165401,392,101847,178,86209,188056,03/15/2016
2000,Gloversville,170500,2666,998556,1446,1013001,2011557,03/15/2016
2000,Johnstown,170800,1919,716904,836,635732,1352636,03/15/2016
2000,Broadalbin-Perth,172201,2035,474329,727,380938,855267,03/15/2016
2000,Wheelerville,172401,331,95318,133,84047,179365,03/15/2016
2000,Mayfield,173001,1221,398589,462,317298,715887,03/15/2016
2000,Northville,173201,526,137513,284,161341,298854,03/15/2016
2000,Oppenheim-Ephratah,173401,543,171521,186,105046,276567,03/15/2016
2000,Batavia,180200,2679,1028411,1214,1085682,2114093,03/15/2016
2000,Alexander,182202,1068,504337,305,328959,833296,03/15/2016
2000,Byron-Bergen,183001,1503,696139,412,399186,1095325,03/15/2016
2000,Elba,183401,559,223034,183,170670,393704,03/15/2016
2000,Le Roy,183601,1593,638466,535,488725,1127191,03/15/2016
2000,Oakfield-Alabama,183801,1024,479706,405,428802,908508,03/15/2016
2000,Pavilion,184001,1094,446039,264,239925,685964,03/15/2016
2000,Pembroke,184202,1335,501719,444,373282,875001,03/15/2016
2000,Cairo-Durham,192401,1518,495688,729,542606,1038294,03/15/2016
2000,Catskill,192601,1899,658866,860,685516,1344382,03/15/2016
2000,Coxsackie-Athens,192801,1703,488130,609,396162,884292,03/15/2016
2000,Greenville,193201,1583,564574,605,515392,1079966,03/15/2016
2000,Hunter-Tannersville,193601,592,171480,299,198630,370110,03/15/2016
2000,Windham-Ashland-Jewett,194601,555,120834,260,130764,251598,03/15/2016
2000,Piseco,202001,79,6861,42,8464,15325,03/15/2016
2000,Indian Lake,202601,288,53020,183,79575,132595,03/15/2016
2000,Inlet,202801,91,6897,38,7146,14043,03/15/2016
2000,Lake Pleasant,203001,167,28382,109,45209,73591,03/15/2016
2000,Long Lake,203201,151,23673,112,40773,64446,03/15/2016
2000,Raquette Lake,203202,24,955,17,1544,2499,03/15/2016
2000,Wells,203601,195,41076,119,56576,97652,03/15/2016
2000,Little Falls,210900,1087,437941,689,552883,990824,03/15/2016
2000,West Canada Valley,212402,879,275626,297,203142,478768,03/15/2016
2000,Frankfort-Schuyler,212602,1215,445044,610,502488,947532,03/15/2016
2000,Ilion,212801,1460,379666,649,369470,749136,03/15/2016
2000,Mohawk,212802,1002,318173,455,321208,639381,03/15/2016
2000,Herkimer,213001,1328,469295,880,602439,1071734,03/15/2016
2000,Dolgeville,213602,901,237023,445,230852,467875,03/15/2016
2000,Poland,213803,811,226530,277,170843,397373,03/15/2016
2000,Van Hornesville-Owen D. Young,215001,285,111493,111,95860,207353,03/15/2016
2000,Town Of Webb,215401,527,67464,290,87054,154518,03/15/2016
2000,Mount Markham,215601,1327,485259,445,345708,830967,03/15/2016
2000,Watertown,221800,3334,849950,1470,798259,1648209,03/15/2016
2000,South Jefferson,222001,1798,454449,551,292337,746786,03/15/2016
2000,Alexandria,222202,685,169698,290,155541,325239,03/15/2016
2000,Indian River,222401,1346,182084,418,104397,286481,03/15/2016
2000,General Brown,222601,1535,368144,508,263360,631504,03/15/2016
2000,Thousand Islands,223201,1241,358495,580,372332,730827,03/15/2016
2000,Belleville-Henderson,223402,577,114695,282,119168,233863,03/15/2016
2000,Sackets Harbor,223801,502,158583,169,116478,275061,03/15/2016
2000,Lyme,224401,424,104933,239,135832,240765,03/15/2016
2000,La Fargeville,224601,454,123253,159,90218,213471,03/15/2016
2000,Carthage,226001,2041,730821,808,593414,1324235,03/15/2016
2000,Copenhagen,232201,481,127151,136,75867,203018,03/15/2016
2000,Harrisville,232401,510,179431,179,107206,286637,03/15/2016
2000,Lowville,233601,1406,347756,565,283888,631644,03/15/2016
2000,South Lewis,234001,1351,362387,597,301450,663837,03/15/2016
2000,Beaver River,234401,1083,228735,342,146394,375129,03/15/2016
2000,Avon,242001,1057,536492,317,345442,881934,03/15/2016
2000,Caledonia-Mumford,242201,1238,417608,351,281068,698676,03/15/2016
2000,Geneseo,242601,1218,419344,316,262718,682062,03/15/2016
2000,Livonia,243401,2335,790965,585,442607,1233572,03/15/2016
2000,Mount Morris,243601,535,221570,283,248257,469827,03/15/2016
2000,Dansville,243801,1792,573004,692,477524,1050528,03/15/2016
2000,Dalton-Nunda,244001,1003,302186,329,203841,506027,03/15/2016
2000,York,245201,1057,355273,298,230458,585731,03/15/2016
2000,Oneida,251200,2476,752998,968,661560,1414558,03/15/2016
2000,Brookfield,252009,251,79902,86,55725,135627,03/15/2016
2000,Cazenovia,252201,2013,751682,493,428692,1180374,03/15/2016
2000,De Ruyter,252401,476,168811,171,130937,299748,03/15/2016
2000,Morrisville-Eaton,252601,855,290907,253,180298,471205,03/15/2016
2000,Hamilton,253201,773,298666,260,225369,524035,03/15/2016
2000,Canastota,253601,1636,534546,628,457563,992109,03/15/2016
2000,Madison,254001,537,213998,194,159630,373628,03/15/2016
2000,Stockbridge Valley,254601,466,153272,163,108662,261934,03/15/2016
2000,Chittenango,254801,2908,1308104,730,706080,2014184,03/15/2016
2000,Rochester,261400,23109,5889631,6115,3296824,9186455,03/15/2016
2000,Brighton,262001,4894,2227517,989,1084443,3311960,03/15/2016
2000,Gates-Chili,262601,7335,3207650,2906,3027578,6235228,03/15/2016
2000,Greece,262801,16590,6640976,5435,5252929,11893905,03/15/2016
2000,East Irondequoit,263401,5381,2316106,2819,2850616,5166722,03/15/2016
2000,West Irondequoit,263403,5504,2648469,2113,2482065,5130534,03/15/2016
2000,Honeoye Falls-Lima,263601,2934,1145045,501,474228,1619273,03/15/2016
2000,Spencerport,263801,4794,1979564,1155,1151710,3131274,03/15/2016
2000,Hilton,264001,5342,2042215,1036,958590,3000805,03/15/2016
2000,Penfield,264201,7311,3467297,1467,1695846,5163143,03/15/2016
2000,Fairport,264401,8677,3284851,1749,1584291,4869142,03/15/2016
2000,East Rochester,264413,1488,610131,701,657371,1267502,03/15/2016
2000,Pittsford,264601,7674,2978375,1015,972614,3950989,03/15/2016
2000,Churchville-Chili,264801,4970,2145516,1131,1169642,3315158,03/15/2016
2000,Rush-Henrietta,265001,7334,2585692,1983,1662253,4247945,03/15/2016
2000,Brockport,265201,4323,1633366,769,693204,2326570,03/15/2016
2000,Webster,265401,10733,3866825,2793,2456832,6323657,03/15/2016
2000,Wheatland-Chili,265601,1170,489107,367,356227,845334,03/15/2016
2000,Amsterdam,270100,3497,1381962,2313,2004742,3386704,03/15/2016
2000,Canajoharie,272201,994,388916,509,430640,819556,03/15/2016
2000,Fonda-Fultonville,272801,1549,596312,579,473577,1069889,03/15/2016
2000,Fort Plain,273001,825,364636,410,368194,732830,03/15/2016
2000,St. Johnsville,273802,488,187474,309,226742,414216,03/15/2016
2000,Glen Cove,280500,2723,1747528,1218,1888686,3636214,03/15/2016
2000,Long Beach,281000,5920,2260351,1108,1152226,3412577,03/15/2016
2000,Hempstead,282001,2395,2233276,539,1264862,3498138,03/15/2016
2000,Uniondale,282002,4144,2191673,966,1310673,3502346,03/15/2016
2000,East Meadow,282003,9756,6161016,3109,4407289,10568305,03/15/2016
2000,North Bellmore,282004,5276,3146838,1265,1967346,5114184,03/15/2016
2000,Levittown,282005,9803,7428720,2414,4822054,12250774,03/15/2016
2000,Seaford,282006,3457,2039798,858,1296519,3336317,03/15/2016
2000,Bellmore,282007,2809,1664779,506,760593,2425372,03/15/2016
2000,Roosevelt,282008,1849,1145962,402,615858,1761820,03/15/2016
2000,Freeport,282009,4559,2787478,926,1439666,4227144,03/15/2016
2000,Baldwin,282010,6349,4234448,1142,1936788,6171236,03/15/2016
2000,Oceanside,282011,7608,4158047,1770,2493498,6651545,03/15/2016
2000,Malverne,282012,2675,1720450,674,1166242,2886692,03/15/2016
2000,Valley Stream 13,282013,5303,3260691,1646,2613503,5874194,03/15/2016
2000,Hewlett-Woodmere,282014,4297,2690633,678,1061854,3752487,03/15/2016
2000,Lawrence,282015,5612,2515004,942,1173468,3688472,03/15/2016
2000,Elmont,282016,6387,3387856,1970,2679199,6067055,03/15/2016
2000,Franklin Square,282017,4372,2183162,1687,2179363,4362525,03/15/2016
2000,Garden City,282018,5223,1722887,789,711662,2434549,03/15/2016
2000,East Rockaway,282019,1726,1059663,511,804114,1863777,03/15/2016
2000,Lynbrook,282020,3343,2013189,829,1305609,3318798,03/15/2016
2000,Rockville Centre,282021,4275,2205739,679,956198,3161937,03/15/2016
2000,Floral Park-Bellerose,282022,3674,1841116,928,1234140,3075256,03/15/2016
2000,Wantagh,282023,4061,2554589,787,1321543,3876132,03/15/2016
2000,Valley Stream 24,282024,2140,1167990,686,969443,2137433,03/15/2016
2000,Merrick,282025,4355,2316347,631,856250,3172597,03/15/2016
2000,Island Trees,282026,2947,1723190,809,1245407,2968597,03/15/2016
2000,West Hempstead,282027,3200,1814593,773,1148826,2963419,03/15/2016
2000,North Merrick,282029,2918,1695010,755,1189342,2884352,03/15/2016
2000,Valley Stream 30,282030,2474,1196602,816,1047992,2244594,03/15/2016
2000,Island Park,282031,1367,605660,317,344654,950314,03/15/2016
2000,Westbury,282201,2554,1744522,660,1152040,2896562,03/15/2016
2000,East Williston,282202,1941,1027061,281,401253,1428314,03/15/2016
2000,Roslyn,282203,3693,1893279,381,544744,2438023,03/15/2016
2000,Port Washington,282204,5039,2017815,724,777477,2795292,03/15/2016
2000,New Hyde Park-Garden City,282205,3967,1663041,1447,1627273,3290314,03/15/2016
2000,Manhasset,282206,3377,1066277,372,353006,1419283,03/15/2016
2000,Great Neck,282207,8165,2463235,1080,883293,3346528,03/15/2016
2000,Herricks,282209,5432,2553384,1117,1559387,4112771,03/15/2016
2000,Mineola,282210,3804,1653108,1265,1531155,3184263,03/15/2016
2000,Carle Place,282211,1618,721116,502,613595,1334711,03/15/2016
2000,North Shore,282401,3169,1120989,656,611858,1732847,03/15/2016
2000,Syosset,282402,7144,3406453,1001,1313994,4720447,03/15/2016
2000,Locust Valley,282403,2989,1097460,474,497643,1595103,03/15/2016
2000,Plainview-Old Bethpage,282404,6310,3419231,1367,2075858,5495089,03/15/2016
2000,Oyster Bay-East Norwich,282406,2235,800180,412,420619,1220799,03/15/2016
2000,Jericho,282415,3044,1282250,331,382877,1665127,03/15/2016
2000,Hicksville,282417,6609,2576058,2334,2476703,5052761,03/15/2016
2000,Plainedge,282418,4080,2600390,1238,2135117,4735507,03/15/2016
2000,Bethpage,282421,3570,1777557,1344,1483173,3260730,03/15/2016
2000,Farmingdale,282422,7344,4924664,2201,3881709,8806373,03/15/2016
2000,Massapequa,282423,10526,5154320,2452,3292540,8446860,03/15/2016
2000,Lockport,290900,5679,2705694,1750,1806367,4512061,03/15/2016
2000,Niagara Falls,291100,6885,2068195,4510,2745266,4813461,03/15/2016
2000,North Tonawanda,291200,5612,2502213,2543,2657976,5160189,03/15/2016
2000,Lewiston-Porter,292401,3543,1491877,1325,1366689,2858566,03/15/2016
2000,Newfane,292801,2039,896996,714,738780,1635776,03/15/2016
2000,Niagara-Wheatfield,293001,4232,1402285,1522,1155720,2558005,03/15/2016
2000,Starpoint,293201,2980,986439,839,667402,1653841,03/15/2016
2000,Royalton-Hartland,293601,1831,836371,593,639659,1476030,03/15/2016
2000,Barker,293801,963,321664,337,255005,576669,03/15/2016
2000,Wilson,294201,1570,673075,577,587055,1260130,03/15/2016
2000,Rome,301300,5461,2408467,2668,2447343,4855810,03/15/2016
2000,Utica,301600,6263,2262593,4300,3138319,5400912,03/15/2016
2000,Adirondack,302601,1651,549975,648,419200,969175,03/15/2016
2000,Camden,303001,2539,822899,880,545432,1368331,03/15/2016
2000,Clinton,304001,1627,685245,549,515121,1200366,03/15/2016
2000,New Hartford,304801,3368,1673567,1285,1383149,3056716,03/15/2016
2000,New York Mills,304804,739,355226,566,646577,1001803,03/15/2016
2000,Sauquoit Valley,305002,1256,468506,420,340682,809188,03/15/2016
2000,Remsen,305201,670,234220,199,148619,382839,03/15/2016
2000,Waterville,305401,1050,394018,355,284818,678836,03/15/2016
2000,Holland Patent,305801,1918,729136,574,480442,1209578,03/15/2016
2000,Sherrill,306000,2495,848374,889,681440,1529814,03/15/2016
2000,Westmoreland,306801,1325,630447,506,488554,1119001,03/15/2016
2000,Oriskany,307001,854,355654,349,323778,679432,03/15/2016
2000,Whitesboro,307002,4433,1868906,1941,1921786,3790692,03/15/2016
2000,Syracuse,311500,14675,3583461,6540,3677380,7260841,03/15/2016
2000,West Genesee,312001,6522,2642899,2652,2485365,5128264,03/15/2016
2000,North Syracuse,312403,12280,4898037,3398,2954797,7852834,03/15/2016
2000,East Syracuse-Minoa,312601,4400,1937557,1759,1675715,3613272,03/15/2016
2000,Jamesville-Dewitt,312611,3533,1403608,846,797387,2200995,03/15/2016
2000,Jordan-Elbridge,312801,1653,816058,530,505626,1321684,03/15/2016
2000,Fabius-Pompey,313001,1024,414435,248,225457,639892,03/15/2016
2000,Westhill,313201,2286,1017956,1050,1116131,2134087,03/15/2016
2000,Solvay,313202,1664,636759,1083,965962,1602721,03/15/2016
2000,La Fayette,313407,969,357912,252,205754,563666,03/15/2016
2000,Baldwinsville,313601,7070,2783286,1637,1421425,4204711,03/15/2016
2000,Fayetteville-Manlius,313801,5682,2689678,1093,1234313,3923991,03/15/2016
2000,Marcellus,314001,2453,937907,670,605468,1543375,03/15/2016
2000,Onondaga,314201,1280,627162,441,463341,1090503,03/15/2016
2000,Liverpool,314801,9811,4472755,2861,2980471,7453226,03/15/2016
2000,Lyncourt,314804,705,216287,527,351593,567880,03/15/2016
2000,Skaneateles,315001,2013,696041,613,503320,1199361,03/15/2016
2000,Tully,315402,1213,389622,263,196175,585797,03/15/2016
2000,Canandaigua,320200,3758,1326104,1004,838329,2164433,03/15/2016
2000,Geneva,320500,2427,898605,1187,984218,1882823,03/15/2016
2000,East Bloomfield,322601,1235,541038,289,295960,836998,03/15/2016
2000,Gorham-Middlesex,323201,1874,603744,624,462359,1066103,03/15/2016
2000,Manchester-Shortsville,323601,1081,532052,390,402123,934175,03/15/2016
2000,Naples,323801,1211,379129,351,255319,634448,03/15/2016
2000,Phelps-Clifton Springs,324001,2155,1098292,606,695098,1793390,03/15/2016
2000,Honeoye,324201,1341,433397,352,265379,698776,03/15/2016
2000,Victor,324801,3419,1319918,598,531219,1851137,03/15/2016
2000,Middletown,330900,4280,2204720,1426,1589774,3794494,03/15/2016
2000,Newburgh,331100,7973,3700404,2669,2741276,6441680,03/15/2016
2000,Port Jervis,331300,2366,1100171,963,967182,2067353,03/15/2016
2000,Washingtonville,332002,5020,2029562,633,709710,2739272,03/15/2016
2000,Chester,332201,1076,501807,224,257629,759436,03/15/2016
2000,Cornwall,332401,2850,1201097,584,592163,1793260,03/15/2016
2000,Pine Bush,332601,4904,2404795,978,1127293,3532088,03/15/2016
2000,Goshen,333001,2554,944575,586,531609,1476184,03/15/2016
2000,Highland Falls,333601,671,233730,280,237029,470759,03/15/2016
2000,Minisink Valley,333801,3663,1664544,679,733693,2398237,03/15/2016
2000,Monroe-Woodbury,334001,7302,3312515,987,1217770,4530285,03/15/2016
2000,Kiryas Joel Village,334002,539,148466,39,26899,175365,03/15/2016
2000,Valley,334201,4240,1722722,1089,1036853,2759575,03/15/2016
2000,Tuxedo,335003,427,69013,97,45861,114874,03/15/2016
2000,Warwick Valley,335401,4385,1959606,818,902886,2862492,03/15/2016
2000,Greenwood Lake,335411,1283,575496,273,297598,873094,03/15/2016
2000,Florida,335415,936,403191,263,278877,682068,03/15/2016
2000,Albion,342001,2102,746946,846,680988,1427934,03/15/2016
2000,Kendall,343007,1116,423922,260,232225,656147,03/15/2016
2000,Holley,343204,1298,580720,402,384565,965285,03/15/2016
2000,Medina,343401,1775,685273,809,697015,1382288,03/15/2016
2000,Lyndonville,343801,808,246859,326,223556,470415,03/15/2016
2000,Fulton,350400,3329,1360419,1335,1091307,2451726,03/15/2016
2000,Oswego,351200,4834,1201153,1760,1056820,2257973,03/15/2016
2000,Altmar Parish-Williamstown,352002,1355,450403,365,250243,700646,03/15/2016
2000,Hannibal,353001,1474,459448,407,260237,719685,03/15/2016
2000,Central Square,353201,4655,1782295,1211,897435,2679730,03/15/2016
2000,Mexico,353401,2410,821501,609,447934,1269435,03/15/2016
2000,Pulaski,355001,1057,405061,326,266934,671995,03/15/2016
2000,Sandy Creek,355201,989,344741,356,240260,585001,03/15/2016
2000,Phoenix,355401,2470,1087914,633,591044,1678958,03/15/2016
2000,Oneonta,361200,2205,944863,909,894914,1839777,03/15/2016
2000,Gilbertsville-Mt Upton,362202,573,162704,233,137429,300133,03/15/2016
2000,Cherry Valley-Springfield,362401,750,196115,381,221654,417769,03/15/2016
2000,Edmeston,362801,504,139141,209,131377,270518,03/15/2016
2000,Laurens,363401,506,192683,175,150130,342813,03/15/2016
2000,Schenevus,363601,494,183172,190,143782,326954,03/15/2016
2000,Milford,364001,578,216095,247,207839,423934,03/15/2016
2000,Morris,364201,485,184745,208,181164,365909,03/15/2016
2000,Otego-Unadilla,364801,1215,474230,520,435710,909940,03/15/2016
2000,Cooperstown,365001,1084,327848,486,342362,670210,03/15/2016
2000,Richfield Springs,365601,693,173324,383,223485,396809,03/15/2016
2000,Worcester,366606,421,152629,216,172572,325201,03/15/2016
2000,Mahopac,372001,5090,3129477,809,1232143,4361620,03/15/2016
2000,Carmel,372002,5292,3391441,888,1409342,4800783,03/15/2016
2000,Haldane,372601,871,457488,271,320427,777915,03/15/2016
2000,Garrison,372604,468,156510,66,55154,211664,03/15/2016
2000,Putnam Valley,372803,2080,1480572,339,577495,2058067,03/15/2016
2000,Brewster,373001,3851,2303470,770,1126311,3429781,03/15/2016
2000,Rensselaer,381400,1016,491610,421,386645,878255,03/15/2016
2000,Troy,381700,3860,1401564,1633,1211377,2612941,03/15/2016
2000,Lansingburgh,381701,2358,1049366,997,930889,1980255,03/15/2016
2000,Berlin,382001,1340,502400,406,339851,842251,03/15/2016
2000,Brunswick,382202,1565,664177,468,450563,1114740,03/15/2016
2000,East Greenbush,382401,5636,2316272,1576,1524089,3840361,03/15/2016
2000,Hoosick Falls,382801,1416,468120,576,414584,882704,03/15/2016
2000,North Greenbush,383201,252,33537,119,38835,72372,03/15/2016
2000,Wynantskill,383204,745,285857,304,273874,559731,03/15/2016
2000,Averill Park,384001,3839,1478639,979,838354,2316993,03/15/2016
2000,Hoosic Valley,384201,1328,525063,373,326207,851270,03/15/2016
2000,Schodack,384401,1276,574108,352,371998,946106,03/15/2016
2000,Clarkstown,392001,11057,5690551,1617,2138275,7828826,03/15/2016
2000,Nanuet,392008,2183,1010458,643,748649,1759107,03/15/2016
2000,Haverstraw-Stony Point,392201,7136,5129419,1704,2545298,7674717,03/15/2016
2000,South Orangetown,392401,3710,1994623,1011,1381821,3376444,03/15/2016
2000,Nyack,392404,3498,2489406,800,1492683,3982089,03/15/2016
2000,Pearl River,392408,2810,1813094,753,1235852,3048946,03/15/2016
2000,Ramapo,392601,5407,4473368,1077,2083788,6557156,03/15/2016
2000,East Ramapo,392602,11193,8543912,1731,3018014,11561926,03/15/2016
2000,Ogdensburg,401200,1952,746809,779,465439,1212248,03/15/2016
2000,Brasher Falls,402001,1119,372815,421,265175,637990,03/15/2016
2000,Canton,402201,1540,543097,439,321407,864504,03/15/2016
2000,Clifton-Fine,402601,464,125449,254,109477,234926,03/15/2016
2000,Colton-Pierrepont,402801,521,131990,199,100738,232728,03/15/2016
2000,Edwards-Knox,403401,637,96603,212,58584,155187,03/15/2016
2000,Gouverneur,404001,1595,462041,609,316223,778264,03/15/2016
2000,Hammond,404201,308,60978,151,59601,120579,03/15/2016
2000,Hermon-Dekalb,404401,461,149418,173,110707,260125,03/15/2016
2000,Lisbon,405002,683,240798,243,168036,408834,03/15/2016
2000,Madrid-Waddington,405601,871,301191,313,217575,518766,03/15/2016
2000,Massena,405801,3005,908488,1444,959993,1868481,03/15/2016
2000,Morristown,406001,556,162433,221,133463,295896,03/15/2016
2000,Norwood-Norfolk,406201,1225,416917,467,295936,712853,03/15/2016
2000,Heuvelton,406404,728,252097,229,151361,403458,03/15/2016
2000,Parishville-Hopkinton,406601,609,154407,163,68753,223160,03/15/2016
2000,Potsdam,407402,1658,656445,559,466089,1122534,03/15/2016
2000,Mechanicville,411000,1202,374953,583,439132,814085,03/15/2016
2000,Saratoga Springs,411500,7866,2834016,1654,1363341,4197357,03/15/2016
2000,Burnt Hills-Ballston Lake,412001,4333,1799001,1150,1165876,2964877,03/15/2016
2000,Shenendehowa,412402,11010,4677036,1616,1655603,6332639,03/15/2016
2000,Corinth,412601,1197,458246,521,359161,817407,03/15/2016
2000,Edinburg,413001,281,44697,150,51337,96034,03/15/2016
2000,Galway,413201,1357,410364,339,231425,641789,03/15/2016
2000,Ballston Spa,414201,4452,2049375,1002,942466,2991841,03/15/2016
2000,South Glens Falls,414401,2968,1123869,1003,783064,1906933,03/15/2016
2000,Schuylerville,415001,1839,911126,462,502142,1413268,03/15/2016
2000,Stillwater,415201,1362,481465,369,301657,783122,03/15/2016
2000,Waterford-Halfmoon,415401,796,384664,494,515664,900328,03/15/2016
2000,Schenectady,421500,6793,2608636,3608,3158270,5766906,03/15/2016
2000,Duanesburg,422001,1066,404254,211,186343,590597,03/15/2016
2000,Scotia-Glenville,422202,3685,1618154,1200,1258114,2876268,03/15/2016
2000,Niskayuna,422401,5446,2212656,973,971058,3183714,03/15/2016
2000,Schalmont,422801,3018,1133921,910,780747,1914668,03/15/2016
2000,Rotterdam-Mohonasen,422803,4142,1424994,2125,1629045,3054039,03/15/2016
2000,Cobleskill-Richmondville,432602,2156,584373,782,463331,1047704,03/15/2016
2000,Gilboa-Conesville,433401,472,129702,277,154563,284265,03/15/2016
2000,Jefferson,433601,358,96997,140,85908,182905,03/15/2016
2000,Middleburgh,433801,1085,374828,436,339492,714320,03/15/2016
2000,Schoharie,434201,1313,446073,444,339078,785151,03/15/2016
2000,Sharon Springs,434601,391,145343,136,105535,250878,03/15/2016
2000,Odessa-Montour,442001,1050,289553,391,227098,516651,03/15/2016
2000,Watkins Glen,442401,1486,386861,684,404860,791721,03/15/2016
2000,South Seneca,452801,1071,306355,504,302962,609317,03/15/2016
2000,Romulus,453003,562,170264,239,167532,337796,03/15/2016
2000,Seneca Falls,453201,1720,641397,794,664278,1305675,03/15/2016
2000,Waterloo,453801,1896,569980,774,508113,1078093,03/15/2016
2000,Corning,460300,5896,2406922,2292,1938413,4345335,03/15/2016
2000,Hornell,460600,1519,411488,811,408057,819545,03/15/2016
2000,Addison,462001,1172,506923,427,334600,841523,03/15/2016
2000,Avoca,462201,662,217415,227,151309,368724,03/15/2016
2000,Bath,462402,1642,474123,662,425808,899931,03/15/2016
2000,Bradford,462601,355,122626,138,97845,220471,03/15/2016
2000,Campbell-Savona,463002,973,187320,311,127672,314992,03/15/2016
2000,Canisteo,463201,903,327127,377,252610,579737,03/15/2016
2000,Greenwood,464601,225,79995,92,50809,130804,03/15/2016
2000,Arkport,465201,520,198294,210,159980,358274,03/15/2016
2000,Jasper-Troupsburg,465601,466,114097,191,96334,210431,03/15/2016
2000,Prattsburgh,466001,511,127098,204,99980,227078,03/15/2016
2000,Hammondsport,467201,915,276712,386,248467,525179,03/15/2016
2000,Wayland-Cohocton,467401,1825,401187,609,283458,684645,03/15/2016
2000,Babylon,472001,2255,1582209,441,737166,2319375,03/15/2016
2000,West Babylon,472002,4587,3032185,1154,1820284,4852469,03/15/2016
2000,North Babylon,472003,5283,3042623,1575,2209770,5252393,03/15/2016
2000,Lindenhurst,472004,6892,4406954,1906,2911966,7318920,03/15/2016
2000,Copiague,472005,3976,2513482,1194,1745885,4259367,03/15/2016
2000,Amityville,472006,3095,2042131,813,1254951,3297082,03/15/2016
2000,Deer Park,472007,4379,2920884,1503,2437002,5357886,03/15/2016
2000,Wyandanch,472009,749,416669,189,236627,653296,03/15/2016
2000,Three Village,472201,7456,4013924,1267,1665743,5679667,03/15/2016
2000,Brookhaven-Comsewogue,472203,3561,1837458,723,923389,2760847,03/15/2016
2000,South Country,472204,3848,2043193,758,949321,2992514,03/15/2016
2000,Sachem,472205,14885,8094887,2224,2937792,11032679,03/15/2016
2000,Port Jefferson,472206,1341,520629,243,230753,751382,03/15/2016
2000,Mount Sinai,472207,2131,1379045,324,528955,1908000,03/15/2016
2000,Miller Place,472208,2772,1628543,356,509057,2137600,03/15/2016
2000,Rocky Point,472209,2835,1580496,549,714247,2294743,03/15/2016
2000,Middle Country,472211,9420,4541815,1991,2341591,6883406,03/15/2016
2000,Longwood,472212,8873,5349697,2904,3881534,9231231,03/15/2016
2000,South Manor,472221,1487,853531,203,282046,1135577,03/15/2016
2000,Patchogue-Medford,472224,7452,3516668,1706,1893261,5409929,03/15/2016
2000,William Floyd,472232,6477,3533518,1338,1610811,5144329,03/15/2016
2000,Center Moriches,472233,1164,685253,279,386508,1071761,03/15/2016
2000,East Moriches,472234,951,551456,186,258923,810379,03/15/2016
2000,East Hampton,472401,1297,156992,410,128247,285239,03/15/2016
2000,Wainscott,472402,127,7289,27,4451,11740,03/15/2016
2000,Amagansett,472403,249,21366,110,27168,48534,03/15/2016
2000,Springs,472404,900,184779,297,178283,363062,03/15/2016
2000,Sag Harbor,472405,1123,233278,582,330617,563895,03/15/2016
2000,Montauk,472406,645,63248,272,98073,161321,03/15/2016
2000,Elwood,472601,2850,1440040,683,855049,2295089,03/15/2016
2000,Cold Spring Harbor,472602,1961,807765,194,192189,999954,03/15/2016
2000,Huntington,472603,6618,3424807,1602,1983622,5408429,03/15/2016
2000,Northport-East Northport,472604,8192,3228517,1811,1731832,4960349,03/15/2016
2000,Half Hollow Hills,472605,9149,3823518,1464,1371705,5195223,03/15/2016
2000,Harborfields,472606,4255,2114190,864,1037651,3151841,03/15/2016
2000,Commack,472610,8642,4303745,1807,2276848,6580593,03/15/2016
2000,South Huntington,472613,7649,4156743,2159,2849943,7006686,03/15/2016
2000,Bay Shore,472801,4548,2835912,1130,1751771,4587683,03/15/2016
2000,Islip,472802,3372,1741101,693,899010,2640111,03/15/2016
2000,East Islip,472803,5004,2929047,1035,1638591,4567638,03/15/2016
2000,Sayville,472804,3604,2288511,798,1267204,3555715,03/15/2016
2000,Bayport-Blue Point,472805,2633,1695242,485,764813,2460055,03/15/2016
2000,Hauppauge,472806,4548,1453054,850,685615,2138669,03/15/2016
2000,Connetquot,472807,7497,4157993,1392,1869810,6027803,03/15/2016
2000,West Islip,472809,5735,3347652,1338,1979760,5327412,03/15/2016
2000,Brentwood,472812,7383,4163137,2268,3200737,7363874,03/15/2016
2000,Central Islip,472813,4304,3275463,846,1546376,4821839,03/15/2016
2000,Fire Island,472814,95,5651,23,3481,9132,03/15/2016
2000,Shoreham-Wading River,473001,2493,1359974,691,845545,2205519,03/15/2016
2000,Riverhead,473002,4945,2490824,2478,2368436,4859260,03/15/2016
2000,Shelter Island,473201,498,68365,267,91613,159978,03/15/2016
2000,Smithtown,473401,12042,6526084,2292,3024304,9550388,03/15/2016
2000,Kings Park,473405,4827,2311517,862,1047095,3358612,03/15/2016
2000,Remsenburg-Speonk,473601,358,63201,88,42224,105425,03/15/2016
2000,Westhampton Beach,473602,723,151328,248,136715,288043,03/15/2016
2000,Quogue,473603,206,18912,53,13225,32137,03/15/2016
2000,Hampton Bays,473605,1706,508960,805,637726,1146686,03/15/2016
2000,Southhampton,473606,1582,211673,633,230024,441697,03/15/2016
2000,Bridgehampton,473609,275,36225,103,36859,73084,03/15/2016
2000,Sagaponack,473610,81,2755,8,740,3495,03/15/2016
2000,Eastport,473611,1381,888408,508,667833,1556241,03/15/2016
2000,Tuckahoe Common,473613,418,84836,175,96313,181149,03/15/2016
2000,East Quogue,473617,832,306991,280,254211,561202,03/15/2016
2000,Oysterponds,473802,308,55130,216,95931,151061,03/15/2016
2000,Fishers Island,473804,38,6628,15,6390,13018,03/15/2016
2000,Southold,473805,1256,400097,658,517017,917114,03/15/2016
2000,Greenport,473810,496,190215,366,339522,529737,03/15/2016
2000,Mattituck-Cutchogue,473812,1867,663762,798,700298,1364060,03/15/2016
2000,New Suffolk,473815,61,10049,48,19509,29558,03/15/2016
2000,Fallsburg,482801,955,531980,401,486231,1018211,03/15/2016
2000,Eldred,483401,800,230562,378,255145,485707,03/15/2016
2000,Liberty,483601,1218,534097,556,557516,1091613,03/15/2016
2000,Tri-Valley,484201,1089,410127,329,242295,652422,03/15/2016
2000,Roscoe,484401,304,81692,202,119421,201113,03/15/2016
2000,Livingston Manor,484402,542,160585,263,172375,332960,03/15/2016
2000,Monticello,484601,2629,1008126,1230,1051243,2059369,03/15/2016
2000,Sullivan West,484802,1851,563534,945,666032,1229566,03/15/2016
2000,Waverly,492001,1473,395403,665,355569,750972,03/15/2016
2000,Candor,492401,874,285852,330,228909,514761,03/15/2016
2000,Newark Valley,492602,1414,587508,471,421516,1009024,03/15/2016
2000,Owego-Apalachin,493001,2599,1124967,975,886109,2011076,03/15/2016
2000,Spencer-Van Etten,493401,1120,292039,358,196285,488324,03/15/2016
2000,Tioga,493603,1055,289394,344,199644,489038,03/15/2016
2000,Ithaca,500700,6743,2668424,1652,1400855,4069279,03/15/2016
2000,Dryden,502401,2133,919027,458,395227,1314254,03/15/2016
2000,Groton,502801,1144,390358,277,197743,588101,03/15/2016
2000,Lansing,503201,1306,493900,317,266903,760803,03/15/2016
2000,Newfield,503401,850,344050,231,154311,498361,03/15/2016
2000,Trumansburg,503601,1410,540851,404,326919,867770,03/15/2016
2000,Kingston,510800,7401,2838880,3146,2765010,5603890,03/15/2016
2000,Highland,513203,1877,875887,568,616919,1492806,03/15/2016
2000,Rondout Valley,513401,3100,1514949,1026,1111926,2626875,03/15/2016
2000,Marlboro,513601,1835,580535,557,412587,993122,03/15/2016
2000,New Paltz,513801,2747,1235908,656,722981,1958889,03/15/2016
2000,Onteora,514001,2983,991149,1156,875994,1867143,03/15/2016
2000,Saugerties,514801,3714,1348855,1260,1065745,2414600,03/15/2016
2000,Wallkill,515201,3113,1489278,869,807164,2296442,03/15/2016
2000,Ellenville,515602,1432,741473,592,535595,1277068,03/15/2016
2000,Glens Falls,520500,2384,779241,897,673985,1453226,03/15/2016
2000,Bolton,522001,353,54124,157,58286,112410,03/15/2016
2000,Lake George,522201,1266,233989,437,196426,430415,03/15/2016
2000,North Warren,522402,861,168723,405,181135,349858,03/15/2016
2000,Johnsburg,523001,445,137007,250,163577,300584,03/15/2016
2000,Hadley-Luzerne,523201,1059,310679,513,322822,633501,03/15/2016
2000,Queensbury,523402,3667,1152076,982,703274,1855350,03/15/2016
2000,Glens Falls Common,523418,197,44993,123,62669,107662,03/15/2016
2000,Warrensburg,524001,1033,383985,410,336859,720844,03/15/2016
2000,Argyle,532001,767,228374,255,165652,394026,03/15/2016
2000,Fort Ann,532802,670,200957,190,131013,331970,03/15/2016
2000,Fort Edward,533001,439,162718,232,206274,368992,03/15/2016
2000,Granville,533201,1231,445376,483,372306,817682,03/15/2016
2000,Greenwich,533401,1204,448300,479,420025,868325,03/15/2016
2000,Hartford,533801,634,210423,154,113765,324188,03/15/2016
2000,Hudson Falls,534401,2224,807872,980,785664,1593536,03/15/2016
2000,Putnam,534601,135,28813,45,22617,51430,03/15/2016
2000,Salem,534801,730,236972,280,206049,443021,03/15/2016
2000,Cambridge,535010,1102,369867,473,383283,753150,03/15/2016
2000,Whitehall,535201,777,267787,420,289500,557287,03/15/2016
2000,Newark,542001,2523,992762,946,839646,1832408,03/15/2016
2000,Clyde-Savannah,542401,999,367901,444,344134,712035,03/15/2016
2000,Lyons,542801,1072,388539,458,328081,716620,03/15/2016
2000,Gananda,543002,1165,487123,76,76213,563336,03/15/2016
2000,Marion,543201,1231,527994,258,255922,783916,03/15/2016
2000,Wayne,543401,3147,1061502,578,466853,1528355,03/15/2016
2000,Palmyra-Macedon,543601,2353,1061548,597,598858,1660406,03/15/2016
2000,Sodus,544201,1474,671461,544,507864,1179325,03/15/2016
2000,Williamson,544602,1405,562677,378,357102,919779,03/15/2016
2000,North Rose-Wolcott,544801,1731,570068,664,454038,1024106,03/15/2016
2000,Red Creek,544803,1069,254277,358,179193,433470,03/15/2016
2000,Mount Vernon,550800,3918,4792368,1737,4459007,9251375,03/15/2016
2000,New Rochelle,551000,7137,7699158,1607,4366609,12065767,03/15/2016
2000,Peekskill,551200,2329,2455350,645,1384587,3839937,03/15/2016
2000,Rye,551400,2692,1796634,422,683725,2480359,03/15/2016
2000,White Plains,551700,5630,6537040,1232,2917947,9454987,03/15/2016
2000,Yonkers,551800,13807,12847391,5610,11003909,23851300,03/15/2016
2000,Katonah-Lewisboro,552001,4038,4159188,483,1167518,5326706,03/15/2016
2000,Bedford,552002,4025,2917160,689,1163808,4080968,03/15/2016
2000,Croton-Harmon,552202,1709,1922163,309,760235,2682398,03/15/2016
2000,Hendrick Hudson,552203,2761,2416997,530,901825,3318822,03/15/2016
2000,Eastchester,552401,2662,2921457,800,1885103,4806560,03/15/2016
2000,Tuckahoe,552402,1001,989276,273,605456,1594732,03/15/2016
2000,Bronxville,552403,1052,1112541,65,289044,1401585,03/15/2016
2000,Tarrytowns,552601,1926,2174385,479,1245894,3420279,03/15/2016
2000,Irvington,552602,1584,1613875,239,620673,2234548,03/15/2016
2000,Dobbs Ferry,552603,1202,1629133,232,764093,2393226,03/15/2016
2000,Hastings On Hudson,552604,1374,1915422,323,1043680,2959102,03/15/2016
2000,Ardsley,552605,2184,2252281,402,1032798,3285079,03/15/2016
2000,Edgemont,552606,1437,1715830,147,412940,2128770,03/15/2016
2000,Greenburgh,552607,3325,3335072,947,2050049,5385121,03/15/2016
2000,Elmsford,552609,1071,940204,363,766516,1706720,03/15/2016
2000,Harrison,552801,2956,1890032,698,1054815,2944847,03/15/2016
2000,Mamaroneck,553201,4060,3525897,676,1438494,4964391,03/15/2016
2000,Mount Pleasant,553401,2543,2067663,611,1220415,3288078,03/15/2016
2000,Pocantico Hills,553402,400,161220,89,80613,241833,03/15/2016
2000,Valhalla,553405,1488,1402584,396,964183,2366767,03/15/2016
2000,Pleasantville,553409,1686,1712554,318,717233,2429787,03/15/2016
2000,Chappaqua,553604,3848,3860991,202,491994,4352985,03/15/2016
2000,Byram Hills,553801,2450,1714049,228,417112,2131161,03/15/2016
2000,North Salem,554001,1623,1337175,220,392277,1729452,03/15/2016
2000,Ossining,554201,4896,5489207,920,2276921,7766128,03/15/2016
2000,Briarcliff Manor,554202,1496,1601915,133,347058,1948973,03/15/2016
2000,Pelham,554401,1998,1786659,368,779763,2566422,03/15/2016
2000,Rye Neck,554801,1317,1208125,361,776644,1984769,03/15/2016
2000,Port Chester-Rye,554804,2265,2127658,1165,2449698,4577356,03/15/2016
2000,Blind Brook-Rye,554805,1274,1097765,203,438282,1536047,03/15/2016
2000,Scarsdale,555001,4236,3498737,230,474257,3972994,03/15/2016
2000,Somers,555201,3802,2976567,957,1759804,4736371,03/15/2016
2000,Lakeland,555401,6988,7151038,1558,2980502,10131540,03/15/2016
2000,Yorktown,555402,4464,4724808,587,1474619,6199427,03/15/2016
2000,Attica,562201,2158,614350,636,435116,1049466,03/15/2016
2000,Letchworth,562601,1348,420714,397,263807,684521,03/15/2016
2000,Wyoming,563802,437,121535,95,64056,185591,03/15/2016
2000,Perry,564201,1199,391503,460,344249,735752,03/15/2016
2000,Warsaw,564801,1317,508847,423,383729,892576,03/15/2016
2000,Penn Yan,573001,2449,676903,1149,713465,1390368,03/15/2016
2000,Dundee,573401,1002,256543,440,239703,496246,03/15/2016
2000,New York City School,650000,401880,52382626,114159,37053488,89436114,03/15/2016
1999,Albany,010100,8352,1659890,4205,3753354,5413244,03/15/2016
1999,Cohoes,010300,1670,335983,922,770939,1106922,03/15/2016
1999,Watervliet,011800,1136,175367,655,478650,654017,03/15/2016
1999,Berne-Knox-Westerlo,012001,1297,210948,356,270182,481130,03/15/2016
1999,Bethlehem,012206,5532,1167942,1280,1314132,2482074,03/15/2016
1999,Ravena-Coeymans-Selkirk,012402,2326,477175,760,651646,1128821,03/15/2016
1999,South Colonie,012601,7365,1074005,3070,2107320,3181325,03/15/2016
1999,North Colonie,012605,6034,836966,1898,1287761,2124727,03/15/2016
1999,Menands,012615,312,34909,124,66547,101456,03/15/2016
1999,Maplewood,012622,67,7703,75,41267,48970,03/15/2016
1999,Green Island,012801,224,47737,143,142599,190336,03/15/2016
1999,Guilderland,013002,6070,1169983,1555,1457556,2627539,03/15/2016
1999,Voorheesville,013403,1673,333020,401,392662,725682,03/15/2016
1999,Alfred-Almond,022001,741,144108,261,209510,353618,03/15/2016
1999,Andover,023001,371,76936,157,120348,197284,03/15/2016
1999,Genesee Valley,023202,618,73946,348,151846,225792,03/15/2016
1999,Belfast,023401,348,47013,168,83665,130678,03/15/2016
1999,Canaseraga,024002,331,58596,143,93885,152481,03/15/2016
1999,Cuba-Rushford,024801,1041,115306,507,223620,338926,03/15/2016
1999,Friendship,025001,274,45809,155,89954,135763,03/15/2016
1999,Fillmore,025801,609,83062,266,147592,230654,03/15/2016
1999,Whitesville,026001,222,43837,83,54003,97840,03/15/2016
1999,Scio,026601,410,88260,191,142908,231168,03/15/2016
1999,Wellsville,027001,1470,239651,792,494357,734008,03/15/2016
1999,Bolivar-Richburg,027602,813,82760,360,119664,202424,03/15/2016
1999,Binghamton,030200,4823,1012470,3124,2537172,3549642,03/15/2016
1999,Chenango Forks,032001,1983,461699,564,564205,1025904,03/15/2016
1999,South Mountain-Hickory,032201,107,6033,33,9300,15333,03/15/2016
1999,Harpursville,032601,932,144997,283,182225,327222,03/15/2016
1999,Susquehanna Valley,032801,2209,554351,787,822250,1376601,03/15/2016
1999,Chenango Valley,033001,2290,532705,1266,1337060,1869765,03/15/2016
1999,Maine-Endwell,033801,3091,801307,1390,1521158,2322465,03/15/2016
1999,Deposit,034201,587,85026,331,209939,294965,03/15/2016
1999,Whitney Point,034401,1492,216961,472,287486,504447,03/15/2016
1999,Union-Endicott,034601,4947,1313074,2384,2663567,3976641,03/15/2016
1999,Johnson City,034602,2649,617810,1790,1557093,2174903,03/15/2016
1999,Vestal,034801,5189,1183362,1721,1737172,2920534,03/15/2016
1999,Windsor,035001,1849,314220,669,500108,814328,03/15/2016
1999,Olean,041200,2446,394329,1404,791229,1185558,03/15/2016
1999,Salamanca,041600,996,124267,580,212249,336516,03/15/2016
1999,Allegany-Limestone,042001,1278,157518,501,241891,399409,03/15/2016
1999,West Valley,042204,440,64570,151,94496,159066,03/15/2016
1999,Ellicottville,043601,578,64729,244,114934,179663,03/15/2016
1999,Franklinville,044001,711,102219,326,179369,281588,03/15/2016
1999,Hinsdale,044601,491,67555,189,102619,170174,03/15/2016
1999,Little Valley,045401,444,81108,193,134507,215615,03/15/2016
1999,Cattaraugus,046401,731,138359,308,225719,364078,03/15/2016
1999,Gowanda,047201,1250,174054,668,394496,568550,03/15/2016
1999,Portville,047401,910,123147,353,201148,324295,03/15/2016
1999,Randolph,047601,1067,167916,405,252530,420446,03/15/2016
1999,Yorkshire-Pioneer,048401,2488,310882,864,455987,766869,03/15/2016
1999,Auburn,050100,4615,787774,2432,1841176,2628950,03/15/2016
1999,Weedsport,052201,986,176839,343,272964,449803,03/15/2016
1999,Cato-Meridian,052401,1157,148428,276,161913,310341,03/15/2016
1999,Southern Cayuga,053001,1056,137268,400,235506,372774,03/15/2016
1999,Port Byron,053801,1268,209187,446,294734,503921,03/15/2016
1999,Moravia,054201,1181,152055,330,187718,339773,03/15/2016
1999,Union Springs,055401,1106,229416,413,381005,610421,03/15/2016
1999,Dunkirk,060300,2036,371344,1458,1025603,1396947,03/15/2016
1999,Jamestown,060800,4345,759150,2061,1343612,2102762,03/15/2016
1999,Southwestern,062201,2126,410973,808,698643,1109616,03/15/2016
1999,Frewsburg,062401,981,202214,325,301023,503237,03/15/2016
1999,Cassadaga Valley,062601,1256,220101,487,330471,550572,03/15/2016
1999,Chautauqua Lake,062803,1049,117319,459,234658,351977,03/15/2016
1999,Pine Valley,063001,657,132584,250,194924,327508,03/15/2016
1999,Clymer,063201,509,78716,237,166920,245636,03/15/2016
1999,Bemus Point,063601,992,156672,418,319637,476309,03/15/2016
1999,Falconer,063801,1370,239888,559,421034,660922,03/15/2016
1999,Silver Creek,064601,1079,170135,534,367864,537999,03/15/2016
1999,Forestville,064603,695,100317,288,183117,283434,03/15/2016
1999,Panama,064801,727,135996,239,181432,317428,03/15/2016
1999,Fredonia,065801,1669,281318,789,619379,900697,03/15/2016
1999,Brocton,066001,629,129399,281,228411,357810,03/15/2016
1999,Ripley,066201,340,85191,190,170326,255517,03/15/2016
1999,Sherman,066601,447,74274,156,108056,182330,03/15/2016
1999,Westfield,067201,790,155195,398,340758,495953,03/15/2016
1999,Elmira,070400,6650,1263238,3593,2868379,4131617,03/15/2016
1999,Horseheads,073401,4751,772145,1848,1392881,2165026,03/15/2016
1999,Elmira Heights,073402,1057,165572,631,414786,580358,03/15/2016
1999,Norwich,081100,1970,428799,856,678606,1107405,03/15/2016
1999,Afton,082001,740,158683,299,252654,411337,03/15/2016
1999,Bainbridge-Guilford,082201,1016,179137,382,266247,445384,03/15/2016
1999,Greene,083001,1352,247378,413,329499,576877,03/15/2016
1999,Unadilla Valley,083803,984,162026,374,216485,378511,03/15/2016
1999,Georgetown-So Otselic Valley,084401,472,89324,136,91300,180624,03/15/2016
1999,Oxford Academy,084601,944,186419,368,278209,464628,03/15/2016
1999,Sherburne-Earlville,085601,1489,306332,549,439618,745950,03/15/2016
1999,Plattsburgh,091300,1662,334699,763,695765,1030464,03/15/2016
1999,Ausable Valley,092201,1644,214915,680,339654,554569,03/15/2016
1999,Beekmantown,092401,2237,324242,625,367205,691447,03/15/2016
1999,Northeastern Clinton,092801,1703,287481,558,367331,654812,03/15/2016
1999,Chazy,093001,589,90256,191,121968,212224,03/15/2016
1999,Northern Adirondack,093601,1184,139900,416,169933,309833,03/15/2016
1999,Peru,094001,2220,332882,534,335629,668511,03/15/2016
1999,Saranac,094401,2023,321260,610,403880,725140,03/15/2016
1999,Hudson,100600,1736,318339,1128,914843,1233182,03/15/2016
1999,Taconic Hills,102801,1786,303192,830,655421,958613,03/15/2016
1999,Germantown,103602,745,122409,317,239576,361985,03/15/2016
1999,Chatham,103801,1671,245077,564,395257,640334,03/15/2016
1999,Kinderhook,104401,2626,437579,728,549617,987196,03/15/2016
1999,New Lebanon,104801,784,128820,245,180868,309688,03/15/2016
1999,Cortland,110200,2509,396556,1143,846988,1243544,03/15/2016
1999,Cincinnatus,112001,637,93401,203,107057,200458,03/15/2016
1999,Mc Graw,112204,610,93675,218,140653,234328,03/15/2016
1999,Homer,113001,2402,370574,738,516096,886670,03/15/2016
1999,Marathon,113401,779,139520,250,181022,320542,03/15/2016
1999,Andes,122002,203,26477,147,87924,114401,03/15/2016
1999,Downsville,122401,309,33156,194,78777,111933,03/15/2016
1999,Charlotte Valley,122601,488,63095,197,115108,178203,03/15/2016
1999,Delhi,122801,1047,115997,554,286775,402772,03/15/2016
1999,Franklin,123201,378,60620,183,137761,198381,03/15/2016
1999,Hancock,123606,394,76121,239,173706,249827,03/15/2016
1999,Margaretville,124601,580,49361,347,137343,186704,03/15/2016
1999,Roxbury,124802,469,81924,254,192653,274577,03/15/2016
1999,Sidney,125001,1233,270109,680,609513,879622,03/15/2016
1999,Stamford,125201,429,90984,211,190805,281789,03/15/2016
1999,South Kortright,125202,414,67349,213,151930,219279,03/15/2016
1999,Walton,125601,1018,127750,543,299315,427065,03/15/2016
1999,Beacon,130200,2457,464128,972,863263,1327391,03/15/2016
1999,Poughkeepsie,131300,2239,497701,1134,1141921,1639622,03/15/2016
1999,Dover,132602,1197,301557,314,387711,689268,03/15/2016
1999,Hyde Park,133201,4574,1156269,1456,1653664,2809933,03/15/2016
1999,Northeast,133801,779,143368,334,277786,421154,03/15/2016
1999,Pawling,134001,1259,268330,376,393553,661883,03/15/2016
1999,Pine Plains,134201,1465,238333,529,401125,639458,03/15/2016
1999,Arlington,134601,8831,1952810,1836,1934580,3887390,03/15/2016
1999,Spackenkill,134602,1581,306909,433,405098,712007,03/15/2016
1999,Red Hook,134801,1881,426652,597,649563,1076215,03/15/2016
1999,Rhinebeck,135001,1542,291354,516,459746,751100,03/15/2016
1999,Wappingers,135601,12414,2365782,2960,2695494,5061276,03/15/2016
1999,Millbrook,135801,1210,201863,317,260017,461880,03/15/2016
1999,Buffalo,140200,20437,2582398,12496,6428444,9010842,03/15/2016
1999,Lackawanna,140900,1814,147262,1715,584347,731609,03/15/2016
1999,Tonawanda,141600,2685,415681,1447,1042879,1458560,03/15/2016
1999,Alden,142001,2338,430311,780,674328,1104639,03/15/2016
1999,Amherst,142201,4815,999912,1839,1818358,2818270,03/15/2016
1999,Williamsville,142203,13907,2506061,3542,3082920,5588981,03/15/2016
1999,Sweet Home,142207,4645,569599,2157,1288134,1857733,03/15/2016
1999,East Aurora,142401,2447,408708,851,683523,1092231,03/15/2016
1999,Cheektowaga,143001,3137,459577,2111,1356049,1815626,03/15/2016
1999,Cheektowaga-Maryvale,143002,3141,542124,2355,1916226,2458350,03/15/2016
1999,Cleveland Hill,143003,1944,371041,1346,1215968,1587009,03/15/2016
1999,Depew,143007,3086,620860,1279,1218017,1838877,03/15/2016
1999,Cheektowaga-Sloan,143009,1813,375156,1806,1783938,2159094,03/15/2016
1999,Clarence,143201,5002,763448,1464,950226,1713674,03/15/2016
1999,Springville-Griffith,143801,2513,380647,896,612259,992906,03/15/2016
1999,Eden,144001,1985,288259,645,455736,743995,03/15/2016
1999,Iroquois,144201,3494,493337,1187,786636,1279973,03/15/2016
1999,Evans-Brant,144401,3372,562249,1090,859174,1421423,03/15/2016
1999,Grand Island,144601,4036,681789,927,746990,1428779,03/15/2016
1999,Hamburg,144801,4518,789793,1532,1322338,2112131,03/15/2016
1999,Frontier,144804,6064,936396,2206,1537481,2473877,03/15/2016
1999,Holland,145001,1391,185713,360,234793,420506,03/15/2016
1999,Lancaster,145201,7491,1237845,2634,1982397,3220242,03/15/2016
1999,Akron,145601,1650,253487,565,353504,606991,03/15/2016
1999,North Collins,145801,778,158593,325,307967,466560,03/15/2016
1999,Orchard Park,146001,6060,1039687,1645,1362575,2402262,03/15/2016
1999,Kenmore,146401,13000,1984648,7131,5274971,7259619,03/15/2016
1999,West Seneca,146801,10535,1588858,4869,3387306,4976164,03/15/2016
1999,Crown Point,152203,330,45418,178,97709,143127,03/15/2016
1999,Elizabethtown-Lewis,152401,379,51356,180,100985,152341,03/15/2016
1999,Keene,153001,198,22955,86,45475,68430,03/15/2016
1999,Minerva,153401,179,26789,88,59279,86068,03/15/2016
1999,Moriah,153601,796,100114,491,238181,338295,03/15/2016
1999,Newcomb,153801,109,2873,75,8084,10957,03/15/2016
1999,Lake Placid,154002,932,96892,347,159332,256224,03/15/2016
1999,Schroon Lake,154601,356,30712,200,79432,110144,03/15/2016
1999,Ticonderoga,154801,1004,103792,471,204496,308288,03/15/2016
1999,Westport,155001,272,51385,135,114307,165692,03/15/2016
1999,Willsboro,155201,450,59758,272,151039,210797,03/15/2016
1999,Tupper Lake,162001,1123,136063,529,231989,368052,03/15/2016
1999,Chateaugay,163401,546,87142,237,138954,226096,03/15/2016
1999,Salmon River,164201,640,95218,289,167155,262373,03/15/2016
1999,Saranac Lake,164601,1849,220620,651,323604,544224,03/15/2016
1999,Malone,164801,2509,419084,1056,675565,1094649,03/15/2016
1999,Brushton-Moira,165001,768,117770,295,169390,287160,03/15/2016
1999,St. Regis Falls,165401,381,53156,176,87737,140893,03/15/2016
1999,Gloversville,170500,2504,447703,1393,931922,1379625,03/15/2016
1999,Johnstown,170800,1863,347836,852,663578,1011414,03/15/2016
1999,Broadalbin-Perth,172201,1971,231733,711,366017,597750,03/15/2016
1999,Wheelerville,172401,329,46757,123,75935,122692,03/15/2016
1999,Mayfield,173001,1195,194640,450,296949,491589,03/15/2016
1999,Northville,173201,512,62892,276,145965,208857,03/15/2016
1999,Oppenheim-Ephratah,173401,536,75844,175,90211,166055,03/15/2016
1999,Batavia,180200,2579,508964,1271,1128372,1637336,03/15/2016
1999,Alexander,182202,1025,239810,315,332142,571952,03/15/2016
1999,Byron-Bergen,183001,1435,331892,412,392655,724547,03/15/2016
1999,Elba,183401,555,110129,178,165285,275414,03/15/2016
1999,Le Roy,183601,1533,293859,544,475117,768976,03/15/2016
1999,Oakfield-Alabama,183801,989,213766,395,382823,596589,03/15/2016
1999,Pavilion,184001,1055,201200,262,224695,425895,03/15/2016
1999,Pembroke,184202,1289,239543,424,355074,594617,03/15/2016
1999,Cairo-Durham,192401,1452,222707,747,520773,743480,03/15/2016
1999,Catskill,192601,1778,299935,863,670081,970016,03/15/2016
1999,Coxsackie-Athens,192801,1640,231261,609,389973,621234,03/15/2016
1999,Greenville,193201,1541,284272,603,517442,801714,03/15/2016
1999,Hunter-Tannersville,193601,561,74591,288,176530,251121,03/15/2016
1999,Windham-Ashland-Jewett,194601,508,54151,282,138569,192720,03/15/2016
1999,Piseco,202001,78,3503,42,8542,12045,03/15/2016
1999,Indian Lake,202601,280,26487,186,81977,108464,03/15/2016
1999,Inlet,202801,78,2866,43,7811,10677,03/15/2016
1999,Lake Pleasant,203001,167,11742,109,36904,48646,03/15/2016
1999,Long Lake,203201,159,12637,112,39982,52619,03/15/2016
1999,Raquette Lake,203202,22,437,17,1572,2009,03/15/2016
1999,Wells,203601,193,19670,120,55772,75442,03/15/2016
1999,Little Falls,210900,1056,182282,689,469723,652005,03/15/2016
1999,West Canada Valley,212402,860,123013,288,174463,297476,03/15/2016
1999,Frankfort-Schuyler,212602,1176,206021,646,478576,684597,03/15/2016
1999,Ilion,212801,1444,180956,646,359887,540843,03/15/2016
1999,Mohawk,212802,988,153315,439,304695,458010,03/15/2016
1999,Herkimer,213001,1329,228307,861,569988,798295,03/15/2016
1999,Dolgeville,213602,876,108426,428,202470,310896,03/15/2016
1999,Poland,213803,793,120716,282,176940,297656,03/15/2016
1999,Van Hornesville-Owen D. Young,215001,276,55224,114,100693,155917,03/15/2016
1999,Town Of Webb,215401,525,29744,276,72880,102624,03/15/2016
1999,Mount Markham,215601,1299,253310,429,342828,596138,03/15/2016
1999,Watertown,221800,3246,414869,1507,808860,1223729,03/15/2016
1999,South Jefferson,222001,1729,230383,538,284947,515330,03/15/2016
1999,Alexandria,222202,653,76395,291,148071,224466,03/15/2016
1999,Indian River,222401,1292,86512,416,105635,192147,03/15/2016
1999,General Brown,222601,1499,177647,493,252690,430337,03/15/2016
1999,Thousand Islands,223201,1202,178827,575,364124,542951,03/15/2016
1999,Belleville-Henderson,223402,557,52884,266,108360,161244,03/15/2016
1999,Sackets Harbor,223801,457,74152,167,113992,188144,03/15/2016
1999,Lyme,224401,414,55661,223,126517,182178,03/15/2016
1999,La Fargeville,224601,431,57642,162,87711,145353,03/15/2016
1999,Carthage,226001,2002,321653,802,497332,818985,03/15/2016
1999,Copenhagen,232201,467,65737,137,76618,142355,03/15/2016
1999,Harrisville,232401,510,90593,171,94558,185151,03/15/2016
1999,Lowville,233601,1319,165181,551,280156,445337,03/15/2016
1999,South Lewis,234001,1299,163603,585,280112,443715,03/15/2016
1999,Beaver River,234401,1016,105208,339,137063,242271,03/15/2016
1999,Avon,242001,1010,235039,314,324131,559170,03/15/2016
1999,Caledonia-Mumford,242201,1220,196814,356,270635,467449,03/15/2016
1999,Geneseo,242601,1197,204348,314,257516,461864,03/15/2016
1999,Livonia,243401,2314,376278,575,410364,786642,03/15/2016
1999,Mount Morris,243601,523,104268,277,226736,331004,03/15/2016
1999,Dansville,243801,1760,279897,662,447919,727816,03/15/2016
1999,Dalton-Nunda,244001,969,142180,324,192467,334647,03/15/2016
1999,York,245201,1013,161275,299,218109,379384,03/15/2016
1999,Oneida,251200,2377,340975,956,617085,958060,03/15/2016
1999,Brookfield,252009,245,47668,80,54913,102581,03/15/2016
1999,Cazenovia,252201,1983,367477,486,419861,787338,03/15/2016
1999,De Ruyter,252401,467,90898,160,132599,223497,03/15/2016
1999,Morrisville-Eaton,252601,832,147742,252,178768,326510,03/15/2016
1999,Hamilton,253201,752,140651,263,218957,359608,03/15/2016
1999,Canastota,253601,1616,254755,632,440974,695729,03/15/2016
1999,Madison,254001,515,101276,194,155021,256297,03/15/2016
1999,Stockbridge Valley,254601,456,76987,150,100043,177030,03/15/2016
1999,Chittenango,254801,2803,617506,728,670064,1287570,03/15/2016
1999,Rochester,261400,22736,2801377,6439,3530126,6331503,03/15/2016
1999,Brighton,262001,4673,974852,1064,1074856,2049708,03/15/2016
1999,Gates-Chili,262601,6748,1373737,2925,2758545,4132282,03/15/2016
1999,Greece,262801,16039,2972590,5598,4996761,7969351,03/15/2016
1999,East Irondequoit,263401,5030,968961,2937,2688245,3657206,03/15/2016
1999,West Irondequoit,263403,5276,1138776,2191,2316648,3455424,03/15/2016
1999,Honeoye Falls-Lima,263601,2773,537987,515,474120,1012107,03/15/2016
1999,Spencerport,263801,4518,847414,1116,1003929,1851343,03/15/2016
1999,Hilton,264001,5232,956185,1013,890384,1846569,03/15/2016
1999,Penfield,264201,6896,1556359,1507,1650762,3207121,03/15/2016
1999,Fairport,264401,8277,1554159,1776,1589799,3143958,03/15/2016
1999,East Rochester,264413,1410,277789,731,653839,931628,03/15/2016
1999,Pittsford,264601,7446,1469596,1054,1018951,2488547,03/15/2016
1999,Churchville-Chili,264801,4772,993147,1087,1077582,2070729,03/15/2016
1999,Rush-Henrietta,265001,7227,1255669,1984,1627854,2883523,03/15/2016
1999,Brockport,265201,4211,805544,757,673748,1479292,03/15/2016
1999,Webster,265401,10136,1864141,2744,2462516,4326657,03/15/2016
1999,Wheatland-Chili,265601,1138,224587,367,334597,559184,03/15/2016
1999,Amsterdam,270100,3380,583658,2353,1767312,2350970,03/15/2016
1999,Canajoharie,272201,944,191827,495,427273,619100,03/15/2016
1999,Fonda-Fultonville,272801,1484,272274,574,444950,717224,03/15/2016
1999,Fort Plain,273001,784,180475,396,371068,551543,03/15/2016
1999,St. Johnsville,273802,480,97920,300,221415,319335,03/15/2016
1999,Glen Cove,280500,2550,798383,1220,1842100,2640483,03/15/2016
1999,Long Beach,281000,5648,1196243,1180,1236327,2432570,03/15/2016
1999,Hempstead,282001,2235,1097397,577,1329332,2426729,03/15/2016
1999,Uniondale,282002,3943,976290,1020,1211804,2188094,03/15/2016
1999,East Meadow,282003,9497,3213358,3096,4387967,7601325,03/15/2016
1999,North Bellmore,282004,5203,1634667,1262,1920664,3555331,03/15/2016
1999,Levittown,282005,9572,3623943,2413,4422388,8046331,03/15/2016
1999,Seaford,282006,3374,1088415,868,1316810,2405225,03/15/2016
1999,Bellmore,282007,2801,849329,518,754267,1603596,03/15/2016
1999,Roosevelt,282008,1776,625796,426,686951,1312747,03/15/2016
1999,Freeport,282009,4327,1434371,981,1548978,2983349,03/15/2016
1999,Baldwin,282010,6205,2123944,1189,1933045,4056989,03/15/2016
1999,Oceanside,282011,7404,2110186,1793,2444244,4554430,03/15/2016
1999,Malverne,282012,2595,922531,675,1162854,2085385,03/15/2016
1999,Valley Stream 13,282013,5188,1652003,1691,2640391,4292394,03/15/2016
1999,Hewlett-Woodmere,282014,4229,1311475,666,1020781,2332256,03/15/2016
1999,Lawrence,282015,5415,1404885,990,1253021,2657906,03/15/2016
1999,Elmont,282016,6112,1729834,2065,2801073,4530907,03/15/2016
1999,Franklin Square,282017,4262,1147422,1717,2271283,3418705,03/15/2016
1999,Garden City,282018,5081,878498,852,750019,1628517,03/15/2016
1999,East Rockaway,282019,1688,517099,517,751001,1268100,03/15/2016
1999,Lynbrook,282020,3252,1009114,828,1267173,2276287,03/15/2016
1999,Rockville Centre,282021,4174,1149834,697,952136,2101970,03/15/2016
1999,Floral Park-Bellerose,282022,3587,964806,982,1288972,2253778,03/15/2016
1999,Wantagh,282023,3982,1349485,811,1345806,2695291,03/15/2016
1999,Valley Stream 24,282024,2086,593233,700,966498,1559731,03/15/2016
1999,Merrick,282025,4288,1149237,641,846679,1995916,03/15/2016
1999,Island Trees,282026,2872,854408,809,1182964,2037372,03/15/2016
1999,West Hempstead,282027,3123,930737,794,1145374,2076111,03/15/2016
1999,North Merrick,282029,2871,902467,767,1184549,2087016,03/15/2016
1999,Valley Stream 30,282030,2371,644165,866,1136912,1781077,03/15/2016
1999,Island Park,282031,1319,292575,331,347721,640296,03/15/2016
1999,Westbury,282201,2443,842770,714,1183392,2026162,03/15/2016
1999,East Williston,282202,1908,546755,306,436331,983086,03/15/2016
1999,Roslyn,282203,3604,1019110,413,574763,1593873,03/15/2016
1999,Port Washington,282204,4956,1107026,767,841783,1948809,03/15/2016
1999,New Hyde Park-Garden City,282205,3848,863354,1520,1682215,2545569,03/15/2016
1999,Manhasset,282206,3291,620895,412,383829,1004724,03/15/2016
1999,Great Neck,282207,7950,1321146,1209,988757,2309903,03/15/2016
1999,Herricks,282209,5311,1505519,1222,1714926,3220445,03/15/2016
1999,Mineola,282210,3728,879981,1315,1533419,2413400,03/15/2016
1999,Carle Place,282211,1594,365010,518,583161,948171,03/15/2016
1999,North Shore,282401,3097,555379,690,616693,1172072,03/15/2016
1999,Syosset,282402,7043,1813455,1020,1297020,3110475,03/15/2016
1999,Locust Valley,282403,2904,594574,504,507386,1101960,03/15/2016
1999,Plainview-Old Bethpage,282404,6242,1845478,1396,2061425,3906903,03/15/2016
1999,Oyster Bay-East Norwich,282406,2184,413431,445,414101,827532,03/15/2016
1999,Jericho,282415,3001,665742,370,409733,1075475,03/15/2016
1999,Hicksville,282417,6498,1441565,2404,2608934,4050499,03/15/2016
1999,Plainedge,282418,4044,1373580,1239,2091539,3465119,03/15/2016
1999,Bethpage,282421,3511,936718,1362,1487618,2424336,03/15/2016
1999,Farmingdale,282422,7162,2491169,2250,3872453,6363622,03/15/2016
1999,Massapequa,282423,10367,2569845,2555,3151004,5720849,03/15/2016
1999,Lockport,290900,5336,1198347,1859,1796880,2995227,03/15/2016
1999,Niagara Falls,291100,6669,935720,4643,2658596,3594316,03/15/2016
1999,North Tonawanda,291200,5476,1147585,2553,2485284,3632869,03/15/2016
1999,Lewiston-Porter,292401,3445,735607,1305,1358500,2094107,03/15/2016
1999,Newfane,292801,1979,430315,713,723551,1153866,03/15/2016
1999,Niagara-Wheatfield,293001,4042,651201,1468,1061459,1712660,03/15/2016
1999,Starpoint,293201,2766,461506,826,647835,1109341,03/15/2016
1999,Royalton-Hartland,293601,1732,384814,586,613750,998564,03/15/2016
1999,Barker,293801,931,128027,317,190016,318043,03/15/2016
1999,Wilson,294201,1496,285406,559,504541,789947,03/15/2016
1999,Rome,301300,5293,1121281,2774,2399963,3521244,03/15/2016
1999,Utica,301600,6030,1016367,4483,3058733,4075100,03/15/2016
1999,Adirondack,302601,1609,262959,645,393064,656023,03/15/2016
1999,Camden,303001,2461,405255,850,523609,928864,03/15/2016
1999,Clinton,304001,1587,334284,526,524821,859105,03/15/2016
1999,New Hartford,304801,3287,674843,1332,1289173,1964016,03/15/2016
1999,New York Mills,304804,722,150950,580,582141,733091,03/15/2016
1999,Sauquoit Valley,305002,1225,205790,414,305313,511103,03/15/2016
1999,Remsen,305201,640,117244,205,148919,266163,03/15/2016
1999,Waterville,305401,998,182662,353,281959,464621,03/15/2016
1999,Holland Patent,305801,1867,357286,567,462129,819415,03/15/2016
1999,Sherrill,306000,2454,408277,871,642783,1051060,03/15/2016
1999,Westmoreland,306801,1288,282137,525,465158,747295,03/15/2016
1999,Oriskany,307001,838,169024,340,303606,472630,03/15/2016
1999,Whitesboro,307002,4361,888773,1948,1853778,2742551,03/15/2016
1999,Syracuse,311500,13836,1688192,6813,3819433,5507625,03/15/2016
1999,West Genesee,312001,6483,1191116,2582,2218852,3409968,03/15/2016
1999,North Syracuse,312403,11904,2303346,3390,2854429,5157775,03/15/2016
1999,East Syracuse-Minoa,312601,4191,922734,1817,1693434,2616168,03/15/2016
1999,Jamesville-Dewitt,312611,3327,671673,888,840323,1511996,03/15/2016
1999,Jordan-Elbridge,312801,1618,388108,526,496438,884546,03/15/2016
1999,Fabius-Pompey,313001,1015,198361,235,204223,402584,03/15/2016
1999,Westhill,313201,2259,475331,1039,1042115,1517446,03/15/2016
1999,Solvay,313202,1678,316403,1077,940441,1256844,03/15/2016
1999,La Fayette,313407,954,165983,248,194064,360047,03/15/2016
1999,Baldwinsville,313601,6919,1352722,1550,1315516,2668238,03/15/2016
1999,Fayetteville-Manlius,313801,5328,1243041,1178,1312124,2555165,03/15/2016
1999,Marcellus,314001,2390,430710,663,564215,994925,03/15/2016
1999,Onondaga,314201,1258,280472,432,422082,702554,03/15/2016
1999,Liverpool,314801,9634,2171275,2785,2860145,5031420,03/15/2016
1999,Lyncourt,314804,690,98860,519,321839,420699,03/15/2016
1999,Skaneateles,315001,1986,328444,627,489714,818158,03/15/2016
1999,Tully,315402,1194,181816,259,182343,364159,03/15/2016
1999,Canandaigua,320200,3572,615801,1055,860744,1476545,03/15/2016
1999,Geneva,320500,2332,438531,1174,973431,1411962,03/15/2016
1999,East Bloomfield,322601,1185,258490,302,303254,561744,03/15/2016
1999,Gorham-Middlesex,323201,1742,277629,606,435764,713393,03/15/2016
1999,Manchester-Shortsville,323601,1062,258375,391,395022,653397,03/15/2016
1999,Naples,323801,1162,168312,353,235512,403824,03/15/2016
1999,Phelps-Clifton Springs,324001,2072,506840,641,695028,1201868,03/15/2016
1999,Honeoye,324201,1300,193862,363,254374,448236,03/15/2016
1999,Victor,324801,3200,601028,579,499294,1100322,03/15/2016
1999,Middletown,330900,4068,988523,1415,1493858,2482381,03/15/2016
1999,Newburgh,331100,7603,1670326,2683,2625516,4295842,03/15/2016
1999,Port Jervis,331300,2318,532794,935,905567,1438361,03/15/2016
1999,Washingtonville,332002,4282,958333,594,642991,1601324,03/15/2016
1999,Chester,332201,1003,251045,228,269419,520464,03/15/2016
1999,Cornwall,332401,2787,596955,605,620977,1217932,03/15/2016
1999,Pine Bush,332601,4623,1105240,929,1025735,2130975,03/15/2016
1999,Goshen,333001,2418,407443,576,466792,874235,03/15/2016
1999,Highland Falls,333601,663,114098,282,239289,353387,03/15/2016
1999,Minisink Valley,333801,3508,787773,667,695495,1483268,03/15/2016
1999,Monroe-Woodbury,334001,6831,1627414,952,1131791,2759205,03/15/2016
1999,Kiryas Joel Village,334002,449,70616,39,28469,99085,03/15/2016
1999,Valley,334201,4061,795387,1106,1003011,1798398,03/15/2016
1999,Tuxedo,335003,363,36664,103,51361,88025,03/15/2016
1999,Warwick Valley,335401,4018,841156,806,829135,1670291,03/15/2016
1999,Greenwood Lake,335411,1170,273494,277,311469,584963,03/15/2016
1999,Florida,335415,874,188270,253,267069,455339,03/15/2016
1999,Albion,342001,2055,352126,827,629636,981762,03/15/2016
1999,Kendall,343007,1098,205637,244,216759,422396,03/15/2016
1999,Holley,343204,1265,266025,395,346655,612680,03/15/2016
1999,Medina,343401,1750,329848,771,641896,971744,03/15/2016
1999,Lyndonville,343801,772,116127,316,212155,328282,03/15/2016
1999,Fulton,350400,3227,642089,1306,1020670,1662759,03/15/2016
1999,Oswego,351200,4793,866017,1793,1042127,1908144,03/15/2016
1999,Altmar Parish-Williamstown,352002,1310,220354,380,255062,475416,03/15/2016
1999,Hannibal,353001,1433,209467,408,248806,458273,03/15/2016
1999,Central Square,353201,4524,889807,1239,933060,1822867,03/15/2016
1999,Mexico,353401,2319,391105,606,428790,819895,03/15/2016
1999,Pulaski,355001,1016,176041,327,244339,420380,03/15/2016
1999,Sandy Creek,355201,925,151030,374,226889,377919,03/15/2016
1999,Phoenix,355401,2407,470934,621,508626,979560,03/15/2016
1999,Oneonta,361200,2127,453412,901,874082,1327494,03/15/2016
1999,Gilbertsville-Mt Upton,362202,569,80391,226,131432,211823,03/15/2016
1999,Cherry Valley-Springfield,362401,711,94207,365,211942,306149,03/15/2016
1999,Edmeston,362801,499,72051,203,125850,197901,03/15/2016
1999,Laurens,363401,485,93342,173,144811,238153,03/15/2016
1999,Schenevus,363601,487,89688,181,135670,225358,03/15/2016
1999,Milford,364001,563,109329,236,200207,309536,03/15/2016
1999,Morris,364201,472,93877,195,168940,262817,03/15/2016
1999,Otego-Unadilla,364801,1163,220384,513,415080,635464,03/15/2016
1999,Cooperstown,365001,1101,152014,483,314248,466262,03/15/2016
1999,Richfield Springs,365601,674,83722,375,213109,296831,03/15/2016
1999,Worcester,366606,413,69197,207,149403,218600,03/15/2016
1999,Mahopac,372001,4997,1463627,810,1171807,2635434,03/15/2016
1999,Carmel,372002,5148,1695967,869,1394235,3090202,03/15/2016
1999,Haldane,372601,834,218460,275,325348,543808,03/15/2016
1999,Garrison,372604,436,69136,73,57876,127012,03/15/2016
1999,Putnam Valley,372803,1963,648106,325,511582,1159688,03/15/2016
1999,Brewster,373001,3696,1075469,779,1101871,2177340,03/15/2016
1999,Rensselaer,381400,999,229660,422,367737,597397,03/15/2016
1999,Troy,381700,3807,683780,1697,1258322,1942102,03/15/2016
1999,Lansingburgh,381701,2324,496339,1011,906885,1403224,03/15/2016
1999,Berlin,382001,1309,219901,402,309471,529372,03/15/2016
1999,Brunswick,382202,1505,317327,469,445504,762831,03/15/2016
1999,East Greenbush,382401,5429,1124291,1597,1529133,2653424,03/15/2016
1999,Hoosick Falls,382801,1291,195825,564,382825,578650,03/15/2016
1999,North Greenbush,383201,235,16150,122,40827,56977,03/15/2016
1999,Wynantskill,383204,724,134466,311,272339,406805,03/15/2016
1999,Averill Park,384001,3700,665671,960,764394,1430065,03/15/2016
1999,Hoosic Valley,384201,1300,257795,367,303790,561585,03/15/2016
1999,Schodack,384401,1236,273011,351,359236,632247,03/15/2016
1999,Clarkstown,392001,10710,2914050,1682,2258693,5172743,03/15/2016
1999,Nanuet,392008,2102,481868,638,710569,1192437,03/15/2016
1999,Haverstraw-Stony Point,392201,6860,2438361,1699,2407406,4845767,03/15/2016
1999,South Orangetown,392401,3548,934346,1040,1359955,2294301,03/15/2016
1999,Nyack,392404,3302,1192119,825,1496491,2688610,03/15/2016
1999,Pearl River,392408,2702,899512,752,1238919,2138431,03/15/2016
1999,Ramapo,392601,5245,2229326,1075,2065499,4294825,03/15/2016
1999,East Ramapo,392602,10789,4152820,1843,3215375,7368195,03/15/2016
1999,Ogdensburg,401200,1883,335611,776,444056,779667,03/15/2016
1999,Brasher Falls,402001,1047,176270,410,255932,432202,03/15/2016
1999,Canton,402201,1508,285832,431,323741,609573,03/15/2016
1999,Clifton-Fine,402601,465,62809,250,103989,166798,03/15/2016
1999,Colton-Pierrepont,402801,515,73693,190,90886,164579,03/15/2016
1999,Edwards-Knox,403401,625,48530,199,55580,104110,03/15/2016
1999,Gouverneur,404001,1481,218700,623,307576,526276,03/15/2016
1999,Hammond,404201,289,29581,152,59098,88679,03/15/2016
1999,Hermon-Dekalb,404401,442,71017,165,99282,170299,03/15/2016
1999,Lisbon,405002,646,116256,230,158045,274301,03/15/2016
1999,Madrid-Waddington,405601,855,155853,300,208992,364845,03/15/2016
1999,Massena,405801,2967,450718,1389,903782,1354500,03/15/2016
1999,Morristown,406001,542,79861,220,127691,207552,03/15/2016
1999,Norwood-Norfolk,406201,1187,208347,445,272679,481026,03/15/2016
1999,Heuvelton,406404,692,121371,219,140520,261891,03/15/2016
1999,Parishville-Hopkinton,406601,596,73075,163,60689,133764,03/15/2016
1999,Potsdam,407402,1580,281275,556,405131,686406,03/15/2016
1999,Mechanicville,411000,1160,177697,587,435259,612956,03/15/2016
1999,Saratoga Springs,411500,7474,1345964,1679,1369506,2715470,03/15/2016
1999,Burnt Hills-Ballston Lake,412001,4214,845847,1182,1155170,2001017,03/15/2016
1999,Shenendehowa,412402,10532,2135747,1624,1578782,3714529,03/15/2016
1999,Corinth,412601,1188,219015,495,325803,544818,03/15/2016
1999,Edinburg,413001,274,18127,147,41880,60007,03/15/2016
1999,Galway,413201,1338,183947,334,207612,391559,03/15/2016
1999,Ballston Spa,414201,4298,982991,1061,946902,1929893,03/15/2016
1999,South Glens Falls,414401,2854,545172,982,749956,1295128,03/15/2016
1999,Schuylerville,415001,1757,437457,425,477973,915430,03/15/2016
1999,Stillwater,415201,1312,228591,345,280658,509249,03/15/2016
1999,Waterford-Halfmoon,415401,761,184476,498,524411,708887,03/15/2016
1999,Schenectady,421500,6749,1267826,3712,3122152,4389978,03/15/2016
1999,Duanesburg,422001,1036,187516,218,184997,372513,03/15/2016
1999,Scotia-Glenville,422202,3555,781952,1223,1280075,2062027,03/15/2016
1999,Niskayuna,422401,5289,1034472,1042,1000636,2035108,03/15/2016
1999,Schalmont,422801,2869,498565,922,726284,1224849,03/15/2016
1999,Rotterdam-Mohonasen,422803,3920,656533,2192,1619587,2276120,03/15/2016
1999,Cobleskill-Richmondville,432602,2118,273623,738,410772,684395,03/15/2016
1999,Gilboa-Conesville,433401,459,65284,261,148945,214229,03/15/2016
1999,Jefferson,433601,350,47379,142,86331,133710,03/15/2016
1999,Middleburgh,433801,1053,172356,424,311301,483657,03/15/2016
1999,Schoharie,434201,1312,217012,420,309198,526210,03/15/2016
1999,Sharon Springs,434601,386,70059,125,92390,162449,03/15/2016
1999,Odessa-Montour,442001,999,123426,373,192099,315525,03/15/2016
1999,Watkins Glen,442401,1411,201610,660,388670,590280,03/15/2016
1999,South Seneca,452801,1014,143012,489,280144,423156,03/15/2016
1999,Romulus,453003,560,92372,225,162621,254993,03/15/2016
1999,Seneca Falls,453201,1675,310667,812,660833,971500,03/15/2016
1999,Waterloo,453801,1866,264226,784,466406,730632,03/15/2016
1999,Corning,460300,5719,1156300,2295,1898590,3054890,03/15/2016
1999,Hornell,460600,1480,196487,812,414092,610579,03/15/2016
1999,Addison,462001,1142,216025,420,267344,483369,03/15/2016
1999,Avoca,462201,621,100312,231,152227,252539,03/15/2016
1999,Bath,462402,1585,228789,666,415752,644541,03/15/2016
1999,Bradford,462601,336,58502,127,87083,145585,03/15/2016
1999,Campbell-Savona,463002,927,86725,321,126583,213308,03/15/2016
1999,Canisteo,463201,835,150082,388,251169,401251,03/15/2016
1999,Greenwood,464601,222,39823,93,47463,87286,03/15/2016
1999,Arkport,465201,498,81004,220,143979,224983,03/15/2016
1999,Jasper-Troupsburg,465601,434,55890,198,98631,154521,03/15/2016
1999,Prattsburgh,466001,489,60586,199,97357,157943,03/15/2016
1999,Hammondsport,467201,865,112558,398,222668,335226,03/15/2016
1999,Wayland-Cohocton,467401,1751,191269,623,278959,470228,03/15/2016
1999,Babylon,472001,2082,710970,463,749454,1460424,03/15/2016
1999,West Babylon,472002,4307,1408122,1178,1831338,3239460,03/15/2016
1999,North Babylon,472003,4921,1335392,1553,2049347,3384739,03/15/2016
1999,Lindenhurst,472004,6448,2080134,1938,2973133,5053267,03/15/2016
1999,Copiague,472005,3629,1091533,1224,1680919,2772452,03/15/2016
1999,Amityville,472006,2827,902697,851,1207571,2110268,03/15/2016
1999,Deer Park,472007,4144,1327452,1504,2332398,3659850,03/15/2016
1999,Wyandanch,472009,655,184497,202,255607,440104,03/15/2016
1999,Three Village,472201,7209,2034313,1226,1642270,3676583,03/15/2016
1999,Brookhaven-Comsewogue,472203,3420,915533,677,856018,1771551,03/15/2016
1999,South Country,472204,3687,1005135,698,862401,1867536,03/15/2016
1999,Sachem,472205,14608,4093950,2152,2814659,6908609,03/15/2016
1999,Port Jefferson,472206,1292,271118,240,239825,510943,03/15/2016
1999,Mount Sinai,472207,2063,693951,273,442449,1136400,03/15/2016
1999,Miller Place,472208,2650,787242,369,515523,1302765,03/15/2016
1999,Rocky Point,472209,2730,786116,526,666753,1452869,03/15/2016
1999,Middle Country,472211,9062,2276202,1930,2252246,4528448,03/15/2016
1999,Longwood,472212,8478,2667517,2695,3642858,6310375,03/15/2016
1999,South Manor,472221,1403,407975,189,254463,662438,03/15/2016
1999,Patchogue-Medford,472224,7149,1783030,1631,1799770,3582800,03/15/2016
1999,William Floyd,472232,6199,1709846,1275,1483794,3193640,03/15/2016
1999,Center Moriches,472233,1126,347525,287,401124,748649,03/15/2016
1999,East Moriches,472234,895,273886,183,261639,535525,03/15/2016
1999,East Hampton,472401,1303,92752,404,125258,218010,03/15/2016
1999,Wainscott,472402,125,4802,29,5436,10238,03/15/2016
1999,Amagansett,472403,251,12728,104,25858,38586,03/15/2016
1999,Springs,472404,887,110342,288,178327,288669,03/15/2016
1999,Sag Harbor,472405,1124,122651,588,315225,437876,03/15/2016
1999,Montauk,472406,642,35584,267,93885,129469,03/15/2016
1999,Elwood,472601,2695,728802,647,860792,1589594,03/15/2016
1999,Cold Spring Harbor,472602,1825,381405,180,187927,569332,03/15/2016
1999,Huntington,472603,6256,1690365,1534,1977737,3668102,03/15/2016
1999,Northport-East Northport,472604,7722,1612508,1737,1773157,3385665,03/15/2016
1999,Half Hollow Hills,472605,8575,1821661,1376,1316450,3138111,03/15/2016
1999,Harborfields,472606,4018,1039326,824,1042213,2081539,03/15/2016
1999,Commack,472610,8267,2124873,1801,2317547,4442420,03/15/2016
1999,South Huntington,472613,7189,2043261,2087,2869636,4912897,03/15/2016
1999,Bay Shore,472801,4399,1360593,1151,1730231,3090824,03/15/2016
1999,Islip,472802,3309,869771,674,869480,1739251,03/15/2016
1999,East Islip,472803,4927,1497670,1039,1649384,3147054,03/15/2016
1999,Sayville,472804,3530,1124421,822,1279596,2404017,03/15/2016
1999,Bayport-Blue Point,472805,2522,864284,496,812407,1676691,03/15/2016
1999,Hauppauge,472806,4279,706344,884,720829,1427173,03/15/2016
1999,Connetquot,472807,7348,2077692,1383,1842511,3920203,03/15/2016
1999,West Islip,472809,5440,1624907,1344,1958105,3583012,03/15/2016
1999,Brentwood,472812,7212,2203360,2312,3437907,5641267,03/15/2016
1999,Central Islip,472813,4109,1615356,845,1544568,3159924,03/15/2016
1999,Fire Island,472814,84,2523,27,4051,6574,03/15/2016
1999,Shoreham-Wading River,473001,2362,606878,661,748224,1355102,03/15/2016
1999,Riverhead,473002,4631,1119691,2473,2191657,3311348,03/15/2016
1999,Shelter Island,473201,482,33580,262,90702,124282,03/15/2016
1999,Smithtown,473401,11457,3165459,2350,3091970,6257429,03/15/2016
1999,Kings Park,473405,4595,1123151,908,1103054,2226205,03/15/2016
1999,Remsenburg-Speonk,473601,356,33339,83,38410,71749,03/15/2016
1999,Westhampton Beach,473602,698,71429,240,116751,188180,03/15/2016
1999,Quogue,473603,210,8936,54,11643,20579,03/15/2016
1999,Hampton Bays,473605,1651,271739,805,633611,905350,03/15/2016
1999,Southhampton,473606,1575,123036,634,240747,363783,03/15/2016
1999,Bridgehampton,473609,277,20486,100,35604,56090,03/15/2016
1999,Sagaponack,473610,76,1513,8,698,2211,03/15/2016
1999,Eastport,473611,1326,453322,494,643550,1096872,03/15/2016
1999,Tuckahoe Common,473613,410,44594,174,93210,137804,03/15/2016
1999,East Quogue,473617,821,164170,283,249997,414167,03/15/2016
1999,Oysterponds,473802,299,27497,221,100867,128364,03/15/2016
1999,Fishers Island,473804,40,3385,16,6579,9964,03/15/2016
1999,Southold,473805,1184,180815,681,510239,691054,03/15/2016
1999,Greenport,473810,478,94557,354,336775,431332,03/15/2016
1999,Mattituck-Cutchogue,473812,1817,325672,794,699678,1025350,03/15/2016
1999,New Suffolk,473815,58,4595,49,18887,23482,03/15/2016
1999,Fallsburg,482801,911,209289,416,417697,626986,03/15/2016
1999,Eldred,483401,768,102091,388,240563,342654,03/15/2016
1999,Liberty,483601,1191,238809,554,512203,751012,03/15/2016
1999,Tri-Valley,484201,1075,206760,342,234485,441245,03/15/2016
1999,Roscoe,484401,293,40927,203,123898,164825,03/15/2016
1999,Livingston Manor,484402,517,79082,254,171314,250396,03/15/2016
1999,Monticello,484601,2544,442609,1139,923847,1366456,03/15/2016
1999,Sullivan West,484802,1821,278829,934,652076,930905,03/15/2016
1999,Waverly,492001,1401,199308,636,345779,545087,03/15/2016
1999,Candor,492401,832,132403,307,200097,332500,03/15/2016
1999,Newark Valley,492602,1377,258057,451,357189,615246,03/15/2016
1999,Owego-Apalachin,493001,2565,565299,926,834392,1399691,03/15/2016
1999,Spencer-Van Etten,493401,1047,138559,337,177061,315620,03/15/2016
1999,Tioga,493603,1020,147367,322,192104,339471,03/15/2016
1999,Ithaca,500700,6522,1290107,1651,1420159,2710266,03/15/2016
1999,Dryden,502401,2111,455789,435,359482,815271,03/15/2016
1999,Groton,502801,1109,199464,269,192643,392107,03/15/2016
1999,Lansing,503201,1239,243337,316,273960,517297,03/15/2016
1999,Newfield,503401,824,165282,227,150480,315762,03/15/2016
1999,Trumansburg,503601,1328,254336,409,327231,581567,03/15/2016
1999,Kingston,510800,7213,1383782,3169,2716879,4100661,03/15/2016
1999,Highland,513203,1873,419477,542,557863,977340,03/15/2016
1999,Rondout Valley,513401,3067,706307,1014,1028647,1734954,03/15/2016
1999,Marlboro,513601,1790,272930,546,387562,660492,03/15/2016
1999,New Paltz,513801,2651,570927,663,698406,1269333,03/15/2016
1999,Onteora,514001,2896,520978,1156,926058,1447036,03/15/2016
1999,Saugerties,514801,3590,648327,1301,1083291,1731618,03/15/2016
1999,Wallkill,515201,2997,716627,862,772935,1489562,03/15/2016
1999,Ellenville,515602,1900,352029,619,546985,899014,03/15/2016
1999,Glens Falls,520500,2302,377973,910,676332,1054305,03/15/2016
1999,Bolton,522001,142,25932,149,54077,80009,03/15/2016
1999,Lake George,522201,1197,113925,440,200900,314825,03/15/2016
1999,North Warren,522402,840,80511,412,176173,256684,03/15/2016
1999,Johnsburg,523001,412,60428,239,141906,202334,03/15/2016
1999,Hadley-Luzerne,523201,1036,153276,494,292970,446246,03/15/2016
1999,Queensbury,523402,3533,553947,939,668429,1222376,03/15/2016
1999,Glens Falls Common,523418,200,22386,113,55133,77519,03/15/2016
1999,Warrensburg,524001,977,179916,398,316279,496195,03/15/2016
1999,Argyle,532001,730,101461,245,144852,246313,03/15/2016
1999,Fort Ann,532802,651,98493,181,124192,222685,03/15/2016
1999,Fort Edward,533001,420,70135,234,178080,248215,03/15/2016
1999,Granville,533201,1189,208084,464,349303,557387,03/15/2016
1999,Greenwich,533401,1169,203711,475,394892,598603,03/15/2016
1999,Hartford,533801,609,104582,156,121813,226395,03/15/2016
1999,Hudson Falls,534401,2172,394072,978,772254,1166326,03/15/2016
1999,Putnam,534601,135,14628,45,22084,36712,03/15/2016
1999,Salem,534801,685,111631,282,197630,309261,03/15/2016
1999,Cambridge,535010,1031,174867,453,344087,518954,03/15/2016
1999,Whitehall,535201,745,122639,411,277545,400184,03/15/2016
1999,Newark,542001,2469,484558,962,835845,1320403,03/15/2016
1999,Clyde-Savannah,542401,986,162265,436,303607,465872,03/15/2016
1999,Lyons,542801,1059,190339,438,299033,489372,03/15/2016
1999,Gananda,543002,1065,206871,77,70901,277772,03/15/2016
1999,Marion,543201,1169,237116,265,253496,490612,03/15/2016
1999,Wayne,543401,2995,450630,548,393938,844568,03/15/2016
1999,Palmyra-Macedon,543601,2322,496056,571,544309,1040365,03/15/2016
1999,Sodus,544201,1431,317465,516,468247,785712,03/15/2016
1999,Williamson,544602,1364,260712,351,314575,575287,03/15/2016
1999,North Rose-Wolcott,544801,1659,268208,656,429763,697971,03/15/2016
1999,Red Creek,544803,1039,120517,359,169627,290144,03/15/2016
1999,Mount Vernon,550800,3642,2153360,1733,4246271,6399631,03/15/2016
1999,New Rochelle,551000,6553,3866109,1729,4565580,8431689,03/15/2016
1999,Peekskill,551200,2300,1178657,760,1387351,2566008,03/15/2016
1999,Rye,551400,2537,826548,428,664849,1491397,03/15/2016
1999,White Plains,551700,5341,3130197,1319,2996604,6126801,03/15/2016
1999,Yonkers,551800,16845,5913443,6811,10858852,16772295,03/15/2016
1999,Katonah-Lewisboro,552001,3923,2003652,504,1204144,3207796,03/15/2016
1999,Bedford,552002,3902,1399584,711,1163845,2563429,03/15/2016
1999,Croton-Harmon,552202,1677,911146,322,755001,1666147,03/15/2016
1999,Hendrick Hudson,552203,2691,1129189,564,906545,2035734,03/15/2016
1999,Eastchester,552401,2633,1393054,810,1822961,3216015,03/15/2016
1999,Tuckahoe,552402,991,461826,278,571424,1033250,03/15/2016
1999,Bronxville,552403,1399,584000,150,283580,867580,03/15/2016
1999,Tarrytowns,552601,1661,959064,486,1252449,2211513,03/15/2016
1999,Irvington,552602,1369,724473,231,600331,1324804,03/15/2016
1999,Dobbs Ferry,552603,1034,711962,238,755699,1467661,03/15/2016
1999,Hastings On Hudson,552604,1080,762651,321,997412,1760063,03/15/2016
1999,Ardsley,552605,1959,1024792,372,948152,1972944,03/15/2016
1999,Edgemont,552606,1218,753130,138,381039,1134169,03/15/2016
1999,Greenburgh,552607,2794,1517970,929,2064708,3582678,03/15/2016
1999,Elmsford,552609,900,387361,352,712555,1099916,03/15/2016
1999,Harrison,552801,2851,879107,745,1048493,1927600,03/15/2016
1999,Mamaroneck,553201,3925,1721057,718,1508277,3229334,03/15/2016
1999,Mount Pleasant,553401,2469,1002422,636,1244484,2246906,03/15/2016
1999,Pocantico Hills,553402,364,73192,89,78075,151267,03/15/2016
1999,Valhalla,553405,1408,653939,401,910065,1564004,03/15/2016
1999,Pleasantville,553409,1644,852921,319,774125,1627046,03/15/2016
1999,Chappaqua,553604,3791,1848390,228,539528,2387918,03/15/2016
1999,Byram Hills,553801,2368,876714,228,420534,1297248,03/15/2016
1999,North Salem,554001,1592,642291,235,413292,1055583,03/15/2016
1999,Ossining,554201,4557,2530592,909,2166488,4697080,03/15/2016
1999,Briarcliff Manor,554202,1427,732720,130,319846,1052566,03/15/2016
1999,Pelham,554401,1897,826331,413,848884,1675215,03/15/2016
1999,Rye Neck,554801,1249,544675,349,759683,1304358,03/15/2016
1999,Port Chester-Rye,554804,2137,1008186,1235,2522541,3530727,03/15/2016
1999,Blind Brook-Rye,554805,1237,524404,210,437906,962310,03/15/2016
1999,Scarsdale,555001,3982,1578757,257,506201,2084958,03/15/2016
1999,Somers,555201,3615,1376813,1044,1863693,3240506,03/15/2016
1999,Lakeland,555401,6866,3236354,1644,2776692,6013046,03/15/2016
1999,Yorktown,555402,4408,2258069,605,1466070,3724139,03/15/2016
1999,Attica,562201,2144,293681,618,405389,699070,03/15/2016
1999,Letchworth,562601,1264,193365,381,244430,437795,03/15/2016
1999,Wyoming,563802,436,59271,96,61534,120805,03/15/2016
1999,Perry,564201,1190,190703,457,334691,525394,03/15/2016
1999,Warsaw,564801,1291,252006,425,385359,637365,03/15/2016
1999,Penn Yan,573001,2340,319111,1143,696806,1015917,03/15/2016
1999,Dundee,573401,965,119889,417,217655,337544,03/15/2016
1999,New York City School,650000,319683,21677515,113557,38231907,59909422,03/15/2016
1998,Albany,010100,,,4040,3496672,3496672,03/15/2016
1998,Cohoes,010300,,,836,675943,675943,03/15/2016
1998,Watervliet,011800,,,628,460325,460325,03/15/2016
1998,Berne-Knox-Westerlo,012001,,,314,227235,227235,03/15/2016
1998,Bethlehem,012206,,,1235,1127181,1127181,03/15/2016
1998,Ravena-Coeymans-Selkirk,012402,,,713,588174,588174,03/15/2016
1998,South Colonie,012601,,,2835,1814954,1814954,03/15/2016
1998,North Colonie,012605,,,1714,1113701,1113701,03/15/2016
1998,Menands,012615,,,120,61307,61307,03/15/2016
1998,Maplewood,012622,,,73,33548,33548,03/15/2016
1998,Green Island,012801,,,134,130754,130754,03/15/2016
1998,Guilderland,013002,,,1398,1240376,1240376,03/15/2016
1998,Voorheesville,013403,,,363,343611,343611,03/15/2016
1998,Alfred-Almond,022001,,,248,167362,167362,03/15/2016
1998,Andover,023001,,,148,107040,107040,03/15/2016
1998,Genesee Valley,023202,,,299,129970,129970,03/15/2016
1998,Belfast,023401,,,153,74772,74772,03/15/2016
1998,Canaseraga,024002,,,128,83346,83346,03/15/2016
1998,Cuba-Rushford,024801,,,451,187242,187242,03/15/2016
1998,Friendship,025001,,,142,78180,78180,03/15/2016
1998,Fillmore,025801,,,234,124816,124816,03/15/2016
1998,Whitesville,026001,,,72,50854,50854,03/15/2016
1998,Scio,026601,,,191,141815,141815,03/15/2016
1998,Wellsville,027001,,,706,405298,405298,03/15/2016
1998,Bolivar-Richburg,027602,,,322,101355,101355,03/15/2016
1998,Binghamton,030200,,,2942,2337802,2337802,03/15/2016
1998,Chenango Forks,032001,,,533,524533,524533,03/15/2016
1998,South Mountain-Hickory,032201,,,28,8834,8834,03/15/2016
1998,Harpursville,032601,,,242,154274,154274,03/15/2016
1998,Susquehanna Valley,032801,,,732,704042,704042,03/15/2016
1998,Chenango Valley,033001,,,1195,1243855,1243855,03/15/2016
1998,Maine-Endwell,033801,,,1300,1391120,1391120,03/15/2016
1998,Deposit,034201,,,215,182658,182658,03/15/2016
1998,Whitney Point,034401,,,423,248063,248063,03/15/2016
1998,Union-Endicott,034601,,,2218,2479190,2479190,03/15/2016
1998,Johnson City,034602,,,1723,1431534,1431534,03/15/2016
1998,Vestal,034801,,,1565,1526921,1526921,03/15/2016
1998,Windsor,035001,,,627,448198,448198,03/15/2016
1998,Olean,041200,,,1266,684556,684556,03/15/2016
1998,Salamanca,041600,,,541,179183,179183,03/15/2016
1998,Allegany-Limestone,042001,,,461,213550,213550,03/15/2016
1998,West Valley,042204,,,137,80433,80433,03/15/2016
1998,Ellicottville,043601,,,224,104353,104353,03/15/2016
1998,Franklinville,044001,,,279,133501,133501,03/15/2016
1998,Hinsdale,044601,,,183,93178,93178,03/15/2016
1998,Little Valley,045401,,,170,106377,106377,03/15/2016
1998,Cattaraugus,046401,,,273,191615,191615,03/15/2016
1998,Gowanda,047201,,,630,357844,357844,03/15/2016
1998,Portville,047401,,,308,170447,170447,03/15/2016
1998,Randolph,047601,,,378,225455,225455,03/15/2016
1998,Yorkshire-Pioneer,048401,,,800,416981,416981,03/15/2016
1998,Auburn,050100,,,2230,1657399,1657399,03/15/2016
1998,Weedsport,052201,,,295,240646,240646,03/15/2016
1998,Cato-Meridian,052401,,,233,129211,129211,03/15/2016
1998,Southern Cayuga,053001,,,335,197752,197752,03/15/2016
1998,Port Byron,053801,,,383,242531,242531,03/15/2016
1998,Moravia,054201,,,297,157965,157965,03/15/2016
1998,Union Springs,055401,,,352,299883,299883,03/15/2016
1998,Dunkirk,060300,,,1390,960138,960138,03/15/2016
1998,Jamestown,060800,,,1900,1230403,1230403,03/15/2016
1998,Southwestern,062201,,,735,615994,615994,03/15/2016
1998,Frewsburg,062401,,,291,257086,257086,03/15/2016
1998,Cassadaga Valley,062601,,,434,293614,293614,03/15/2016
1998,Chautauqua Lake,062803,,,403,213510,213510,03/15/2016
1998,Pine Valley,063001,,,237,182479,182479,03/15/2016
1998,Clymer,063201,,,206,136535,136535,03/15/2016
1998,Bemus Point,063601,,,390,293697,293697,03/15/2016
1998,Falconer,063801,,,521,356360,356360,03/15/2016
1998,Silver Creek,064601,,,493,316821,316821,03/15/2016
1998,Forestville,064603,,,267,165869,165869,03/15/2016
1998,Panama,064801,,,221,172093,172093,03/15/2016
1998,Fredonia,065801,,,714,529584,529584,03/15/2016
1998,Brocton,066001,,,253,197631,197631,03/15/2016
1998,Ripley,066201,,,173,153737,153737,03/15/2016
1998,Sherman,066601,,,134,90941,90941,03/15/2016
1998,Westfield,067201,,,359,272375,272375,03/15/2016
1998,Elmira,070400,,,3382,2353593,2353593,03/15/2016
1998,Horseheads,073401,,,1693,1139060,1139060,03/15/2016
1998,Elmira Heights,073402,,,586,336964,336964,03/15/2016
1998,Norwich,081100,,,775,628994,628994,03/15/2016
1998,Afton,082001,,,259,212219,212219,03/15/2016
1998,Bainbridge-Guilford,082201,,,363,249274,249274,03/15/2016
1998,Greene,083001,,,386,299102,299102,03/15/2016
1998,Unadilla Valley,083803,,,308,178248,178248,03/15/2016
1998,Georgetown-So Otselic Valley,084401,,,122,78499,78499,03/15/2016
1998,Oxford Academy,084601,,,324,229488,229488,03/15/2016
1998,Sherburne-Earlville,085601,,,485,370280,370280,03/15/2016
1998,Plattsburgh,091300,,,701,617099,617099,03/15/2016
1998,Ausable Valley,092201,,,600,286907,286907,03/15/2016
1998,Beekmantown,092401,,,526,295114,295114,03/15/2016
1998,Northeastern Clinton,092801,,,516,332841,332841,03/15/2016
1998,Chazy,093001,,,169,106575,106575,03/15/2016
1998,Northern Adirondack,093601,,,359,147935,147935,03/15/2016
1998,Peru,094001,,,446,274031,274031,03/15/2016
1998,Saranac,094401,,,547,345326,345326,03/15/2016
1998,Hudson,100600,,,1049,803095,803095,03/15/2016
1998,Taconic Hills,102801,,,749,569234,569234,03/15/2016
1998,Germantown,103602,,,309,213110,213110,03/15/2016
1998,Chatham,103801,,,509,333350,333350,03/15/2016
1998,Kinderhook,104401,,,674,486649,486649,03/15/2016
1998,New Lebanon,104801,,,209,153571,153571,03/15/2016
1998,Cortland,110200,,,1077,770297,770297,03/15/2016
1998,Cincinnatus,112001,,,194,102804,102804,03/15/2016
1998,Mc Graw,112204,,,186,119202,119202,03/15/2016
1998,Homer,113001,,,674,451578,451578,03/15/2016
1998,Marathon,113401,,,238,161290,161290,03/15/2016
1998,Andes,122002,,,125,69578,69578,03/15/2016
1998,Downsville,122401,,,160,61596,61596,03/15/2016
1998,Charlotte Valley,122601,,,175,94496,94496,03/15/2016
1998,Delhi,122801,,,504,245259,245259,03/15/2016
1998,Franklin,123201,,,167,120410,120410,03/15/2016
1998,Hancock,123606,,,201,140405,140405,03/15/2016
1998,Margaretville,124601,,,292,111461,111461,03/15/2016
1998,Roxbury,124802,,,203,131869,131869,03/15/2016
1998,Sidney,125001,,,627,542391,542391,03/15/2016
1998,Stamford,125201,,,175,149907,149907,03/15/2016
1998,South Kortright,125202,,,189,123807,123807,03/15/2016
1998,Walton,125601,,,474,251815,251815,03/15/2016
1998,Beacon,130200,,,884,744663,744663,03/15/2016
1998,Poughkeepsie,131300,,,1028,1002468,1002468,03/15/2016
1998,Dover,132602,,,277,302588,302588,03/15/2016
1998,Hyde Park,133201,,,1295,1390297,1390297,03/15/2016
1998,Northeast,133801,,,314,260937,260937,03/15/2016
1998,Pawling,134001,,,339,359508,359508,03/15/2016
1998,Pine Plains,134201,,,488,368577,368577,03/15/2016
1998,Arlington,134601,,,1701,1733193,1733193,03/15/2016
1998,Spackenkill,134602,,,389,361264,361264,03/15/2016
1998,Red Hook,134801,,,562,597352,597352,03/15/2016
1998,Rhinebeck,135001,,,458,404748,404748,03/15/2016
1998,Wappingers,135601,,,2605,2358802,2358802,03/15/2016
1998,Millbrook,135801,,,304,242825,242825,03/15/2016
1998,Buffalo,140200,,,11417,5985286,5985286,03/15/2016
1998,Lackawanna,140900,,,1655,574836,574836,03/15/2016
1998,Tonawanda,141600,,,1381,955387,955387,03/15/2016
1998,Alden,142001,,,747,603992,603992,03/15/2016
1998,Amherst,142201,,,1721,1615083,1615083,03/15/2016
1998,Williamsville,142203,,,3187,2778682,2778682,03/15/2016
1998,Sweet Home,142207,,,1991,1183669,1183669,03/15/2016
1998,East Aurora,142401,,,807,623710,623710,03/15/2016
1998,Cheektowaga,143001,,,2044,1246237,1246237,03/15/2016
1998,Cheektowaga-Maryvale,143002,,,2261,1831119,1831119,03/15/2016
1998,Cleveland Hill,143003,,,1326,1137405,1137405,03/15/2016
1998,Depew,143007,,,1202,1006596,1006596,03/15/2016
1998,Cheektowaga-Sloan,143009,,,1746,1579757,1579757,03/15/2016
1998,Clarence,143201,,,1329,819838,819838,03/15/2016
1998,Springville-Griffith,143801,,,829,539185,539185,03/15/2016
1998,Eden,144001,,,612,413804,413804,03/15/2016
1998,Iroquois,144201,,,1099,719831,719831,03/15/2016
1998,Evans-Brant,144401,,,1046,759649,759649,03/15/2016
1998,Grand Island,144601,,,867,655336,655336,03/15/2016
1998,Hamburg,144801,,,1423,1189914,1189914,03/15/2016
1998,Frontier,144804,,,2093,1371258,1371258,03/15/2016
1998,Holland,145001,,,325,205120,205120,03/15/2016
1998,Lancaster,145201,,,2498,1863027,1863027,03/15/2016
1998,Akron,145601,,,522,321545,321545,03/15/2016
1998,North Collins,145801,,,303,268210,268210,03/15/2016
1998,Orchard Park,146001,,,1470,1122484,1122484,03/15/2016
1998,Kenmore,146401,,,6809,4990710,4990710,03/15/2016
1998,West Seneca,146801,,,4691,3146463,3146463,03/15/2016
1998,Crown Point,152203,,,144,76742,76742,03/15/2016
1998,Elizabethtown-Lewis,152401,,,158,92299,92299,03/15/2016
1998,Keene,153001,,,63,27283,27283,03/15/2016
1998,Minerva,153401,,,84,53334,53334,03/15/2016
1998,Moriah,153601,,,429,199446,199446,03/15/2016
1998,Newcomb,153801,,,68,7034,7034,03/15/2016
1998,Lake Placid,154002,,,318,138100,138100,03/15/2016
1998,Schroon Lake,154601,,,178,68759,68759,03/15/2016
1998,Ticonderoga,154801,,,416,178563,178563,03/15/2016
1998,Westport,155001,,,125,105217,105217,03/15/2016
1998,Willsboro,155201,,,219,107167,107167,03/15/2016
1998,Tupper Lake,162001,,,472,188812,188812,03/15/2016
1998,Chateaugay,163401,,,207,119861,119861,03/15/2016
1998,Salmon River,164201,,,242,138485,138485,03/15/2016
1998,Saranac Lake,164601,,,584,276365,276365,03/15/2016
1998,Malone,164801,,,924,612028,612028,03/15/2016
1998,Brushton-Moira,165001,,,255,143575,143575,03/15/2016
1998,St. Regis Falls,165401,,,143,74299,74299,03/15/2016
1998,Gloversville,170500,,,1328,850508,850508,03/15/2016
1998,Johnstown,170800,,,768,524005,524005,03/15/2016
1998,Broadalbin-Perth,172201,,,646,302789,302789,03/15/2016
1998,Wheelerville,172401,,,109,64377,64377,03/15/2016
1998,Mayfield,173001,,,378,255376,255376,03/15/2016
1998,Northville,173201,,,239,118252,118252,03/15/2016
1998,Oppenheim-Ephratah,173401,,,162,81457,81457,03/15/2016
1998,Batavia,180200,,,1182,1033182,1033182,03/15/2016
1998,Alexander,182202,,,280,291670,291670,03/15/2016
1998,Byron-Bergen,183001,,,396,341610,341610,03/15/2016
1998,Elba,183401,,,172,163724,163724,03/15/2016
1998,Le Roy,183601,,,499,429832,429832,03/15/2016
1998,Oakfield-Alabama,183801,,,360,320711,320711,03/15/2016
1998,Pavilion,184001,,,237,192021,192021,03/15/2016
1998,Pembroke,184202,,,361,282100,282100,03/15/2016
1998,Cairo-Durham,192401,,,631,423728,423728,03/15/2016
1998,Catskill,192601,,,770,592057,592057,03/15/2016
1998,Coxsackie-Athens,192801,,,543,355221,355221,03/15/2016
1998,Greenville,193201,,,569,472158,472158,03/15/2016
1998,Hunter-Tannersville,193601,,,258,149403,149403,03/15/2016
1998,Windham-Ashland-Jewett,194601,,,233,109715,109715,03/15/2016
1998,Piseco,202001,,,35,7250,7250,03/15/2016
1998,Indian Lake,202601,,,166,70344,70344,03/15/2016
1998,Inlet,202801,,,39,7044,7044,03/15/2016
1998,Lake Pleasant,203001,,,91,30215,30215,03/15/2016
1998,Long Lake,203201,,,98,32439,32439,03/15/2016
1998,Raquette Lake,203202,,,13,1216,1216,03/15/2016
1998,Wells,203601,,,94,40321,40321,03/15/2016
1998,Little Falls,210900,,,638,422736,422736,03/15/2016
1998,West Canada Valley,212402,,,252,145158,145158,03/15/2016
1998,Frankfort-Schuyler,212602,,,552,416016,416016,03/15/2016
1998,Ilion,212801,,,613,333787,333787,03/15/2016
1998,Mohawk,212802,,,422,282862,282862,03/15/2016
1998,Herkimer,213001,,,799,505030,505030,03/15/2016
1998,Dolgeville,213602,,,372,159506,159506,03/15/2016
1998,Poland,213803,,,255,150691,150691,03/15/2016
1998,Van Hornesville-Owen D. Young,215001,,,101,86260,86260,03/15/2016
1998,Town Of Webb,215401,,,254,60354,60354,03/15/2016
1998,Mount Markham,215601,,,400,303689,303689,03/15/2016
1998,Watertown,221800,,,1402,737897,737897,03/15/2016
1998,South Jefferson,222001,,,466,238904,238904,03/15/2016
1998,Alexandria,222202,,,259,136812,136812,03/15/2016
1998,Indian River,222401,,,355,87272,87272,03/15/2016
1998,General Brown,222601,,,429,214926,214926,03/15/2016
1998,Thousand Islands,223201,,,507,317714,317714,03/15/2016
1998,Belleville-Henderson,223402,,,232,91999,91999,03/15/2016
1998,Sackets Harbor,223801,,,146,103083,103083,03/15/2016
1998,Lyme,224401,,,177,101389,101389,03/15/2016
1998,La Fargeville,224601,,,134,71803,71803,03/15/2016
1998,Carthage,226001,,,761,456369,456369,03/15/2016
1998,Copenhagen,232201,,,108,59831,59831,03/15/2016
1998,Harrisville,232401,,,156,82740,82740,03/15/2016
1998,Lowville,233601,,,492,245597,245597,03/15/2016
1998,South Lewis,234001,,,521,256788,256788,03/15/2016
1998,Beaver River,234401,,,302,117850,117850,03/15/2016
1998,Avon,242001,,,284,266113,266113,03/15/2016
1998,Caledonia-Mumford,242201,,,334,239461,239461,03/15/2016
1998,Geneseo,242601,,,286,227137,227137,03/15/2016
1998,Livonia,243401,,,529,368749,368749,03/15/2016
1998,Mount Morris,243601,,,261,210669,210669,03/15/2016
1998,Dansville,243801,,,617,419298,419298,03/15/2016
1998,Dalton-Nunda,244001,,,290,164479,164479,03/15/2016
1998,York,245201,,,281,197016,197016,03/15/2016
1998,Oneida,251200,,,873,524355,524355,03/15/2016
1998,Brookfield,252009,,,70,44093,44093,03/15/2016
1998,Cazenovia,252201,,,429,364210,364210,03/15/2016
1998,De Ruyter,252401,,,142,46569,46569,03/15/2016
1998,Morrisville-Eaton,252601,,,211,142529,142529,03/15/2016
1998,Hamilton,253201,,,232,186033,186033,03/15/2016
1998,Canastota,253601,,,556,386889,386889,03/15/2016
1998,Madison,254001,,,166,126968,126968,03/15/2016
1998,Stockbridge Valley,254601,,,144,89986,89986,03/15/2016
1998,Chittenango,254801,,,657,598747,598747,03/15/2016
1998,Rochester,261400,,,6214,3309771,3309771,03/15/2016
1998,Brighton,262001,,,874,850228,850228,03/15/2016
1998,Gates-Chili,262601,,,2678,2480750,2480750,03/15/2016
1998,Greece,262801,,,5106,4392669,4392669,03/15/2016
1998,East Irondequoit,263401,,,2757,2524949,2524949,03/15/2016
1998,West Irondequoit,263403,,,2088,2195951,2195951,03/15/2016
1998,Honeoye Falls-Lima,263601,,,478,426720,426720,03/15/2016
1998,Spencerport,263801,,,1020,784977,784977,03/15/2016
1998,Hilton,264001,,,926,796074,796074,03/15/2016
1998,Penfield,264201,,,1360,1469452,1469452,03/15/2016
1998,Fairport,264401,,,1581,1381570,1381570,03/15/2016
1998,East Rochester,264413,,,688,606033,606033,03/15/2016
1998,Pittsford,264601,,,914,859356,859356,03/15/2016
1998,Churchville-Chili,264801,,,1017,957909,957909,03/15/2016
1998,Rush-Henrietta,265001,,,1764,1410157,1410157,03/15/2016
1998,Brockport,265201,,,716,622904,622904,03/15/2016
1998,Webster,265401,,,2401,2054030,2054030,03/15/2016
1998,Wheatland-Chili,265601,,,337,290835,290835,03/15/2016
1998,Amsterdam,270100,,,2062,1499393,1499393,03/15/2016
1998,Canajoharie,272201,,,446,376388,376388,03/15/2016
1998,Fonda-Fultonville,272801,,,497,342305,342305,03/15/2016
1998,Fort Plain,273001,,,351,293347,293347,03/15/2016
1998,St. Johnsville,273802,,,251,187190,187190,03/15/2016
1998,Glen Cove,280500,,,960,1458541,1458541,03/15/2016
1998,Long Beach,281000,,,745,761238,761238,03/15/2016
1998,Hempstead,282001,,,474,987973,987973,03/15/2016
1998,Uniondale,282002,,,871,1009232,1009232,03/15/2016
1998,East Meadow,282003,,,2210,3460295,3460295,03/15/2016
1998,North Bellmore,282004,,,1027,1514120,1514120,03/15/2016
1998,Levittown,282005,,,2052,3415274,3415274,03/15/2016
1998,Seaford,282006,,,681,1036122,1036122,03/15/2016
1998,Bellmore,282007,,,422,575100,575100,03/15/2016
1998,Roosevelt,282008,,,337,506734,506734,03/15/2016
1998,Freeport,282009,,,784,1240888,1240888,03/15/2016
1998,Baldwin,282010,,,924,1459466,1459466,03/15/2016
1998,Oceanside,282011,,,1412,1866947,1866947,03/15/2016
1998,Malverne,282012,,,561,934395,934395,03/15/2016
1998,Valley Stream 13,282013,,,1337,2000255,2000255,03/15/2016
1998,Hewlett-Woodmere,282014,,,472,671578,671578,03/15/2016
1998,Lawrence,282015,,,680,838553,838553,03/15/2016
1998,Elmont,282016,,,1664,2181934,2181934,03/15/2016
1998,Franklin Square,282017,,,1368,1776736,1776736,03/15/2016
1998,Garden City,282018,,,586,499112,499112,03/15/2016
1998,East Rockaway,282019,,,374,521309,521309,03/15/2016
1998,Lynbrook,282020,,,615,901064,901064,03/15/2016
1998,Rockville Centre,282021,,,512,634020,634020,03/15/2016
1998,Floral Park-Bellerose,282022,,,801,1011747,1011747,03/15/2016
1998,Wantagh,282023,,,655,1045860,1045860,03/15/2016
1998,Valley Stream 24,282024,,,574,761314,761314,03/15/2016
1998,Merrick,282025,,,510,649365,649365,03/15/2016
1998,Island Trees,282026,,,662,909526,909526,03/15/2016
1998,West Hempstead,282027,,,663,922098,922098,03/15/2016
1998,North Merrick,282029,,,595,899705,899705,03/15/2016
1998,Valley Stream 30,282030,,,715,932536,932536,03/15/2016
1998,Island Park,282031,,,254,254420,254420,03/15/2016
1998,Westbury,282201,,,541,852235,852235,03/15/2016
1998,East Williston,282202,,,217,293275,293275,03/15/2016
1998,Roslyn,282203,,,304,382229,382229,03/15/2016
1998,Port Washington,282204,,,535,563170,563170,03/15/2016
1998,New Hyde Park-Garden City,282205,,,1272,1338314,1338314,03/15/2016
1998,Manhasset,282206,,,295,268380,268380,03/15/2016
1998,Great Neck,282207,,,757,591149,591149,03/15/2016
1998,Herricks,282209,,,922,1253643,1253643,03/15/2016
1998,Mineola,282210,,,1057,1186012,1186012,03/15/2016
1998,Carle Place,282211,,,404,429827,429827,03/15/2016
1998,North Shore,282401,,,530,461637,461637,03/15/2016
1998,Syosset,282402,,,798,980470,980470,03/15/2016
1998,Locust Valley,282403,,,366,349504,349504,03/15/2016
1998,Plainview-Old Bethpage,282404,,,1105,1572886,1572886,03/15/2016
1998,Oyster Bay-East Norwich,282406,,,325,279431,279431,03/15/2016
1998,Jericho,282415,,,266,285128,285128,03/15/2016
1998,Hicksville,282417,,,1975,2089050,2089050,03/15/2016
1998,Plainedge,282418,,,1042,1712472,1712472,03/15/2016
1998,Bethpage,282421,,,1024,1147727,1147727,03/15/2016
1998,Farmingdale,282422,,,1818,2955403,2955403,03/15/2016
1998,Massapequa,282423,,,2040,2312473,2312473,03/15/2016
1998,Lockport,290900,,,1758,1599148,1599148,03/15/2016
1998,Niagara Falls,291100,,,4296,2298553,2298553,03/15/2016
1998,North Tonawanda,291200,,,2472,2186102,2186102,03/15/2016
1998,Lewiston-Porter,292401,,,1206,1124980,1124980,03/15/2016
1998,Newfane,292801,,,648,627828,627828,03/15/2016
1998,Niagara-Wheatfield,293001,,,1302,888401,888401,03/15/2016
1998,Starpoint,293201,,,774,563852,563852,03/15/2016
1998,Royalton-Hartland,293601,,,512,517827,517827,03/15/2016
1998,Barker,293801,,,287,154321,154321,03/15/2016
1998,Wilson,294201,,,513,439088,439088,03/15/2016
1998,Rome,301300,,,2627,2263518,2263518,03/15/2016
1998,Utica,301600,,,4309,2973900,2973900,03/15/2016
1998,Adirondack,302601,,,588,354045,354045,03/15/2016
1998,Camden,303001,,,764,462988,462988,03/15/2016
1998,Clinton,304001,,,496,451523,451523,03/15/2016
1998,New Hartford,304801,,,1307,1209901,1209901,03/15/2016
1998,New York Mills,304804,,,547,551573,551573,03/15/2016
1998,Sauquoit Valley,305002,,,391,289153,289153,03/15/2016
1998,Remsen,305201,,,184,134743,134743,03/15/2016
1998,Waterville,305401,,,334,255261,255261,03/15/2016
1998,Holland Patent,305801,,,529,424720,424720,03/15/2016
1998,Sherrill,306000,,,843,586478,586478,03/15/2016
1998,Westmoreland,306801,,,465,393613,393613,03/15/2016
1998,Oriskany,307001,,,298,256144,256144,03/15/2016
1998,Whitesboro,307002,,,1804,1707367,1707367,03/15/2016
1998,Syracuse,311500,,,6701,3821842,3821842,03/15/2016
1998,West Genesee,312001,,,2391,2000543,2000543,03/15/2016
1998,North Syracuse,312403,,,3076,2481996,2481996,03/15/2016
1998,East Syracuse-Minoa,312601,,,1645,1503606,1503606,03/15/2016
1998,Jamesville-Dewitt,312611,,,755,691336,691336,03/15/2016
1998,Jordan-Elbridge,312801,,,475,410351,410351,03/15/2016
1998,Fabius-Pompey,313001,,,217,182642,182642,03/15/2016
1998,Westhill,313201,,,964,946887,946887,03/15/2016
1998,Solvay,313202,,,1014,889544,889544,03/15/2016
1998,La Fayette,313407,,,234,176273,176273,03/15/2016
1998,Baldwinsville,313601,,,1394,1169773,1169773,03/15/2016
1998,Fayetteville-Manlius,313801,,,1007,1053183,1053183,03/15/2016
1998,Marcellus,314001,,,603,484970,484970,03/15/2016
1998,Onondaga,314201,,,411,384733,384733,03/15/2016
1998,Liverpool,314801,,,2577,2592071,2592071,03/15/2016
1998,Lyncourt,314804,,,491,290215,290215,03/15/2016
1998,Skaneateles,315001,,,568,429682,429682,03/15/2016
1998,Tully,315402,,,233,160062,160062,03/15/2016
1998,Canandaigua,320200,,,937,712097,712097,03/15/2016
1998,Geneva,320500,,,1056,836689,836689,03/15/2016
1998,East Bloomfield,322601,,,277,267360,267360,03/15/2016
1998,Gorham-Middlesex,323201,,,522,355084,355084,03/15/2016
1998,Manchester-Shortsville,323601,,,367,345925,345925,03/15/2016
1998,Naples,323801,,,302,186220,186220,03/15/2016
1998,Phelps-Clifton Springs,324001,,,569,602272,602272,03/15/2016
1998,Honeoye,324201,,,294,194318,194318,03/15/2016
1998,Victor,324801,,,510,416543,416543,03/15/2016
1998,Middletown,330900,,,1311,1262978,1262978,03/15/2016
1998,Newburgh,331100,,,2397,2275530,2275530,03/15/2016
1998,Port Jervis,331300,,,850,775152,775152,03/15/2016
1998,Washingtonville,332002,,,539,554212,554212,03/15/2016
1998,Chester,332201,,,189,210783,210783,03/15/2016
1998,Cornwall,332401,,,527,521311,521311,03/15/2016
1998,Pine Bush,332601,,,800,784900,784900,03/15/2016
1998,Goshen,333001,,,533,418884,418884,03/15/2016
1998,Highland Falls,333601,,,263,224148,224148,03/15/2016
1998,Minisink Valley,333801,,,611,622206,622206,03/15/2016
1998,Monroe-Woodbury,334001,,,875,944484,944484,03/15/2016
1998,Kiryas Joel Village,334002,,,31,22509,22509,03/15/2016
1998,Valley,334201,,,1014,863839,863839,03/15/2016
1998,Tuxedo,335003,,,88,44198,44198,03/15/2016
1998,Warwick Valley,335401,,,700,705653,705653,03/15/2016
1998,Greenwood Lake,335411,,,251,278666,278666,03/15/2016
1998,Florida,335415,,,217,222032,222032,03/15/2016
1998,Albion,342001,,,748,542837,542837,03/15/2016
1998,Kendall,343007,,,208,176240,176240,03/15/2016
1998,Holley,343204,,,341,290039,290039,03/15/2016
1998,Medina,343401,,,700,492346,492346,03/15/2016
1998,Lyndonville,343801,,,274,177805,177805,03/15/2016
1998,Fulton,350400,,,1184,866105,866105,03/15/2016
1998,Oswego,351200,,,1603,585156,585156,03/15/2016
1998,Altmar Parish-Williamstown,352002,,,338,224296,224296,03/15/2016
1998,Hannibal,353001,,,354,208298,208298,03/15/2016
1998,Central Square,353201,,,1065,809652,809652,03/15/2016
1998,Mexico,353401,,,524,367549,367549,03/15/2016
1998,Pulaski,355001,,,308,221270,221270,03/15/2016
1998,Sandy Creek,355201,,,335,204311,204311,03/15/2016
1998,Phoenix,355401,,,559,426232,426232,03/15/2016
1998,Oneonta,361200,,,782,736858,736858,03/15/2016
1998,Gilbertsville-Mt Upton,362202,,,202,113692,113692,03/15/2016
1998,Cherry Valley-Springfield,362401,,,315,171212,171212,03/15/2016
1998,Edmeston,362801,,,164,97336,97336,03/15/2016
1998,Laurens,363401,,,157,127068,127068,03/15/2016
1998,Schenevus,363601,,,166,120475,120475,03/15/2016
1998,Milford,364001,,,212,174598,174598,03/15/2016
1998,Morris,364201,,,171,147364,147364,03/15/2016
1998,Otego-Unadilla,364801,,,454,297367,297367,03/15/2016
1998,Cooperstown,365001,,,437,278069,278069,03/15/2016
1998,Richfield Springs,365601,,,321,181519,181519,03/15/2016
1998,Worcester,366606,,,183,114627,114627,03/15/2016
1998,Mahopac,372001,,,733,1030863,1030863,03/15/2016
1998,Carmel,372002,,,801,1246176,1246176,03/15/2016
1998,Haldane,372601,,,247,285930,285930,03/15/2016
1998,Garrison,372604,,,74,56869,56869,03/15/2016
1998,Putnam Valley,372803,,,303,445120,445120,03/15/2016
1998,Brewster,373001,,,745,1019105,1019105,03/15/2016
1998,Rensselaer,381400,,,418,371546,371546,03/15/2016
1998,Troy,381700,,,1642,1240113,1240113,03/15/2016
1998,Lansingburgh,381701,,,978,852387,852387,03/15/2016
1998,Berlin,382001,,,362,264591,264591,03/15/2016
1998,Brunswick,382202,,,426,385645,385645,03/15/2016
1998,East Greenbush,382401,,,1532,1416290,1416290,03/15/2016
1998,Hoosick Falls,382801,,,496,308207,308207,03/15/2016
1998,North Greenbush,383201,,,110,37627,37627,03/15/2016
1998,Wynantskill,383204,,,300,263782,263782,03/15/2016
1998,Averill Park,384001,,,875,597582,597582,03/15/2016
1998,Hoosic Valley,384201,,,352,276826,276826,03/15/2016
1998,Schodack,384401,,,333,323323,323323,03/15/2016
1998,Clarkstown,392001,,,1431,1878865,1878865,03/15/2016
1998,Nanuet,392008,,,547,539935,539935,03/15/2016
1998,Haverstraw-Stony Point,392201,,,1424,1910281,1910281,03/15/2016
1998,South Orangetown,392401,,,874,1054102,1054102,03/15/2016
1998,Nyack,392404,,,726,1278098,1278098,03/15/2016
1998,Pearl River,392408,,,610,878325,878325,03/15/2016
1998,Ramapo,392601,,,931,1747622,1747622,03/15/2016
1998,East Ramapo,392602,,,1564,2728521,2728521,03/15/2016
1998,Ogdensburg,401200,,,764,424598,424598,03/15/2016
1998,Brasher Falls,402001,,,389,231669,231669,03/15/2016
1998,Canton,402201,,,400,280730,280730,03/15/2016
1998,Clifton-Fine,402601,,,215,90084,90084,03/15/2016
1998,Colton-Pierrepont,402801,,,169,79331,79331,03/15/2016
1998,Edwards-Knox,403401,,,189,54154,54154,03/15/2016
1998,Gouverneur,404001,,,566,273920,273920,03/15/2016
1998,Hammond,404201,,,135,54660,54660,03/15/2016
1998,Hermon-Dekalb,404401,,,164,103775,103775,03/15/2016
1998,Lisbon,405002,,,203,137764,137764,03/15/2016
1998,Madrid-Waddington,405601,,,272,188071,188071,03/15/2016
1998,Massena,405801,,,1285,789259,789259,03/15/2016
1998,Morristown,406001,,,200,113467,113467,03/15/2016
1998,Norwood-Norfolk,406201,,,418,249310,249310,03/15/2016
1998,Heuvelton,406404,,,211,133249,133249,03/15/2016
1998,Parishville-Hopkinton,406601,,,150,54202,54202,03/15/2016
1998,Potsdam,407402,,,505,336224,336224,03/15/2016
1998,Mechanicville,411000,,,583,428795,428795,03/15/2016
1998,Saratoga Springs,411500,,,1565,1212294,1212294,03/15/2016
1998,Burnt Hills-Ballston Lake,412001,,,1101,1033159,1033159,03/15/2016
1998,Shenendehowa,412402,,,1435,1351612,1351612,03/15/2016
1998,Corinth,412601,,,467,293923,293923,03/15/2016
1998,Edinburg,413001,,,132,42671,42671,03/15/2016
1998,Galway,413201,,,308,183271,183271,03/15/2016
1998,Ballston Spa,414201,,,968,849054,849054,03/15/2016
1998,South Glens Falls,414401,,,886,670284,670284,03/15/2016
1998,Schuylerville,415001,,,406,420845,420845,03/15/2016
1998,Stillwater,415201,,,316,253043,253043,03/15/2016
1998,Waterford-Halfmoon,415401,,,446,490820,490820,03/15/2016
1998,Schenectady,421500,,,3575,3021431,3021431,03/15/2016
1998,Duanesburg,422001,,,189,149000,149000,03/15/2016
1998,Scotia-Glenville,422202,,,1172,1198456,1198456,03/15/2016
1998,Niskayuna,422401,,,916,872061,872061,03/15/2016
1998,Schalmont,422801,,,803,600742,600742,03/15/2016
1998,Rotterdam-Mohonasen,422803,,,1961,1424662,1424662,03/15/2016
1998,Cobleskill-Richmondville,432602,,,670,348417,348417,03/15/2016
1998,Gilboa-Conesville,433401,,,230,128742,128742,03/15/2016
1998,Jefferson,433601,,,118,66068,66068,03/15/2016
1998,Middleburgh,433801,,,382,278247,278247,03/15/2016
1998,Schoharie,434201,,,393,271342,271342,03/15/2016
1998,Sharon Springs,434601,,,108,74966,74966,03/15/2016
1998,Odessa-Montour,442001,,,307,130226,130226,03/15/2016
1998,Watkins Glen,442401,,,555,320475,320475,03/15/2016
1998,South Seneca,452801,,,422,226948,226948,03/15/2016
1998,Romulus,453003,,,202,142385,142385,03/15/2016
1998,Seneca Falls,453201,,,750,566584,566584,03/15/2016
1998,Waterloo,453801,,,689,372945,372945,03/15/2016
1998,Corning,460300,,,2093,1652570,1652570,03/15/2016
1998,Hornell,460600,,,793,375276,375276,03/15/2016
1998,Addison,462001,,,355,200625,200625,03/15/2016
1998,Avoca,462201,,,208,136571,136571,03/15/2016
1998,Bath,462402,,,570,333348,333348,03/15/2016
1998,Bradford,462601,,,105,72928,72928,03/15/2016
1998,Campbell-Savona,463002,,,268,101439,101439,03/15/2016
1998,Canisteo,463201,,,355,214205,214205,03/15/2016
1998,Greenwood,464601,,,80,36563,36563,03/15/2016
1998,Arkport,465201,,,200,125910,125910,03/15/2016
1998,Jasper-Troupsburg,465601,,,159,74256,74256,03/15/2016
1998,Prattsburgh,466001,,,185,82862,82862,03/15/2016
1998,Hammondsport,467201,,,372,193821,193821,03/15/2016
1998,Wayland-Cohocton,467401,,,551,248279,248279,03/15/2016
1998,Babylon,472001,,,439,688794,688794,03/15/2016
1998,West Babylon,472002,,,1152,1844029,1844029,03/15/2016
1998,North Babylon,472003,,,1477,1868742,1868742,03/15/2016
1998,Lindenhurst,472004,,,1881,2920494,2920494,03/15/2016
1998,Copiague,472005,,,1160,1529074,1529074,03/15/2016
1998,Amityville,472006,,,773,1063856,1063856,03/15/2016
1998,Deer Park,472007,,,1445,2157158,2157158,03/15/2016
1998,Wyandanch,472009,,,211,270478,270478,03/15/2016
1998,Three Village,472201,,,1105,1439474,1439474,03/15/2016
1998,Brookhaven-Comsewogue,472203,,,596,716247,716247,03/15/2016
1998,South Country,472204,,,658,791949,791949,03/15/2016
1998,Sachem,472205,,,1925,2372479,2372479,03/15/2016
1998,Port Jefferson,472206,,,203,203182,203182,03/15/2016
1998,Mount Sinai,472207,,,283,455245,455245,03/15/2016
1998,Miller Place,472208,,,323,432283,432283,03/15/2016
1998,Rocky Point,472209,,,491,586741,586741,03/15/2016
1998,Middle Country,472211,,,1760,1916889,1916889,03/15/2016
1998,Longwood,472212,,,2443,3134094,3134094,03/15/2016
1998,South Manor,472221,,,146,208215,208215,03/15/2016
1998,Patchogue-Medford,472224,,,1537,1650796,1650796,03/15/2016
1998,William Floyd,472232,,,1165,1250511,1250511,03/15/2016
1998,Center Moriches,472233,,,232,313789,313789,03/15/2016
1998,East Moriches,472234,,,162,220221,220221,03/15/2016
1998,East Hampton,472401,,,281,94143,94143,03/15/2016
1998,Wainscott,472402,,,22,3933,3933,03/15/2016
1998,Amagansett,472403,,,74,17683,17683,03/15/2016
1998,Springs,472404,,,237,142794,142794,03/15/2016
1998,Sag Harbor,472405,,,545,274606,274606,03/15/2016
1998,Montauk,472406,,,203,65362,65362,03/15/2016
1998,Elwood,472601,,,602,789527,789527,03/15/2016
1998,Cold Spring Harbor,472602,,,145,151584,151584,03/15/2016
1998,Huntington,472603,,,1385,1767407,1767407,03/15/2016
1998,Northport-East Northport,472604,,,1574,1571535,1571535,03/15/2016
1998,Half Hollow Hills,472605,,,1160,1131635,1131635,03/15/2016
1998,Harborfields,472606,,,751,935509,935509,03/15/2016
1998,Commack,472610,,,1656,2077172,2077172,03/15/2016
1998,South Huntington,472613,,,1965,2674370,2674370,03/15/2016
1998,Bay Shore,472801,,,1093,1598731,1598731,03/15/2016
1998,Islip,472802,,,604,803869,803869,03/15/2016
1998,East Islip,472803,,,975,1536264,1536264,03/15/2016
1998,Sayville,472804,,,788,1195447,1195447,03/15/2016
1998,Bayport-Blue Point,472805,,,469,755370,755370,03/15/2016
1998,Hauppauge,472806,,,787,645482,645482,03/15/2016
1998,Connetquot,472807,,,1290,1710121,1710121,03/15/2016
1998,West Islip,472809,,,1260,1835286,1835286,03/15/2016
1998,Brentwood,472812,,,2195,3479613,3479613,03/15/2016
1998,Central Islip,472813,,,800,1394369,1394369,03/15/2016
1998,Fire Island,472814,,,22,3424,3424,03/15/2016
1998,Shoreham-Wading River,473001,,,555,506573,506573,03/15/2016
1998,Riverhead,473002,,,2353,1970644,1970644,03/15/2016
1998,Shelter Island,473201,,,232,79315,79315,03/15/2016
1998,Smithtown,473401,,,2207,2825897,2825897,03/15/2016
1998,Kings Park,473405,,,838,992679,992679,03/15/2016
1998,Remsenburg-Speonk,473601,,,78,35774,35774,03/15/2016
1998,Westhampton Beach,473602,,,207,97439,97439,03/15/2016
1998,Quogue,473603,,,44,8268,8268,03/15/2016
1998,Hampton Bays,473605,,,753,597032,597032,03/15/2016
1998,Southhampton,473606,,,572,219630,219630,03/15/2016
1998,Bridgehampton,473609,,,94,36337,36337,03/15/2016
1998,Sagaponack,473610,,,11,1000,1000,03/15/2016
1998,Eastport,473611,,,412,475782,475782,03/15/2016
1998,Tuckahoe Common,473613,,,166,81744,81744,03/15/2016
1998,East Quogue,473617,,,270,231430,231430,03/15/2016
1998,Oysterponds,473802,,,196,90216,90216,03/15/2016
1998,Fishers Island,473804,,,9,3734,3734,03/15/2016
1998,Southold,473805,,,612,451231,451231,03/15/2016
1998,Greenport,473810,,,297,284422,284422,03/15/2016
1998,Mattituck-Cutchogue,473812,,,697,556747,556747,03/15/2016
1998,New Suffolk,473815,,,43,17667,17667,03/15/2016
1998,Jeffersonville-Youngsville,482201,,,362,313081,313081,03/15/2016
1998,Delaware Valley,482601,,,244,144532,144532,03/15/2016
1998,Fallsburg,482801,,,340,324693,324693,03/15/2016
1998,Eldred,483401,,,347,203296,203296,03/15/2016
1998,Liberty,483601,,,458,383888,383888,03/15/2016
1998,Tri-Valley,484201,,,293,193785,193785,03/15/2016
1998,Roscoe,484401,,,182,117119,117119,03/15/2016
1998,Livingston Manor,484402,,,236,156984,156984,03/15/2016
1998,Monticello,484601,,,968,709056,709056,03/15/2016
1998,Narrowsburg,484801,,,229,154716,154716,03/15/2016
1998,Waverly,492001,,,589,297978,297978,03/15/2016
1998,Candor,492401,,,263,162409,162409,03/15/2016
1998,Newark Valley,492602,,,417,307037,307037,03/15/2016
1998,Owego-Apalachin,493001,,,836,768829,768829,03/15/2016
1998,Spencer-Van Etten,493401,,,324,164715,164715,03/15/2016
1998,Tioga,493603,,,287,168228,168228,03/15/2016
1998,Ithaca,500700,,,1603,1318011,1318011,03/15/2016
1998,Dryden,502401,,,402,329734,329734,03/15/2016
1998,Groton,502801,,,267,181038,181038,03/15/2016
1998,Lansing,503201,,,293,246445,246445,03/15/2016
1998,Newfield,503401,,,206,137328,137328,03/15/2016
1998,Trumansburg,503601,,,361,288402,288402,03/15/2016
1998,Kingston,510800,,,2813,2375665,2375665,03/15/2016
1998,Highland,513203,,,504,519721,519721,03/15/2016
1998,Rondout Valley,513401,,,888,852504,852504,03/15/2016
1998,Marlboro,513601,,,497,325425,325425,03/15/2016
1998,New Paltz,513801,,,571,586225,586225,03/15/2016
1998,Onteora,514001,,,1033,772134,772134,03/15/2016
1998,Saugerties,514801,,,1161,925085,925085,03/15/2016
1998,Wallkill,515201,,,780,670268,670268,03/15/2016
1998,Ellenville,515602,,,522,454365,454365,03/15/2016
1998,Glens Falls,520500,,,861,616516,616516,03/15/2016
1998,Bolton,522001,,,127,44693,44693,03/15/2016
1998,Lake George,522201,,,397,172153,172153,03/15/2016
1998,North Warren,522402,,,366,151950,151950,03/15/2016
1998,Johnsburg,523001,,,194,116119,116119,03/15/2016
1998,Hadley-Luzerne,523201,,,435,253568,253568,03/15/2016
1998,Queensbury,523402,,,841,560968,560968,03/15/2016
1998,Glens Falls Common,523418,,,108,50765,50765,03/15/2016
1998,Warrensburg,524001,,,378,282210,282210,03/15/2016
1998,Argyle,532001,,,233,135105,135105,03/15/2016
1998,Fort Ann,532802,,,154,106085,106085,03/15/2016
1998,Fort Edward,533001,,,214,160448,160448,03/15/2016
1998,Granville,533201,,,443,316744,316744,03/15/2016
1998,Greenwich,533401,,,429,340971,340971,03/15/2016
1998,Hartford,533801,,,128,95736,95736,03/15/2016
1998,Hudson Falls,534401,,,912,687402,687402,03/15/2016
1998,Putnam,534601,,,42,19213,19213,03/15/2016
1998,Salem,534801,,,248,164444,164444,03/15/2016
1998,Cambridge,535010,,,416,297044,297044,03/15/2016
1998,Whitehall,535201,,,358,228563,228563,03/15/2016
1998,Newark,542001,,,853,700583,700583,03/15/2016
1998,Clyde-Savannah,542401,,,396,250907,250907,03/15/2016
1998,Lyons,542801,,,385,257378,257378,03/15/2016
1998,Gananda,543002,,,77,69430,69430,03/15/2016
1998,Marion,543201,,,243,225122,225122,03/15/2016
1998,Wayne,543401,,,488,346307,346307,03/15/2016
1998,Palmyra-Macedon,543601,,,513,462838,462838,03/15/2016
1998,Sodus,544201,,,465,420092,420092,03/15/2016
1998,Williamson,544602,,,309,263755,263755,03/15/2016
1998,North Rose-Wolcott,544801,,,582,376285,376285,03/15/2016
1998,Red Creek,544803,,,310,143533,143533,03/15/2016
1998,Mount Vernon,550800,,,1596,3902954,3902954,03/15/2016
1998,New Rochelle,551000,,,1631,3907774,3907774,03/15/2016
1998,Peekskill,551200,,,636,1484212,1484212,03/15/2016
1998,Rye,551400,,,338,557715,557715,03/15/2016
1998,White Plains,551700,,,1160,2383098,2383098,03/15/2016
1998,Yonkers,551800,,,5923,9486669,9486669,03/15/2016
1998,Katonah-Lewisboro,552001,,,463,1016871,1016871,03/15/2016
1998,Bedford,552002,,,669,1044207,1044207,03/15/2016
1998,Croton-Harmon,552202,,,297,639148,639148,03/15/2016
1998,Hendrick Hudson,552203,,,539,817921,817921,03/15/2016
1998,Eastchester,552401,,,779,1577706,1577706,03/15/2016
1998,Tuckahoe,552402,,,261,488118,488118,03/15/2016
1998,Bronxville,552403,,,142,262128,262128,03/15/2016
1998,Tarrytowns,552601,,,456,1053040,1053040,03/15/2016
1998,Irvington,552602,,,206,485610,485610,03/15/2016
1998,Dobbs Ferry,552603,,,212,620630,620630,03/15/2016
1998,Hastings On Hudson,552604,,,304,869265,869265,03/15/2016
1998,Ardsley,552605,,,326,784923,784923,03/15/2016
1998,Edgemont,552606,,,120,302068,302068,03/15/2016
1998,Greenburgh,552607,,,820,1697188,1697188,03/15/2016
1998,Elmsford,552609,,,314,559878,559878,03/15/2016
1998,Harrison,552801,,,677,836810,836810,03/15/2016
1998,Mamaroneck,553201,,,695,1329685,1329685,03/15/2016
1998,Mount Pleasant,553401,,,625,1115778,1115778,03/15/2016
1998,Pocantico Hills,553402,,,84,68849,68849,03/15/2016
1998,Valhalla,553405,,,380,784687,784687,03/15/2016
1998,Pleasantville,553409,,,297,712340,712340,03/15/2016
1998,Chappaqua,553604,,,203,456254,456254,03/15/2016
1998,Byram Hills,553801,,,204,333888,333888,03/15/2016
1998,North Salem,554001,,,222,356983,356983,03/15/2016
1998,Ossining,554201,,,836,1832852,1832852,03/15/2016
1998,Briarcliff Manor,554202,,,110,243154,243154,03/15/2016
1998,Pelham,554401,,,378,806119,806119,03/15/2016
1998,Rye Neck,554801,,,337,647439,647439,03/15/2016
1998,Port Chester-Rye,554804,,,1151,2156054,2156054,03/15/2016
1998,Blind Brook-Rye,554805,,,189,344012,344012,03/15/2016
1998,Scarsdale,555001,,,209,372746,372746,03/15/2016
1998,Somers,555201,,,881,1481333,1481333,03/15/2016
1998,Lakeland,555401,,,1457,2385364,2385364,03/15/2016
1998,Yorktown,555402,,,521,1199571,1199571,03/15/2016
1998,Attica,562201,,,538,344224,344224,03/15/2016
1998,Letchworth,562601,,,354,222819,222819,03/15/2016
1998,Wyoming,563802,,,95,53589,53589,03/15/2016
1998,Perry,564201,,,426,282501,282501,03/15/2016
1998,Warsaw,564801,,,409,363053,363053,03/15/2016
1998,Penn Yan,573001,,,979,598140,598140,03/15/2016
1998,Dundee,573401,,,359,181845,181845,03/15/2016
1998,New York City School,650000,,,99003,31797998,31797998,03/15/2016
