Levy Year,County,County Code,Number of Basic Exemptions,Amount of Basic Reimbursement,Number of Enhanced Exemptions,Amount of  Enhanced Reimbursement,Total Amount of Reimbursement ,Data Preparation Date
2019,Albany,01,38952,21482412,11828,14441123,35923535,04/22/2020
2019,Allegany,02,6734,3566146,3518,3609225,7175371,04/22/2020
2019,Broome,03,25751,17495819,12264,18022602,35518421,04/22/2020
2019,Cattaraugus,04,11423,4984600,5564,4736080,9720680,04/22/2020
2019,Cayuga,05,11108,5673022,4888,5474895,11147917,04/22/2020
2019,Chautauqua,06,18170,9795024,9526,10570512,20365536,04/22/2020
2019,Chemung,07,11959,6764421,5571,6804550,13568971,04/22/2020
2019,Chenango,08,7346,3743274,3412,3635007,7378281,04/22/2020
2019,Clinton,09,11260,6253199,4757,5544320,11797519,04/22/2020
2019,Columbia,10,8418,3739777,3346,3239629,6979406,04/22/2020
2019,Cortland,11,5950,3154171,2798,3246941,6401112,04/22/2020
2019,Delaware,12,6484,2522519,3732,3119554,5642073,04/22/2020
2019,Dutchess,13,39423,28837038,11630,18507578,47344616,04/22/2020
2019,Erie,14,129839,60329048,50078,52693746,113022794,04/22/2020
2019,Essex,15,5246,1878128,2835,2080719,3958847,04/22/2020
2019,Franklin,16,6623,2700427,2925,2483306,5183733,04/22/2020
2019,Fulton,17,7800,3959747,3908,4077166,8036913,04/22/2020
2019,Genesee,18,9215,5861041,3709,5127038,10988079,04/22/2020
2019,Greene,19,6272,2767205,3113,2909686,5676891,04/22/2020
2019,Hamilton,20,894,183627,571,256690,440317,04/22/2020
2019,Herkimer,21,9243,5191004,4422,5102724,10293728,04/22/2020
2019,Jefferson,22,13163,3465816,5105,2961183,6426999,04/22/2020
2019,Lewis,23,4514,1374053,1893,1252230,2626283,04/22/2020
2019,Livingston,24,9278,5535419,3783,4754571,10289990,04/22/2020
2019,Madison,25,10377,6160969,4273,5482086,11643055,04/22/2020
2019,Monroe,26,100591,65193629,38941,57012010,122205639,04/22/2020
2019,Montgomery,27,6753,3609538,3396,3774204,7383742,04/22/2020
2019,Nassau,28,191177,230642491,40778,104104893,334747384,04/22/2020
2019,Niagara,29,31337,17922033,14399,17435302,35357335,04/22/2020
2019,Oneida,30,32115,19320787,13499,17415342,36736129,04/22/2020
2019,Onondaga,31,64063,42480334,24885,35761211,78241545,04/22/2020
2019,Ontario,32,15765,9040859,6411,8114665,17155524,04/22/2020
2019,Orange,33,47065,38687363,12422,22794129,61481492,04/22/2020
2019,Orleans,34,5907,3273952,2812,3292494,6566446,04/22/2020
2019,Oswego,35,17358,10750556,7167,9306222,20056778,04/22/2020
2019,Otsego,36,8760,4018063,4010,3985807,8003870,04/22/2020
2019,Putnam,37,15879,17277189,4016,9756007,27033196,04/22/2020
2019,Rensselaer,38,21845,11551235,7803,8975732,20526967,04/22/2020
2019,Rockland,39,35928,42518277,8932,23915368,66433645,04/22/2020
2019,St. Lawrence,40,16004,8905939,6986,7830837,16736776,04/22/2020
2019,Saratoga,41,34831,20478086,10129,12882302,33360388,04/22/2020
2019,Schenectady,42,21653,12506573,7445,9366658,21873231,04/22/2020
2019,Schoharie,43,4540,2560046,2406,2790429,5350475,04/22/2020
2019,Schuyler,44,3008,1211867,1382,1211892,2423759,04/22/2020
2019,Seneca,45,4762,2715077,2212,2727644,5442721,04/22/2020
2019,Steuben,46,14714,8147846,6601,7469126,15616972,04/22/2020
2019,Suffolk,47,206296,212217769,54240,120663912,332881681,04/22/2020
2019,Sullivan,48,8753,4570185,3781,4155393,8725578,04/22/2020
2019,Tioga,49,8045,4334987,3506,4039545,8374532,04/22/2020
2019,Tompkins,50,10937,6035541,3877,4582124,10617665,04/22/2020
2019,Ulster,51,24146,15169009,9598,12727988,27896997,04/22/2020
2019,Warren,52,9225,3532980,4413,3632403,7165383,04/22/2020
2019,Washington,53,9132,3908887,4234,3983780,7892667,04/22/2020
2019,Wayne,54,14446,9400510,6259,8649191,18049701,04/22/2020
2019,Westchester,55,85536,158608527,21276,79492659,238101186,04/22/2020
2019,Wyoming,56,6519,3107961,2602,2680819,5788780,04/22/2020
2019,Yates,57,3613,1198440,1728,1243363,2441803,04/22/2020
2019,New York City,65,379641,107971221,95556,57497839,165469060,04/22/2020
2018,Albany,01,43331,24458931,12275,14896771,39355702,03/11/2020
2018,Allegany,02,7185,3872031,3598,3643662,7515693,03/11/2020
2018,Broome,03,28155,19373260,12292,17882371,37255631,03/11/2020
2018,Cattaraugus,04,12033,5403084,5786,4928644,10331728,03/11/2020
2018,Cayuga,05,11978,6273262,4944,5497773,11771035,03/11/2020
2018,Chautauqua,06,19325,10690816,9842,10852954,21543770,03/11/2020
2018,Chemung,07,13099,7504136,5592,6726096,14230232,03/11/2020
2018,Chenango,08,7749,4040228,3573,3761176,7801404,03/11/2020
2018,Clinton,09,12083,6789780,4812,5511761,12301541,03/11/2020
2018,Columbia,10,9053,4203250,3497,3436383,7639633,03/11/2020
2018,Cortland,11,6508,3505634,2807,3223223,6728857,03/11/2020
2018,Delaware,12,6667,2632365,4032,3343400,5975765,03/11/2020
2018,Dutchess,13,43355,33012431,12309,19908406,52920837,03/11/2020
2018,Erie,14,140573,67433959,51722,54185086,121619045,03/11/2020
2018,Essex,15,5651,2017111,2959,2153087,4170198,03/11/2020
2018,Franklin,16,6922,2863435,3032,2539327,5402762,03/11/2020
2018,Fulton,17,8235,4239916,4083,4197214,8437130,03/11/2020
2018,Genesee,18,9710,6278475,3864,5198863,11477338,03/11/2020
2018,Greene,19,6654,2983292,3239,2979825,5963117,03/11/2020
2018,Hamilton,20,941,196401,617,272932,469333,03/11/2020
2018,Herkimer,21,9647,5451740,4679,5404860,10856600,03/11/2020
2018,Jefferson,22,13926,3770624,5381,3114665,6885289,03/11/2020
2018,Lewis,23,4720,1467699,1956,1277848,2745547,03/11/2020
2018,Livingston,24,9999,6137201,3782,4774832,10912033,03/11/2020
2018,Madison,25,11120,6737938,4471,5632924,12370862,03/11/2020
2018,Monroe,26,112268,74522305,38699,56084537,130606842,03/11/2020
2018,Montgomery,27,7196,3906565,3507,3889308,7795873,03/11/2020
2018,Nassau,28,222415,271643936,42405,112708257,384352193,03/11/2020
2018,Niagara,29,33471,19763042,14876,18005529,37768571,03/11/2020
2018,Oneida,30,34168,20951284,14103,18031809,38983093,03/11/2020
2018,Onondaga,31,71099,47918250,25043,35324548,83242798,03/11/2020
2018,Ontario,32,17248,10068934,6543,8226375,18295309,03/11/2020
2018,Orange,33,52364,45822129,12972,24519734,70341863,03/11/2020
2018,Orleans,34,6224,3528172,2899,3375861,6904033,03/11/2020
2018,Oswego,35,18592,11714655,7402,9452211,21166866,03/11/2020
2018,Otsego,36,9013,4186231,4443,4316783,8503014,03/11/2020
2018,Putnam,37,18149,20612614,4131,10215436,30828050,03/11/2020
2018,Rensselaer,38,24095,12901285,7937,9028410,21929695,03/11/2020
2018,Rockland,39,41752,51909733,9524,25926423,77836156,03/11/2020
2018,St. Lawrence,40,16718,9448065,7473,8255026,17703091,03/11/2020
2018,Saratoga,41,38454,23824326,10640,13849529,37673855,03/11/2020
2018,Schenectady,42,23623,13951246,7790,9741150,23692396,03/11/2020
2018,Schoharie,43,4872,2796327,2443,2786022,5582349,03/11/2020
2018,Schuyler,44,3152,1297138,1444,1251185,2548323,03/11/2020
2018,Seneca,45,4989,2912792,2368,2907053,5819845,03/11/2020
2018,Steuben,46,15769,8896514,6839,7670762,16567276,03/11/2020
2018,Suffolk,47,233158,250553497,56843,128693606,379247103,03/11/2020
2018,Sullivan,48,9312,4936457,3990,4324586,9261043,03/11/2020
2018,Tioga,49,8602,4703789,3517,4001575,8705364,03/11/2020
2018,Tompkins,50,12358,7024376,3864,4503377,11527753,03/11/2020
2018,Ulster,51,26012,16624660,10015,13100307,29724967,03/11/2020
2018,Warren,52,9996,3893354,4625,3729543,7622897,03/11/2020
2018,Washington,53,9627,4201239,4406,4085025,8286264,03/11/2020
2018,Wayne,54,15334,10157476,6447,8794811,18952287,03/11/2020
2018,Westchester,55,103265,194319237,22275,81551819,275871056,03/11/2020
2018,Wyoming,56,6889,3366237,2658,2747119,6113356,03/11/2020
2018,Yates,57,3884,1300109,1776,1259876,2559985,03/11/2020
2018,New York City,65,418153,121121366,100905,60202079,181323445,03/11/2020
2017,Albany,01,45996,25808734,12870,15282307,41091041,03/11/2020
2017,Allegany,02,7578,4075140,3670,3735121,7810261,03/11/2020
2017,Broome,03,29805,20329247,12534,17759780,38089027,03/11/2020
2017,Cattaraugus,04,12733,6046132,5800,5105364,11151496,03/11/2020
2017,Cayuga,05,12732,6661803,5013,5448640,12110443,03/11/2020
2017,Chautauqua,06,20555,11450152,9917,10769672,22219824,03/11/2020
2017,Chemung,07,13890,7951775,5689,6726388,14678163,03/11/2020
2017,Chenango,08,8144,4199543,3685,3785153,7984696,03/11/2020
2017,Clinton,09,12696,7120255,4867,5434719,12554974,03/11/2020
2017,Columbia,10,9498,4409396,3605,3457952,7867348,03/11/2020
2017,Cortland,11,6968,3766779,2863,3235700,7002479,03/11/2020
2017,Delaware,12,7014,2749400,4178,3385300,6134700,03/11/2020
2017,Dutchess,13,45546,35183686,12611,20277398,55461084,03/11/2020
2017,Erie,14,148905,73142063,52623,54765444,127907507,03/11/2020
2017,Essex,15,6018,2135472,3022,2139551,4275023,03/11/2020
2017,Franklin,16,7291,3018455,3027,2512968,5531423,03/11/2020
2017,Fulton,17,8732,4458293,4082,4111342,8569635,03/11/2020
2017,Genesee,18,10210,6749362,3873,5205650,11955012,03/11/2020
2017,Greene,19,7068,3133522,3324,2976072,6109594,03/11/2020
2017,Hamilton,20,984,203931,622,267124,471055,03/11/2020
2017,Herkimer,21,10172,5716203,4752,5333498,11049701,03/11/2020
2017,Jefferson,22,14669,3963943,5457,3096614,7060557,03/11/2020
2017,Lewis,23,4961,1547265,1940,1253133,2800398,03/11/2020
2017,Livingston,24,10558,6488188,3832,4755564,11243752,03/11/2020
2017,Madison,25,11810,7071805,4467,5543131,12614936,03/11/2020
2017,Monroe,26,119926,80013670,38917,55554049,135567719,03/11/2020
2017,Montgomery,27,7553,4188641,3549,3987059,8175700,03/11/2020
2017,Nassau,28,234358,285911520,45080,114653953,400565473,03/11/2020
2017,Niagara,29,35610,21545358,14948,18184401,39729759,03/11/2020
2017,Oneida,30,35788,21783001,14448,17976349,39759350,03/11/2020
2017,Onondaga,31,76136,51147140,25377,35206606,86353746,03/11/2020
2017,Ontario,32,18404,10794282,6586,8123870,18918152,03/11/2020
2017,Orange,33,55518,49489023,13221,24904903,74393926,03/11/2020
2017,Orleans,34,6569,3765217,2988,3461441,7226658,03/11/2020
2017,Oswego,35,19869,12511783,7490,9397282,21909065,03/11/2020
2017,Otsego,36,9379,4321311,4532,4291664,8612975,03/11/2020
2017,Putnam,37,19087,22270248,4200,10435840,32706088,03/11/2020
2017,Rensselaer,38,25504,13685499,7969,8869090,22554589,03/11/2020
2017,Rockland,39,43888,55781950,9848,26754572,82536522,03/11/2020
2017,St. Lawrence,40,17616,9881744,7585,8169800,18051544,03/11/2020
2017,Saratoga,41,40990,25851641,10606,13712857,39564498,03/11/2020
2017,Schenectady,42,25376,14893348,7988,9676717,24570065,03/11/2020
2017,Schoharie,43,5127,2922300,2495,2779715,5702015,03/11/2020
2017,Schuyler,44,3346,1386413,1472,1256712,2643125,03/11/2020
2017,Seneca,45,5324,3134025,2398,2894049,6028074,03/11/2020
2017,Steuben,46,16656,9439250,6957,7699879,17139129,03/11/2020
2017,Suffolk,47,247180,267457313,58562,130431804,397889117,03/11/2020
2017,Sullivan,48,9757,5126098,4143,4367080,9493178,03/11/2020
2017,Tioga,49,9045,4898623,3577,3949483,8848106,03/11/2020
2017,Tompkins,50,13252,7516673,3895,4398787,11915460,03/11/2020
2017,Ulster,51,27437,17630190,10234,13235432,30865622,03/11/2020
2017,Warren,52,10638,4144645,4753,3751601,7896246,03/11/2020
2017,Washington,53,10140,4414913,4527,4108767,8523680,03/11/2020
2017,Wayne,54,16390,10849103,6458,8614034,19463137,03/11/2020
2017,Westchester,55,109603,204842395,23153,85328438,290170833,03/11/2020
2017,Wyoming,56,7197,3530288,2664,2730230,6260518,03/11/2020
2017,Yates,57,4131,1400684,1790,1261429,2662113,03/11/2020
2017,New York City,65,445003,127344772,105917,61399504,188744276,03/11/2020
2016,Albany,01,48573,27177945,13145,15471373,42649318,03/11/2020
2016,Allegany,02,8000,4415994,3713,3766807,8182801,03/11/2020
2016,Broome,03,31417,21093223,12623,17613231,38706454,03/11/2020
2016,Cattaraugus,04,13485,6462831,5822,5098108,11560939,03/11/2020
2016,Cayuga,05,13512,7071451,4981,5380292,12451743,03/11/2020
2016,Chautauqua,06,21761,12189256,10100,10914313,23103569,03/11/2020
2016,Chemung,07,14691,8390929,5791,6806490,15197419,03/11/2020
2016,Chenango,08,8592,4364491,3724,3754529,8119020,03/11/2020
2016,Clinton,09,13434,7439041,4872,5365022,12804063,03/11/2020
2016,Columbia,10,9961,4579124,3680,3475733,8054857,03/11/2020
2016,Cortland,11,7369,3968332,2893,3236309,7204641,03/11/2020
2016,Delaware,12,7325,2841349,4233,3379289,6220638,03/11/2020
2016,Dutchess,13,47880,36828875,12438,20247674,57076549,03/11/2020
2016,Erie,14,158011,79809153,53027,54586034,134395187,03/11/2020
2016,Essex,15,6299,2230800,3067,2150988,4381788,03/11/2020
2016,Franklin,16,7576,3104755,3099,2523435,5628190,03/11/2020
2016,Fulton,17,9218,4674893,4194,4162195,8837088,03/11/2020
2016,Genesee,18,10744,7210171,3918,5297915,12508086,03/11/2020
2016,Greene,19,7428,3244557,3379,2969417,6213974,03/11/2020
2016,Hamilton,20,1012,205558,649,273623,479181,03/11/2020
2016,Herkimer,21,10704,5921621,4760,5227180,11148801,03/11/2020
2016,Jefferson,22,15461,4158606,5495,3094381,7252987,03/11/2020
2016,Lewis,23,5141,1621907,2015,1311802,2933709,03/11/2020
2016,Livingston,24,11121,6815606,3833,4723563,11539169,03/11/2020
2016,Madison,25,12503,7391961,4513,5510035,12901996,03/11/2020
2016,Monroe,26,128756,85392654,38971,54838251,140230905,03/11/2020
2016,Montgomery,27,7969,4421112,3609,4085965,8507077,03/11/2020
2016,Nassau,28,245587,293291597,46826,116585828,409877425,03/11/2020
2016,Niagara,29,37747,23138942,15054,18446595,41585537,03/11/2020
2016,Oneida,30,37433,21757036,14899,19336027,41093063,03/11/2020
2016,Onondaga,31,81133,54161753,25624,35017077,89178830,03/11/2020
2016,Ontario,32,19748,11631075,6452,7940140,19571215,03/11/2020
2016,Orange,33,58545,51778073,13464,25021156,76799229,03/11/2020
2016,Orleans,34,6941,4103023,2997,3531333,7634356,03/11/2020
2016,Oswego,35,20951,13334972,7515,9397914,22732886,03/11/2020
2016,Otsego,36,9756,4449103,4639,4344311,8793414,03/11/2020
2016,Putnam,37,20202,23868165,4172,10425978,34294143,03/11/2020
2016,Rensselaer,38,27036,14320363,7974,8738504,23058867,03/11/2020
2016,Rockland,39,45794,58047270,10068,27021371,85068641,03/11/2020
2016,St. Lawrence,40,18483,10275235,7710,8150761,18425996,03/11/2020
2016,Saratoga,41,43395,27306186,10752,13794191,41100377,03/11/2020
2016,Schenectady,42,26902,15544052,8264,9845986,25390038,03/11/2020
2016,Schoharie,43,5461,3070969,2506,2725225,5796194,03/11/2020
2016,Schuyler,44,3531,1513376,1506,1305058,2818434,03/11/2020
2016,Seneca,45,5716,3503509,2340,2932874,6436383,03/11/2020
2016,Steuben,46,17534,10033930,7052,7793507,17827437,03/11/2020
2016,Suffolk,47,257143,274254291,60174,130821737,405076028,03/11/2020
2016,Sullivan,48,10238,5290265,4259,4390328,9680593,03/11/2020
2016,Tioga,49,9417,5046445,3649,3955777,9002222,03/11/2020
2016,Tompkins,50,13996,7959745,3865,4328516,12288261,03/11/2020
2016,Ulster,51,28959,18484064,10332,13231725,31715789,03/11/2020
2016,Warren,52,11362,4389173,4745,3687756,8076929,03/11/2020
2016,Washington,53,10736,4627982,4532,4053880,8681862,03/11/2020
2016,Wayne,54,17667,11657136,6226,8232959,19890095,03/11/2020
2016,Westchester,55,116785,219509591,24054,84814177,304323768,03/11/2020
2016,Wyoming,56,7579,3820965,2631,2745988,6566953,03/11/2020
2016,Yates,57,4363,1477456,1804,1264478,2741934,03/11/2020
2016,New York City,65,457203,134925029,115894,69493520,204418549,03/11/2020
2015,Albany,01,51166,28481296,13422,15703972,44185268,03/11/2020
2015,Allegany,02,8419,4755711,3743,3808527,8564238,03/11/2020
2015,Broome,03,32963,21803374,12865,17571497,39374871,03/11/2020
2015,Cattaraugus,04,14123,7025287,5842,5289090,12314377,03/11/2020
2015,Cayuga,05,14149,7432645,5059,5374822,12807467,03/11/2020
2015,Chautauqua,06,22929,12908928,10110,10893543,23802471,03/11/2020
2015,Chemung,07,15435,8819234,5953,6961151,15780385,03/11/2020
2015,Chenango,08,9004,4505041,3789,3772073,8277114,03/11/2020
2015,Clinton,09,14127,7730096,4889,5292201,13022297,03/11/2020
2015,Columbia,10,10352,4692420,3819,3569190,8261610,03/11/2020
2015,Cortland,11,7793,4169884,2881,3185855,7355739,03/11/2020
2015,Delaware,12,7648,2976730,4235,3379200,6355930,03/11/2020
2015,Dutchess,13,50185,39370365,12780,20623519,59993884,03/11/2020
2015,Erie,14,165314,83641114,54791,56992716,140633830,03/11/2020
2015,Essex,15,6617,2311637,3156,2182732,4494369,03/11/2020
2015,Franklin,16,7900,3227721,3150,2531075,5758796,03/11/2020
2015,Fulton,17,9617,4887871,4264,4185051,9072922,03/11/2020
2015,Genesee,18,11207,7557364,4006,5439465,12996829,03/11/2020
2015,Greene,19,7794,3354530,3470,2996766,6351296,03/11/2020
2015,Hamilton,20,1048,209100,662,272370,481470,03/11/2020
2015,Herkimer,21,11235,6195068,4811,5232427,11427495,03/11/2020
2015,Jefferson,22,16284,4439256,5514,3144128,7583384,03/11/2020
2015,Lewis,23,5436,1750127,1979,1305123,3055250,03/11/2020
2015,Livingston,24,11635,7066640,3878,4716368,11783008,03/11/2020
2015,Madison,25,13058,7731617,4549,5523436,13255053,03/11/2020
2015,Monroe,26,136190,90238661,39445,55348657,145587318,03/11/2020
2015,Montgomery,27,8373,4595735,3621,4037743,8633478,03/11/2020
2015,Nassau,28,251550,302630706,49024,125597864,428228570,03/11/2020
2015,Niagara,29,39874,25071139,15243,18966658,44037797,03/11/2020
2015,Oneida,30,39170,23545614,15092,18279416,41825030,03/11/2020
2015,Onondaga,31,85927,56901531,25858,34929282,91830813,03/11/2020
2015,Ontario,32,20956,12314235,6585,8087015,20401250,03/11/2020
2015,Orange,33,61263,54579511,13799,25627007,80206518,03/11/2020
2015,Orleans,34,7322,4365997,3022,3598234,7964231,03/11/2020
2015,Oswego,35,22059,13959555,7531,9289622,23249177,03/11/2020
2015,Otsego,36,10187,4563841,4650,4257435,8821276,03/11/2020
2015,Putnam,37,21101,25542718,4203,10692886,36235604,03/11/2020
2015,Rensselaer,38,28384,14788950,8126,8762073,23551023,03/11/2020
2015,Rockland,39,47886,61315614,10510,28335710,89651324,03/11/2020
2015,St. Lawrence,40,19548,10795236,7647,7999221,18794457,03/11/2020
2015,Saratoga,41,45853,29002854,10926,14010222,43013076,03/11/2020
2015,Schenectady,42,28267,16052684,8547,9981747,26034431,03/11/2020
2015,Schoharie,43,5751,3184629,2550,2717643,5902272,03/11/2020
2015,Schuyler,44,3741,1603362,1475,1271076,2874438,03/11/2020
2015,Seneca,45,6055,3749584,2362,2991659,6741243,03/11/2020
2015,Steuben,46,18464,10669985,7046,7821643,18491628,03/11/2020
2015,Suffolk,47,268806,286191443,61347,131996786,418188229,03/11/2020
2015,Sullivan,48,10772,5476489,4352,4407527,9884016,03/11/2020
2015,Tioga,49,9847,5201373,3692,3947509,9148882,03/11/2020
2015,Tompkins,50,14876,8513869,3918,4381167,12895036,03/11/2020
2015,Ulster,51,30212,19295377,10409,13332021,32627398,03/11/2020
2015,Warren,52,12077,4590790,4825,3696106,8286896,03/11/2020
2015,Washington,53,11265,4776789,4600,4047972,8824761,03/11/2020
2015,Wayne,54,18562,12364484,6303,8360303,20724787,03/11/2020
2015,Westchester,55,123372,225169463,25332,90453030,315622493,03/11/2020
2015,Wyoming,56,7913,4071570,2672,2808636,6880206,03/11/2020
2015,Yates,57,4560,1546762,1855,1296236,2842998,03/11/2020
2015,New York City,65,457744,136296637,114003,68721509,205018146,03/11/2020
2014,Albany,01,50670,27870948,13684,15551666,43422614,03/14/2019
2014,Allegany,02,8553,4876662,3704,3741865,8618527,03/14/2019
2014,Broome,03,32735,21404603,13111,17353176,38757779,03/14/2019
2014,Cattaraugus,04,14105,7213540,5769,5310043,12523583,03/14/2019
2014,Cayuga,05,14127,7395634,5145,5414823,12810457,03/14/2019
2014,Chautauqua,06,23148,13062818,9935,10547809,23610627,03/14/2019
2014,Chemung,07,15289,8849635,6106,7055087,15904722,03/14/2019
2014,Chenango,08,8938,4467078,3844,3744944,8212022,03/14/2019
2014,Clinton,09,14016,7581933,4847,5120498,12702431,03/14/2019
2014,Columbia,10,10214,4551844,3914,3567365,8119209,03/14/2019
2014,Cortland,11,7840,4174132,2851,3071408,7245540,03/14/2019
2014,Delaware,12,7641,2954453,4249,3327015,6281468,03/14/2019
2014,Dutchess,13,49757,39158211,12816,20413321,59571532,03/14/2019
2014,Erie,14,163389,82522977,55953,57087477,139610454,03/14/2019
2014,Essex,15,6588,2275357,3174,2153329,4428686,03/14/2019
2014,Franklin,16,7852,3174845,3158,2473452,5648297,03/14/2019
2014,Fulton,17,9634,4865638,4234,4039383,8905021,03/14/2019
2014,Genesee,18,11163,7477246,4070,5483705,12960951,03/14/2019
2014,Greene,19,7839,3326546,3451,2913826,6240372,03/14/2019
2014,Hamilton,20,1034,202864,672,267838,470702,03/14/2019
2014,Herkimer,21,11244,6098561,4877,5170525,11269086,03/14/2019
2014,Jefferson,22,16031,4431012,5636,3189637,7620649,03/14/2019
2014,Lewis,23,5399,1756822,2005,1315043,3071865,03/14/2019
2014,Livingston,24,11607,7039895,3878,4593956,11633851,03/14/2019
2014,Madison,25,12998,7592042,4554,5364314,12956356,03/14/2019
2014,Monroe,26,135378,88912753,39682,54237860,143150613,03/14/2019
2014,Montgomery,27,8298,4515993,3644,4001353,8517346,03/14/2019
2014,Nassau,28,246224,295011372,50071,126164209,421175581,03/14/2019
2014,Niagara,29,39869,25210793,15290,18728617,43939410,03/14/2019
2014,Oneida,30,38770,23083216,15418,18111427,41194643,03/14/2019
2014,Onondaga,31,84881,55689595,26358,34669587,90359182,03/14/2019
2014,Ontario,32,20803,12216349,6579,7940610,20156959,03/14/2019
2014,Orange,33,60549,53484688,13930,25194774,78679462,03/14/2019
2014,Orleans,34,7310,4432937,3010,3586495,8019432,03/14/2019
2014,Oswego,35,21797,13641845,7681,9241700,22883545,03/14/2019
2014,Otsego,36,10167,4499100,4646,4138083,8637183,03/14/2019
2014,Putnam,37,20993,25728824,4142,10481473,36210297,03/14/2019
2014,Rensselaer,38,28055,14487436,8290,8716679,23204115,03/14/2019
2014,Rockland,39,47256,60372939,10694,28308947,88681886,03/14/2019
2014,St. Lawrence,40,19393,10625159,7776,7911917,18537076,03/14/2019
2014,Saratoga,41,45302,28330472,11016,13746035,42076507,03/14/2019
2014,Schenectady,42,28016,15603825,8616,9856294,25460119,03/14/2019
2014,Schoharie,43,5744,3147545,2538,2665824,5813369,03/14/2019
2014,Schuyler,44,3668,1568880,1516,1284336,2853216,03/14/2019
2014,Seneca,45,6046,3763615,2405,2953898,6717513,03/14/2019
2014,Steuben,46,18290,10755990,7113,7861581,18617571,03/14/2019
2014,Suffolk,47,265308,278165928,62451,130246612,408412540,03/14/2019
2014,Sullivan,48,10707,5367977,4438,4397847,9765824,03/14/2019
2014,Tioga,49,9807,5120517,3691,3833930,8954447,03/14/2019
2014,Tompkins,50,14915,8463532,3854,4173619,12637151,03/14/2019
2014,Ulster,51,29984,18997665,10505,13164887,32162552,03/14/2019
2014,Warren,52,12012,4506399,4845,3609521,8115920,03/14/2019
2014,Washington,53,11268,4721031,4661,3985199,8706230,03/14/2019
2014,Wayne,54,18554,12265361,6309,8196486,20461847,03/14/2019
2014,Westchester,55,121576,216323661,25288,88733741,305057402,03/14/2019
2014,Wyoming,56,7883,4026079,2684,2798058,6824137,03/14/2019
2014,Yates,57,4578,1550890,1854,1277419,2828309,03/14/2019
2014,New York City,65,458642,133226852,116914,67772522,200999374,03/14/2019
2013,Albany,01,53046,28842125,13064,14484953,43327078,03/14/2019
2013,Allegany,02,9080,5146696,3540,3517026,8663722,03/14/2019
2013,Broome,03,35126,22636042,13068,16826765,39462807,03/14/2019
2013,Cattaraugus,04,15168,7843780,5524,5093980,12937760,03/14/2019
2013,Cayuga,05,15044,7895847,4956,5113123,13008970,03/14/2019
2013,Chautauqua,06,24644,13860419,9691,10141457,24001876,03/14/2019
2013,Chemung,07,16238,9480422,5910,6729320,16209742,03/14/2019
2013,Chenango,08,9757,4818130,3721,3547086,8365216,03/14/2019
2013,Clinton,09,15064,8042183,4605,4727407,12769590,03/14/2019
2013,Columbia,10,10920,4855132,3739,3292926,8148058,03/14/2019
2013,Cortland,11,8484,4465692,2779,2953063,7418755,03/14/2019
2013,Delaware,12,8528,3258024,4042,3108951,6366975,03/14/2019
2013,Dutchess,13,53497,41829928,12158,18961478,60791406,03/14/2019
2013,Erie,14,172838,86202465,53997,53840285,140042750,03/14/2019
2013,Essex,15,7345,2492516,3125,2080630,4573146,03/14/2019
2013,Franklin,16,8623,3433046,3073,2343138,5776184,03/14/2019
2013,Fulton,17,10451,5212922,4049,3782639,8995561,03/14/2019
2013,Genesee,18,11733,7809972,3993,5269080,13079052,03/14/2019
2013,Greene,19,8634,3612900,3301,2711306,6324206,03/14/2019
2013,Hamilton,20,1139,222885,637,250245,473130,03/14/2019
2013,Herkimer,21,12016,6445801,4793,4994422,11440223,03/14/2019
2013,Jefferson,22,17658,4910507,5259,2961672,7872179,03/14/2019
2013,Lewis,23,5724,1859885,1935,1249047,3108932,03/14/2019
2013,Livingston,24,12260,7322094,3661,4255094,11577188,03/14/2019
2013,Madison,25,13807,7958394,4417,5062230,13020624,03/14/2019
2013,Monroe,26,145044,93799723,37517,50123206,143922929,03/14/2019
2013,Montgomery,27,8981,4873652,3590,3887388,8761040,03/14/2019
2013,Nassau,28,270897,324068874,48479,115557682,439626556,03/14/2019
2013,Niagara,29,42080,26332475,14457,17286793,43619268,03/14/2019
2013,Oneida,30,41394,24369034,15066,17345219,41714253,03/14/2019
2013,Onondaga,31,90517,58612083,25182,32339837,90951920,03/14/2019
2013,Ontario,32,21408,12476461,6112,7221231,19697692,03/14/2019
2013,Orange,33,65625,57171779,13277,23560602,80732381,03/14/2019
2013,Orleans,34,7748,4866465,2858,3484272,8350737,03/14/2019
2013,Oswego,35,23719,14782310,7343,8652807,23435117,03/14/2019
2013,Otsego,36,11070,4850151,4479,3907647,8757798,03/14/2019
2013,Putnam,37,22387,27151710,3928,9770067,36921777,03/14/2019
2013,Rensselaer,38,29721,15078527,7954,8134542,23213069,03/14/2019
2013,Rockland,39,50938,64726147,10157,26338275,91064422,03/14/2019
2013,St. Lawrence,40,20838,11317430,7454,7423055,18740485,03/14/2019
2013,Saratoga,41,46875,28871444,10471,12713244,41584688,03/14/2019
2013,Schenectady,42,29801,16409192,8360,9323196,25732388,03/14/2019
2013,Schoharie,43,6204,3355726,2421,2490337,5846063,03/14/2019
2013,Schuyler,44,3958,1727488,1519,1275444,3002932,03/14/2019
2013,Seneca,45,6509,4001338,2319,2806897,6808235,03/14/2019
2013,Steuben,46,19683,11508911,6916,7492928,19001839,03/14/2019
2013,Suffolk,47,288744,299148695,60573,123534811,422683506,03/14/2019
2013,Sullivan,48,12128,5980591,4171,4057017,10037608,03/14/2019
2013,Tioga,49,10382,5353744,3643,3680901,9034645,03/14/2019
2013,Tompkins,50,15630,8750724,3653,3838803,12589527,03/14/2019
2013,Ulster,51,32550,20390419,10019,12292473,32682892,03/14/2019
2013,Warren,52,12803,4780030,4613,3384276,8164306,03/14/2019
2013,Washington,53,11946,4946189,4487,3740145,8686334,03/14/2019
2013,Wayne,54,19458,12788042,6024,7630444,20418486,03/14/2019
2013,Westchester,55,133085,237580632,24544,79167089,316747721,03/14/2019
2013,Wyoming,56,8333,4224817,2524,2607042,6831859,03/14/2019
2013,Yates,57,4841,1620447,1840,1236067,2856514,03/14/2019
2013,New York City,65,566695,161293055,111917,63347458,224640513,03/14/2019
2012,Albany,01,53561,28718462,13223,14273897,42992359,03/14/2019
2012,Allegany,02,9101,5175281,3570,3526329,8701610,03/14/2019
2012,Broome,03,35774,22708523,13165,16430368,39138891,03/14/2019
2012,Cattaraugus,04,15337,7851570,5587,4978215,12829785,03/14/2019
2012,Cayuga,05,15130,7854038,5062,5068650,12922688,03/14/2019
2012,Chautauqua,06,24995,14085463,9541,9801577,23887040,03/14/2019
2012,Chemung,07,16250,9385952,6004,6626395,16012347,03/14/2019
2012,Chenango,08,9892,4835497,3704,3442705,8278202,03/14/2019
2012,Clinton,09,15220,8025604,4563,4552837,12578441,03/14/2019
2012,Columbia,10,11098,4810574,3736,3243494,8054068,03/14/2019
2012,Cortland,11,8545,4452998,2776,2866876,7319874,03/14/2019
2012,Delaware,12,8700,3315877,4006,2998018,6313895,03/14/2019
2012,Dutchess,13,53760,41487806,12256,18590142,60077948,03/14/2019
2012,Erie,14,173657,85695888,54710,53001505,138697393,03/14/2019
2012,Essex,15,7531,2552008,3106,2002322,4554330,03/14/2019
2012,Franklin,16,8756,3444199,2997,2215624,5659823,03/14/2019
2012,Fulton,17,10579,5234806,4083,3731549,8966355,03/14/2019
2012,Genesee,18,11826,7895667,3986,5184631,13080298,03/14/2019
2012,Greene,19,8717,3592669,3338,2672387,6265056,03/14/2019
2012,Hamilton,20,1160,223576,632,241634,465210,03/14/2019
2012,Herkimer,21,12170,6472569,4784,4838197,11310766,03/14/2019
2012,Jefferson,22,17832,4972248,5331,2936907,7909155,03/14/2019
2012,Lewis,23,5724,1860349,1960,1233241,3093590,03/14/2019
2012,Livingston,24,12358,7292719,3618,4103845,11396564,03/14/2019
2012,Madison,25,14066,8021844,4338,4828947,12850791,03/14/2019
2012,Monroe,26,146496,93451327,37194,48265708,141717035,03/14/2019
2012,Montgomery,27,9084,4855580,3720,3928583,8784163,03/14/2019
2012,Nassau,28,268998,313857177,48863,116563787,430420964,03/14/2019
2012,Niagara,29,42321,26228962,14358,16652031,42880993,03/14/2019
2012,Oneida,30,41545,24227007,15309,17090448,41317455,03/14/2019
2012,Onondaga,31,91265,58361168,25047,31233098,89594266,03/14/2019
2012,Ontario,32,21569,12467478,6062,6972212,19439690,03/14/2019
2012,Orange,33,66132,56955183,13087,22535619,79490802,03/14/2019
2012,Orleans,34,7871,5063648,2802,3447213,8510861,03/14/2019
2012,Oswego,35,23846,14691790,7410,8492138,23183928,03/14/2019
2012,Otsego,36,11178,4850160,4471,3816861,8667021,03/14/2019
2012,Putnam,37,22595,27108126,3899,9424902,36533028,03/14/2019
2012,Rensselaer,38,29961,15040144,7880,7804338,22844482,03/14/2019
2012,Rockland,39,51566,64693537,10026,25144172,89837709,03/14/2019
2012,St. Lawrence,40,21002,11261731,7421,7195844,18457575,03/14/2019
2012,Saratoga,41,46985,28576650,10230,12052567,40629217,03/14/2019
2012,Schenectady,42,30037,16312736,8401,9113695,25426431,03/14/2019
2012,Schoharie,43,6285,3355743,2402,2402491,5758234,03/14/2019
2012,Schuyler,44,3979,1754706,1515,1257866,3012572,03/14/2019
2012,Seneca,45,6554,4029920,2331,2776755,6806675,03/14/2019
2012,Steuben,46,19715,11422093,6999,7391633,18813726,03/14/2019
2012,Suffolk,47,290036,296175010,60416,118658245,414833255,03/14/2019
2012,Sullivan,48,12321,6002030,4169,3931881,9933911,03/14/2019
2012,Tioga,49,10491,5335856,3645,3588396,8924252,03/14/2019
2012,Tompkins,50,15633,8666361,3673,3754366,12420727,03/14/2019
2012,Ulster,51,32926,20368622,9904,11822384,32191006,03/14/2019
2012,Warren,52,12955,4772260,4560,3228706,8000966,03/14/2019
2012,Washington,53,12073,4945572,4453,3606889,8552461,03/14/2019
2012,Wayne,54,19684,12841662,5930,7319510,20161172,03/14/2019
2012,Westchester,55,134501,236114894,24629,76942004,313056898,03/14/2019
2012,Wyoming,56,8445,4239922,2441,2455984,6695906,03/14/2019
2012,Yates,57,4866,1621542,1854,1213279,2834821,03/14/2019
2012,New York City,65,564612,159335096,108258,59193859,218528955,03/14/2019
2011,Albany,01,53987,28608135,13222,13649520,42257655,03/14/2019
2011,Allegany,02,9107,5198615,3625,3487344,8685959,03/14/2019
2011,Broome,03,36124,22678797,13192,15894630,38573427,03/14/2019
2011,Cattaraugus,04,15417,7901651,5599,4857661,12759312,03/14/2019
2011,Cayuga,05,15305,7929071,5036,4869238,12798309,03/14/2019
2011,Chautauqua,06,25188,14184036,9627,9696770,23880806,03/14/2019
2011,Chemung,07,16491,9437994,5866,6249486,15687480,03/14/2019
2011,Chenango,08,10071,4872922,3676,3296337,8169259,03/14/2019
2011,Clinton,09,15363,8044672,4476,4292063,12336735,03/14/2019
2011,Columbia,10,11234,4914509,3678,3024646,7939155,03/14/2019
2011,Cortland,11,8592,4480529,2718,2697690,7178219,03/14/2019
2011,Delaware,12,8804,3378242,4028,2935856,6314098,03/14/2019
2011,Dutchess,13,54009,41309099,12116,17471870,58780969,03/14/2019
2011,Erie,14,173938,85347355,55310,51704053,137051408,03/14/2019
2011,Essex,15,7629,2625641,3060,1921089,4546730,03/14/2019
2011,Franklin,16,8779,3472422,2996,2163697,5636119,03/14/2019
2011,Fulton,17,10775,5323350,4061,3596511,8919861,03/14/2019
2011,Genesee,18,11830,7924377,4050,5115065,13039442,03/14/2019
2011,Greene,19,8823,3609407,3294,2539607,6149014,03/14/2019
2011,Hamilton,20,1169,224785,637,236823,461608,03/14/2019
2011,Herkimer,21,12311,6471967,4724,4632189,11104156,03/14/2019
2011,Jefferson,22,17992,5163154,5396,2920190,8083344,03/14/2019
2011,Lewis,23,5715,1884284,1997,1228250,3112534,03/14/2019
2011,Livingston,24,12418,7280668,3634,3978685,11259353,03/14/2019
2011,Madison,25,14271,8014744,4285,4637466,12652210,03/14/2019
2011,Monroe,26,148260,94268995,36171,45277395,139546390,03/14/2019
2011,Montgomery,27,9261,4948737,3626,3713925,8662662,03/14/2019
2011,Nassau,28,272643,318237659,49569,108221173,426458832,03/14/2019
2011,Niagara,29,42779,26450712,14191,15962377,42413089,03/14/2019
2011,Oneida,30,41784,24246409,15516,16768502,41014911,03/14/2019
2011,Onondaga,31,91781,58146243,25058,30148133,88294376,03/14/2019
2011,Ontario,32,21693,12511954,5978,6622918,19134872,03/14/2019
2011,Orange,33,66840,56867404,12642,20813016,77680420,03/14/2019
2011,Orleans,34,7998,5162631,2714,3254878,8417509,03/14/2019
2011,Oswego,35,24075,14955369,7327,8156472,23111841,03/14/2019
2011,Otsego,36,11315,4947256,4408,3629464,8576720,03/14/2019
2011,Putnam,37,22877,27099583,3706,8575985,35675568,03/14/2019
2011,Rensselaer,38,30236,15084987,7806,7461028,22546015,03/14/2019
2011,Rockland,39,51851,64419321,9818,23619594,88038915,03/14/2019
2011,St. Lawrence,40,21160,11278272,7400,6890510,18168782,03/14/2019
2011,Saratoga,41,46977,28264298,10201,11527386,39791684,03/14/2019
2011,Schenectady,42,30438,16400924,8222,8544921,24945845,03/14/2019
2011,Schoharie,43,6449,3413465,2326,2270763,5684228,03/14/2019
2011,Schuyler,44,4038,1784049,1464,1169987,2954036,03/14/2019
2011,Seneca,45,6526,4018469,2349,2713716,6732185,03/14/2019
2011,Steuben,46,19987,11595223,6872,7022563,18617786,03/14/2019
2011,Suffolk,47,290073,293412001,59133,111989240,405401241,03/14/2019
2011,Sullivan,48,12504,6058543,4195,3802789,9861332,03/14/2019
2011,Tioga,49,10668,5384990,3614,3451769,8836759,03/14/2019
2011,Tompkins,50,15799,8718566,3583,3516127,12234693,03/14/2019
2011,Ulster,51,33326,20442169,9645,11117902,31560071,03/14/2019
2011,Warren,52,13238,4930093,4348,2996278,7926371,03/14/2019
2011,Washington,53,12231,5088157,4354,3421261,8509418,03/14/2019
2011,Wayne,54,20004,12991314,5705,6782273,19773587,03/14/2019
2011,Westchester,55,137013,235208514,24911,76004898,311213412,03/14/2019
2011,Wyoming,56,8496,4298148,2441,2385936,6684084,03/14/2019
2011,Yates,57,4942,1689730,1799,1153892,2843622,03/14/2019
2011,New York City,65,562404,156717572,107614,56068411,212785983,03/14/2019
2010,Albany,01,54792,28575368,12913,13094607,41669975,03/14/2019
2010,Allegany,02,9231,5286042,3521,3299063,8585105,03/14/2019
2010,Broome,03,36603,22778350,13219,15733171,38511521,03/14/2019
2010,Cattaraugus,04,15805,8088368,5370,4647310,12735678,03/14/2019
2010,Cayuga,05,15619,8082991,4890,4692904,12775895,03/14/2019
2010,Chautauqua,06,25766,14424394,9286,9250610,23675004,03/14/2019
2010,Chemung,07,16777,9401529,5724,5955394,15356923,03/14/2019
2010,Chenango,08,10232,4950898,3682,3289979,8240877,03/14/2019
2010,Clinton,09,15558,8039335,4351,4093089,12132424,03/14/2019
2010,Columbia,10,11713,5087338,3534,2852935,7940273,03/14/2019
2010,Cortland,11,8661,4440411,2670,2619610,7060021,03/14/2019
2010,Delaware,12,8971,3525476,3911,2888458,6413934,03/14/2019
2010,Dutchess,13,55450,41550320,11322,16195727,57746047,03/14/2019
2010,Erie,14,177867,85885492,53544,48814200,134699692,03/14/2019
2010,Essex,15,7789,2740448,3051,1916909,4657357,03/14/2019
2010,Franklin,16,8874,3528452,2946,2095362,5623814,03/14/2019
2010,Fulton,17,10995,5435550,3998,3478622,8914172,03/14/2019
2010,Genesee,18,12063,8016857,3806,4744381,12761238,03/14/2019
2010,Greene,19,9046,3717312,3253,2444253,6161565,03/14/2019
2010,Hamilton,20,1216,231705,610,223410,455115,03/14/2019
2010,Herkimer,21,12504,6419882,4631,4428970,10848852,03/14/2019
2010,Jefferson,22,18515,5723515,5068,2833938,8557453,03/14/2019
2010,Lewis,23,5908,2016972,1861,1148669,3165641,03/14/2019
2010,Livingston,24,12622,7282292,3534,3774427,11056719,03/14/2019
2010,Madison,25,14637,8212080,4059,4260442,12472522,03/14/2019
2010,Monroe,26,151156,95106136,34956,42942781,138048917,03/14/2019
2010,Montgomery,27,9333,4997910,3587,3604479,8602389,03/14/2019
2010,Nassau,28,278948,312962380,48727,109359704,422322084,03/14/2019
2010,Niagara,29,43282,26456401,13887,15403054,41859455,03/14/2019
2010,Oneida,30,43191,25058873,14705,15787226,40846099,03/14/2019
2010,Onondaga,31,93787,58898803,24248,28576788,87475591,03/14/2019
2010,Ontario,32,22145,12642939,5715,6290599,18933538,03/14/2019
2010,Orange,33,68746,57319926,11851,19225779,76545705,03/14/2019
2010,Orleans,34,8099,5271574,2645,3166988,8438562,03/14/2019
2010,Oswego,35,24888,16052642,6691,7619753,23672395,03/14/2019
2010,Otsego,36,11496,5207513,4325,3580480,8787993,03/14/2019
2010,Putnam,37,23689,27546431,3374,7661749,35208180,03/14/2019
2010,Rensselaer,38,30688,15464735,7684,7204778,22669513,03/14/2019
2010,Rockland,39,54123,65706379,9495,22568564,88274943,03/14/2019
2010,St. Lawrence,40,21857,11694687,6853,6327506,18022193,03/14/2019
2010,Saratoga,41,47839,28324024,9729,10876877,39200901,03/14/2019
2010,Schenectady,42,30838,16594407,7976,8076687,24671094,03/14/2019
2010,Schoharie,43,6548,3491180,2265,2182309,5673489,03/14/2019
2010,Schuyler,44,4135,1945600,1423,1176882,3122482,03/14/2019
2010,Seneca,45,6635,4084005,2305,2653286,6737291,03/14/2019
2010,Steuben,46,20364,11738739,6584,6615209,18353948,03/14/2019
2010,Suffolk,47,301509,296192263,56523,104878133,401070396,03/14/2019
2010,Sullivan,48,12900,6560554,4036,3690731,10251285,03/14/2019
2010,Tioga,49,10736,5366153,3569,3362422,8728575,03/14/2019
2010,Tompkins,50,16131,8778032,3323,3194054,11972086,03/14/2019
2010,Ulster,51,34328,20697639,9281,10458740,31156379,03/14/2019
2010,Warren,52,13522,5302097,4217,2963165,8265262,03/14/2019
2010,Washington,53,12375,5508666,4289,3498442,9007108,03/14/2019
2010,Wayne,54,20327,13097392,5530,6523230,19620622,03/14/2019
2010,Westchester,55,152253,251808729,24085,73126332,324935061,03/14/2019
2010,Wyoming,56,8645,4381586,2367,2321185,6702771,03/14/2019
2010,Yates,57,4980,1757497,1798,1161050,2918547,03/14/2019
2010,New York City,65,611233,166552595,106018,54022420,220575015,03/14/2019
2009,Albany,01,54845,28817673,13073,12836783,41654456,03/14/2019
2009,Allegany,02,9252,5324128,3487,3259933,8584061,03/14/2019
2009,Broome,03,37151,25008256,12895,15878730,40886986,03/14/2019
2009,Cattaraugus,04,15972,8110646,5386,4600409,12711055,03/14/2019
2009,Cayuga,05,15662,8475710,4942,4876505,13352215,03/14/2019
2009,Chautauqua,06,26062,14420122,9102,8879497,23299619,03/14/2019
2009,Chemung,07,16782,9529121,5723,5950991,15480112,03/14/2019
2009,Chenango,08,10372,5405401,3549,3356750,8762151,03/14/2019
2009,Clinton,09,15649,8082860,4268,3953238,12036098,03/14/2019
2009,Columbia,10,11889,5377749,3493,2823103,8200852,03/14/2019
2009,Cortland,11,8736,4642633,2636,2637055,7279688,03/14/2019
2009,Delaware,12,8970,3742629,3881,2970524,6713153,03/14/2019
2009,Dutchess,13,55730,37084642,11141,14140824,51225466,03/14/2019
2009,Erie,14,178452,87002836,53950,49178089,136180925,03/14/2019
2009,Essex,15,7908,2952033,3031,1974230,4926263,03/14/2019
2009,Franklin,16,8963,3764363,2938,2148229,5912592,03/14/2019
2009,Fulton,17,11134,5585692,3970,3440483,9026175,03/14/2019
2009,Genesee,18,12204,8122923,3702,4592998,12715921,03/14/2019
2009,Greene,19,9164,4114100,3261,2600275,6714375,03/14/2019
2009,Hamilton,20,1231,256556,608,241226,497782,03/14/2019
2009,Herkimer,21,12546,6612387,4653,4524779,11137166,03/14/2019
2009,Jefferson,22,18579,6228661,5142,3058064,9286725,03/14/2019
2009,Lewis,23,5941,2169954,1841,1157837,3327791,03/14/2019
2009,Livingston,24,12716,7492747,3446,3747567,11240314,03/14/2019
2009,Madison,25,14637,8479647,4042,4297238,12776885,03/14/2019
2009,Monroe,26,151677,94179938,34672,41990992,136170930,03/14/2019
2009,Montgomery,27,9402,5474864,3567,3777374,9252238,03/14/2019
2009,Nassau,28,278792,257716377,48129,87515521,345231898,03/14/2019
2009,Niagara,29,43321,26501312,13897,15360669,41861981,03/14/2019
2009,Oneida,30,43388,26121587,14713,15983010,42104597,03/14/2019
2009,Onondaga,31,93922,58427877,24258,28111103,86538980,03/14/2019
2009,Ontario,32,22274,12687390,5589,6116170,18803560,03/14/2019
2009,Orange,33,69431,52804402,11567,17151366,69955768,03/14/2019
2009,Orleans,34,8201,5418075,2630,3148443,8566518,03/14/2019
2009,Oswego,35,24990,16413640,6668,7652651,24066291,03/14/2019
2009,Otsego,36,11622,5684580,4228,3697650,9382230,03/14/2019
2009,Putnam,37,23733,25347709,3292,6900907,32248616,03/14/2019
2009,Rensselaer,38,30894,16857711,7531,7358920,24216631,03/14/2019
2009,Rockland,39,54201,60789435,9335,20665813,81455248,03/14/2019
2009,St. Lawrence,40,21819,12001549,6946,6490826,18492375,03/14/2019
2009,Saratoga,41,47957,26272383,9367,9690183,35962566,03/14/2019
2009,Schenectady,42,31009,18411014,7897,8499954,26910968,03/14/2019
2009,Schoharie,43,6600,3585180,2240,2141393,5726573,03/14/2019
2009,Schuyler,44,4141,2061886,1434,1221501,3283387,03/14/2019
2009,Seneca,45,6689,4326393,2315,2752320,7078713,03/14/2019
2009,Steuben,46,20403,11786262,6570,6494079,18280341,03/14/2019
2009,Suffolk,47,302176,266641720,56369,93850398,360492118,03/14/2019
2009,Sullivan,48,13066,7316449,4063,3983076,11299525,03/14/2019
2009,Tioga,49,10962,5970894,3363,3353265,9324159,03/14/2019
2009,Tompkins,50,16232,8574093,3287,3042501,11616594,03/14/2019
2009,Ulster,51,34666,20296916,9093,9638753,29935669,03/14/2019
2009,Warren,52,13784,5961686,4045,3081568,9043254,03/14/2019
2009,Washington,53,12506,6305146,4180,3773363,10078509,03/14/2019
2009,Wayne,54,20359,13029893,5435,6309038,19338931,03/14/2019
2009,Westchester,55,152514,248645171,23735,69741785,318386956,03/14/2019
2009,Wyoming,56,8705,4404363,2367,2314334,6718697,03/14/2019
2009,Yates,57,5036,1842213,1757,1152621,2994834,03/14/2019
2009,New York City,65,616034,141318791,103456,44600531,185919322,03/14/2019
2008,Albany,01,54357,30387667,13446,13626949,44014616,03/15/2016
2008,Allegany,02,9227,5334828,3453,3136878,8471706,03/15/2016
2008,Broome,03,36813,25949281,13074,16336532,42285813,03/15/2016
2008,Cattaraugus,04,15778,8377910,5421,4536325,12914235,03/15/2016
2008,Cayuga,05,15565,9036324,4981,5071510,14107834,03/15/2016
2008,Chautauqua,06,25888,14606770,9268,8858634,23465404,03/15/2016
2008,Chemung,07,16689,9810395,5871,6002769,15813164,03/15/2016
2008,Chenango,08,10352,5863914,3517,3422163,9286077,03/15/2016
2008,Clinton,09,15583,8397711,4290,3935628,12333339,03/15/2016
2008,Columbia,10,11823,5817882,3547,3093597,8911479,03/15/2016
2008,Cortland,11,8685,4997452,2633,2701242,7698694,03/15/2016
2008,Delaware,12,8915,4007878,3913,3144875,7152753,03/15/2016
2008,Dutchess,13,55074,36971245,11341,13871252,50842497,03/15/2016
2008,Erie,14,176224,87012022,54392,47595422,134607444,03/15/2016
2008,Essex,15,7946,3301034,3009,2096492,5397526,03/15/2016
2008,Franklin,16,8949,4081800,2944,2213343,6295143,03/15/2016
2008,Fulton,17,11168,6071684,3984,3580537,9652221,03/15/2016
2008,Genesee,18,12161,8256694,3731,4478904,12735598,03/15/2016
2008,Greene,19,9130,4576640,3216,2844871,7421511,03/15/2016
2008,Hamilton,20,1245,268085,608,242166,510251,03/15/2016
2008,Herkimer,21,12436,6927782,4784,4669688,11597470,03/15/2016
2008,Jefferson,22,18182,6866050,5235,3411280,10277330,03/15/2016
2008,Lewis,23,5862,2392896,1906,1287610,3680506,03/15/2016
2008,Livingston,24,12695,7629238,3452,3626951,11256189,03/15/2016
2008,Madison,25,14560,8745372,4035,4215309,12960681,03/15/2016
2008,Monroe,26,150884,96745423,34917,41397424,138142847,03/15/2016
2008,Montgomery,27,9327,5871407,3644,4024436,9895843,03/15/2016
2008,Nassau,28,274151,243903449,49992,90489258,334392707,03/15/2016
2008,Niagara,29,43104,26986103,14026,15117920,42104023,03/15/2016
2008,Oneida,30,43095,27945412,14979,16525793,44471205,03/15/2016
2008,Onondaga,31,93479,59427498,24428,27505957,86933455,03/15/2016
2008,Ontario,32,22119,13363037,5517,6001295,19364332,03/15/2016
2008,Orange,33,68715,49845569,11631,15954523,65800092,03/15/2016
2008,Orleans,34,8203,5604770,2656,3120366,8725136,03/15/2016
2008,Oswego,35,24863,16912697,6672,7594829,24507526,03/15/2016
2008,Otsego,36,11582,6239647,4261,4020458,10260105,03/15/2016
2008,Putnam,37,23633,23485728,3281,6106904,29592632,03/15/2016
2008,Rensselaer,38,30742,18707260,7601,8107233,26814493,03/15/2016
2008,Rockland,39,53846,58980732,9470,19343086,78323818,03/15/2016
2008,St. Lawrence,40,21821,12673145,6968,6494125,19167270,03/15/2016
2008,Saratoga,41,47502,27263946,9336,9606229,36870175,03/15/2016
2008,Schenectady,42,30857,20935779,8172,9963633,30899412,03/15/2016
2008,Schoharie,43,6535,3970030,2240,2319788,6289818,03/15/2016
2008,Schuyler,44,4119,2291758,1435,1303585,3595343,03/15/2016
2008,Seneca,45,6652,4528655,2352,2791213,7319868,03/15/2016
2008,Steuben,46,20358,12353701,6553,6466929,18820630,03/15/2016
2008,Suffolk,47,299670,267811142,56553,90541234,358352376,03/15/2016
2008,Sullivan,48,13065,8064278,4062,4343582,12407860,03/15/2016
2008,Tioga,49,10886,6601798,3393,3574645,10176443,03/15/2016
2008,Tompkins,50,16125,8554770,3298,2932664,11487434,03/15/2016
2008,Ulster,51,34270,21275485,9189,10083341,31358826,03/15/2016
2008,Warren,52,13719,6633878,4050,3394083,10027961,03/15/2016
2008,Washington,53,12447,7421403,4195,4406244,11827647,03/15/2016
2008,Wayne,54,20288,13530234,5436,6269585,19799819,03/15/2016
2008,Westchester,55,151406,266755182,24061,74831966,341587148,03/15/2016
2008,Wyoming,56,8702,4666645,2395,2344250,7010895,03/15/2016
2008,Yates,57,5057,2046892,1782,1247379,3294271,03/15/2016
2008,New York City,65,606485,114803497,101297,33948657,148752154,03/15/2016
2007,Albany,01,53373,32086099,13725,14754679,46840778,03/15/2016
2007,Allegany,02,9112,5521140,3492,3242333,8763473,03/15/2016
2007,Broome,03,36158,27503393,13301,17436958,44940351,03/15/2016
2007,Cattaraugus,04,15694,8794867,5443,4684063,13478930,03/15/2016
2007,Cayuga,05,15414,9498085,4997,5325176,14823261,03/15/2016
2007,Chautauqua,06,25650,15189844,9237,9293180,24483024,03/15/2016
2007,Chemung,07,16425,10187857,5949,6287429,16475286,03/15/2016
2007,Chenango,08,10208,6232819,3495,3559952,9792771,03/15/2016
2007,Clinton,09,15489,9286997,4209,4212260,13499257,03/15/2016
2007,Columbia,10,11614,6130995,3614,3363622,9494617,03/15/2016
2007,Cortland,11,8684,5312448,2629,2822036,8134484,03/15/2016
2007,Delaware,12,8770,4263917,3915,3354390,7618307,03/15/2016
2007,Dutchess,13,53745,38765242,11157,14578459,53343701,03/15/2016
2007,Erie,14,174303,89846839,55252,49719318,139566157,03/15/2016
2007,Essex,15,7833,3428908,2973,2161332,5590240,03/15/2016
2007,Franklin,16,8861,4380568,2924,2320307,6700875,03/15/2016
2007,Fulton,17,11028,6295957,3874,3481235,9777192,03/15/2016
2007,Genesee,18,12059,8729581,3705,4674549,13404130,03/15/2016
2007,Greene,19,8973,4916301,3204,3049933,7966234,03/15/2016
2007,Hamilton,20,1253,308148,595,269243,577391,03/15/2016
2007,Herkimer,21,12227,7384436,4815,4929827,12314263,03/15/2016
2007,Jefferson,22,17633,7190435,5226,3567194,10757629,03/15/2016
2007,Lewis,23,5795,2563975,1878,1341981,3905956,03/15/2016
2007,Livingston,24,12591,7874097,3408,3699883,11573980,03/15/2016
2007,Madison,25,14427,9221477,4017,4383867,13605344,03/15/2016
2007,Monroe,26,148908,98838213,34857,42468803,141307016,03/15/2016
2007,Montgomery,27,9212,6397859,3613,4259689,10657548,03/15/2016
2007,Nassau,28,268233,259648331,51016,100942612,360590943,03/15/2016
2007,Niagara,29,42387,27890940,14141,15711816,43602756,03/15/2016
2007,Oneida,30,42488,29041148,15235,17302763,46343911,03/15/2016
2007,Onondaga,31,91927,62294461,24890,29133360,91427821,03/15/2016
2007,Ontario,32,21644,13782242,5449,6184704,19966946,03/15/2016
2007,Orange,33,67345,53038191,11536,17013710,70051901,03/15/2016
2007,Orleans,34,8074,5661536,2638,3148533,8810069,03/15/2016
2007,Oswego,35,24592,17148319,6625,7520484,24668803,03/15/2016
2007,Otsego,36,11456,6714191,4239,4289843,11004034,03/15/2016
2007,Putnam,37,23332,25117822,3210,6440782,31558604,03/15/2016
2007,Rensselaer,38,30175,20285538,7609,8678549,28964087,03/15/2016
2007,Rockland,39,53279,61943500,9385,20245102,82188602,03/15/2016
2007,St. Lawrence,40,21648,13034681,6876,6484452,19519133,03/15/2016
2007,Saratoga,41,46521,29084261,9226,10238992,39323253,03/15/2016
2007,Schenectady,42,30513,21773519,7961,10165183,31938702,03/15/2016
2007,Schoharie,43,6427,4198844,2234,2434207,6633051,03/15/2016
2007,Schuyler,44,4051,2389476,1425,1331590,3721066,03/15/2016
2007,Seneca,45,6576,4719391,2357,2885597,7604988,03/15/2016
2007,Steuben,46,20095,12403737,6545,6399527,18803264,03/15/2016
2007,Suffolk,47,293943,279175202,56580,95630465,374805667,03/15/2016
2007,Sullivan,48,12838,8618539,4061,4627903,13246442,03/15/2016
2007,Tioga,49,10811,7103223,3354,3759561,10862784,03/15/2016
2007,Tompkins,50,15901,9653333,3285,3235155,12888488,03/15/2016
2007,Ulster,51,33579,22033936,9295,10629784,32663720,03/15/2016
2007,Warren,52,13567,7068329,4029,3592780,10661109,03/15/2016
2007,Washington,53,12221,8085050,4129,4705236,12790286,03/15/2016
2007,Wayne,54,20172,13957950,5409,6376105,20334055,03/15/2016
2007,Westchester,55,148697,273891295,24668,79061385,352952680,03/15/2016
2007,Wyoming,56,8677,4767501,2369,2352375,7119876,03/15/2016
2007,Yates,57,5015,2213723,1804,1359309,3573032,03/15/2016
2007,New York City,65,599439,113239910,97501,32718922,145958832,03/15/2016
2006,Albany,01,52203,32537299,13889,15378801,47916100,03/15/2016
2006,Allegany,02,8955,5630197,3492,3300660,8930857,03/15/2016
2006,Broome,03,35624,27644819,13517,17845018,45489837,03/15/2016
2006,Cattaraugus,04,15470,8472728,5557,4604944,13077672,03/15/2016
2006,Cayuga,05,15174,9622659,5029,5411350,15034009,03/15/2016
2006,Chautauqua,06,25329,15505620,9233,9414950,24920570,03/15/2016
2006,Chemung,07,16097,10364766,6045,6577311,16942077,03/15/2016
2006,Chenango,08,10121,6374506,3382,3484704,9859210,03/15/2016
2006,Clinton,09,15255,9439311,4196,4303069,13742380,03/15/2016
2006,Columbia,10,11405,6076373,3550,3313631,9390004,03/15/2016
2006,Cortland,11,8556,5328852,2637,2842212,8171064,03/15/2016
2006,Delaware,12,8623,4340894,3865,3399592,7740486,03/15/2016
2006,Dutchess,13,52331,37329752,11185,14662904,51992656,03/15/2016
2006,Erie,14,171103,89885706,55679,50872178,140757884,03/15/2016
2006,Essex,15,7710,3502767,2931,2164182,5666949,03/15/2016
2006,Franklin,16,8749,4503123,2916,2346146,6849269,03/15/2016
2006,Fulton,17,10804,6281412,3883,3515416,9796828,03/15/2016
2006,Genesee,18,11956,8917124,3714,4794571,13711695,03/15/2016
2006,Greene,19,8715,4933005,3212,3131791,8064796,03/15/2016
2006,Hamilton,20,1250,335198,583,280114,615312,03/15/2016
2006,Herkimer,21,12056,7412995,4818,4897809,12310804,03/15/2016
2006,Jefferson,22,16999,7095560,5236,3594453,10690013,03/15/2016
2006,Lewis,23,5715,2588981,1860,1309960,3898941,03/15/2016
2006,Livingston,24,12417,8068339,3393,3786375,11854714,03/15/2016
2006,Madison,25,14176,9449589,3978,4451904,13901493,03/15/2016
2006,Monroe,26,147746,99209855,34596,42451428,141661283,03/15/2016
2006,Montgomery,27,8979,6442842,3688,4408238,10851080,03/15/2016
2006,Nassau,28,263780,258102957,52150,104232544,362335501,03/15/2016
2006,Niagara,29,41880,28219902,14129,15748597,43968499,03/15/2016
2006,Oneida,30,41759,29332663,15279,17497981,46830644,03/15/2016
2006,Onondaga,31,90409,62773597,25125,29772233,92545830,03/15/2016
2006,Ontario,32,21262,13732977,5369,6100412,19833389,03/15/2016
2006,Orange,33,65937,53167583,11668,17438068,70605651,03/15/2016
2006,Orleans,34,8120,6080386,2520,3147513,9227899,03/15/2016
2006,Oswego,35,24148,17208804,6560,7605840,24814644,03/15/2016
2006,Otsego,36,11293,6776755,4204,4269784,11046539,03/15/2016
2006,Putnam,37,22881,25536680,3212,6646882,32183562,03/15/2016
2006,Rensselaer,38,29494,20312929,7785,8963285,29276214,03/15/2016
2006,Rockland,39,52444,62271355,9426,20710911,82982266,03/15/2016
2006,St. Lawrence,40,21361,12951600,6837,6355215,19306815,03/15/2016
2006,Saratoga,41,45195,28658584,9269,10282610,38941194,03/15/2016
2006,Schenectady,42,29571,21656369,8107,10198406,31854775,03/15/2016
2006,Schoharie,43,6295,4161828,2168,2353610,6515438,03/15/2016
2006,Schuyler,44,3973,2332598,1443,1336462,3669060,03/15/2016
2006,Seneca,45,6507,4624220,2313,2804196,7428416,03/15/2016
2006,Steuben,46,19800,12405764,6576,6433892,18839656,03/15/2016
2006,Suffolk,47,290269,277310857,56784,95667038,372977895,03/15/2016
2006,Sullivan,48,12458,8750814,4157,4927162,13677976,03/15/2016
2006,Tioga,49,10653,7404645,3349,3914034,11318679,03/15/2016
2006,Tompkins,50,15719,9803541,3299,3287368,13090909,03/15/2016
2006,Ulster,51,32878,22053682,9319,10842476,32896158,03/15/2016
2006,Warren,52,13230,7180481,4037,3718334,10898815,03/15/2016
2006,Washington,53,11978,8138579,4072,4713286,12851865,03/15/2016
2006,Wayne,54,20026,14230510,5351,6408710,20639220,03/15/2016
2006,Westchester,55,146193,267304632,24997,78034829,345339461,03/15/2016
2006,Wyoming,56,8580,4787449,2373,2374100,7161549,03/15/2016
2006,Yates,57,4924,2252111,1794,1387571,3639682,03/15/2016
2006,New York City,65,607892,126551201,95158,34854135,161405336,03/15/2016
2005,Albany,01,51197,31991194,14190,13972681,45963875,03/15/2016
2005,Allegany,02,8894,5553109,3502,3064071,8617180,03/15/2016
2005,Broome,03,34903,26504024,13834,16099114,42603138,03/15/2016
2005,Cattaraugus,04,15331,8480059,5584,4274879,12754938,03/15/2016
2005,Cayuga,05,15025,9554361,5099,4921802,14476163,03/15/2016
2005,Chautauqua,06,25143,15468919,9250,8595265,24064184,03/15/2016
2005,Chemung,07,15933,10091251,6045,5870099,15961350,03/15/2016
2005,Chenango,08,9967,6252159,3393,3141460,9393619,03/15/2016
2005,Clinton,09,14975,9024165,4217,3805250,12829415,03/15/2016
2005,Columbia,10,11165,5869459,3719,3109278,8978737,03/15/2016
2005,Cortland,11,8404,5193859,2664,2534496,7728355,03/15/2016
2005,Delaware,12,8491,4379648,3961,3190336,7569984,03/15/2016
2005,Dutchess,13,51162,36228882,11229,12947736,49176618,03/15/2016
2005,Erie,14,168443,90267735,56755,47095012,137362747,03/15/2016
2005,Essex,15,7627,3526276,2923,1982993,5509269,03/15/2016
2005,Franklin,16,8570,4450282,2981,2192439,6642721,03/15/2016
2005,Fulton,17,10640,6196559,3918,3233729,9430288,03/15/2016
2005,Genesee,18,11874,8802614,3702,4232329,13034943,03/15/2016
2005,Greene,19,8514,4827744,3232,2817453,7645197,03/15/2016
2005,Hamilton,20,1226,353612,598,270608,624220,03/15/2016
2005,Herkimer,21,11840,6915163,4854,4263580,11178743,03/15/2016
2005,Jefferson,22,16381,6980990,5282,3373599,10354589,03/15/2016
2005,Lewis,23,5606,2584798,1869,1207701,3792499,03/15/2016
2005,Livingston,24,12249,7713978,3316,3233608,10947586,03/15/2016
2005,Madison,25,13918,9233040,3928,3904072,13137112,03/15/2016
2005,Monroe,26,145627,97179374,35109,38191678,135371052,03/15/2016
2005,Montgomery,27,8778,6289213,3753,4081228,10370441,03/15/2016
2005,Nassau,28,263030,259032404,52722,93518534,352550938,03/15/2016
2005,Niagara,29,41191,27673455,14270,14095021,41768476,03/15/2016
2005,Oneida,30,41027,28655758,15642,16105335,44761093,03/15/2016
2005,Onondaga,31,89342,61881293,25476,26947432,88828725,03/15/2016
2005,Ontario,32,20811,13476712,5382,5490618,18967330,03/15/2016
2005,Orange,33,64250,51821083,11790,15638189,67459272,03/15/2016
2005,Orleans,34,8007,6025752,2550,2891353,8917105,03/15/2016
2005,Oswego,35,23820,17037431,6599,6989712,24027143,03/15/2016
2005,Otsego,36,11169,6643704,4210,3842299,10486003,03/15/2016
2005,Putnam,37,22465,25218907,3226,5922008,31140915,03/15/2016
2005,Rensselaer,38,28815,20242896,7919,8377195,28620091,03/15/2016
2005,Rockland,39,52140,59056589,9620,17644913,76701502,03/15/2016
2005,St. Lawrence,40,20974,12343049,6945,5804902,18147951,03/15/2016
2005,Saratoga,41,44126,28247989,9363,9341633,37589622,03/15/2016
2005,Schenectady,42,28907,21411991,8468,9970667,31382658,03/15/2016
2005,Schoharie,43,6189,3968348,2163,2037561,6005909,03/15/2016
2005,Schuyler,44,3909,2227337,1466,1211627,3438964,03/15/2016
2005,Seneca,45,6355,4447387,2397,2568869,7016256,03/15/2016
2005,Steuben,46,19600,11597993,6609,5548565,17146558,03/15/2016
2005,Suffolk,47,287777,273553470,56571,84286136,357839606,03/15/2016
2005,Sullivan,48,12047,8499315,4229,4522526,13021841,03/15/2016
2005,Tioga,49,10574,7222599,3332,3399289,10621888,03/15/2016
2005,Tompkins,50,15532,9915414,3255,2977711,12893125,03/15/2016
2005,Ulster,51,32296,22146696,9406,9951567,32098263,03/15/2016
2005,Warren,52,12947,7153173,4002,3338152,10491325,03/15/2016
2005,Washington,53,11652,7748907,4117,4152355,11901262,03/15/2016
2005,Wayne,54,19820,14150992,5281,5654388,19805380,03/15/2016
2005,Westchester,55,143481,256272506,25786,70835488,327107994,03/15/2016
2005,Wyoming,56,8546,4827633,2361,2137892,6965525,03/15/2016
2005,Yates,57,4900,2326418,1770,1267423,3593841,03/15/2016
2005,New York City,65,628375,134729159,91171,30631492,165360651,03/15/2016
2004,Albany,01,50066,30657702,14340,13772269,44429971,03/15/2016
2004,Allegany,02,8774,5334940,3519,2983212,8318152,03/15/2016
2004,Broome,03,34225,25900046,14036,16013336,41913382,03/15/2016
2004,Cattaraugus,04,15290,8226219,5709,4194732,12420951,03/15/2016
2004,Cayuga,05,14893,9357287,5151,4856497,14213784,03/15/2016
2004,Chautauqua,06,24866,15220216,9404,8620740,23840956,03/15/2016
2004,Chemung,07,15655,9507131,6142,5688434,15195565,03/15/2016
2004,Chenango,08,9801,6095791,3408,3101207,9196998,03/15/2016
2004,Clinton,09,14678,8533494,4178,3618073,12151567,03/15/2016
2004,Columbia,10,10951,5835943,3833,3185112,9021055,03/15/2016
2004,Cortland,11,8253,4955718,2676,2452720,7408438,03/15/2016
2004,Delaware,12,8358,4423253,3904,3195315,7618568,03/15/2016
2004,Dutchess,13,49753,33924554,11456,12634099,46558653,03/15/2016
2004,Erie,14,165933,88928923,57237,47209652,136138575,03/15/2016
2004,Essex,15,7466,3374714,2932,1942687,5317401,03/15/2016
2004,Franklin,16,8402,4129954,2962,2055585,6185539,03/15/2016
2004,Fulton,17,10438,5966139,3982,3181882,9148021,03/15/2016
2004,Genesee,18,11770,8624252,3737,4181983,12806235,03/15/2016
2004,Greene,19,8354,4627604,3228,2752677,7380281,03/15/2016
2004,Hamilton,20,1216,352933,619,281476,634409,03/15/2016
2004,Herkimer,21,11662,6650644,4931,4198385,10849029,03/15/2016
2004,Jefferson,22,15942,6668710,5439,3396819,10065529,03/15/2016
2004,Lewis,23,5509,2459033,1889,1167007,3626040,03/15/2016
2004,Livingston,24,12090,7568761,3290,3190179,10758940,03/15/2016
2004,Madison,25,13619,8734376,3889,3706225,12440601,03/15/2016
2004,Monroe,26,143560,95472975,34709,37381274,132854249,03/15/2016
2004,Montgomery,27,8511,5957049,3804,4019999,9977048,03/15/2016
2004,Nassau,28,254610,245613319,53277,92675528,338288847,03/15/2016
2004,Niagara,29,40323,27201963,14565,14329575,41531538,03/15/2016
2004,Oneida,30,40172,27427973,16035,16165375,43593348,03/15/2016
2004,Onondaga,31,87839,59641576,25887,26504047,86145623,03/15/2016
2004,Ontario,32,20352,13253429,5367,5490311,18743740,03/15/2016
2004,Orange,33,62193,49569833,11723,15102526,64672359,03/15/2016
2004,Orleans,34,7832,5933196,2576,2931398,8864594,03/15/2016
2004,Oswego,35,23402,15847068,6660,6669932,22517000,03/15/2016
2004,Otsego,36,10965,6481515,4241,3832652,10314167,03/15/2016
2004,Putnam,37,22030,24085520,3204,5713582,29799102,03/15/2016
2004,Rensselaer,38,28280,19807529,8049,8296618,28104147,03/15/2016
2004,Rockland,39,51337,56517083,9378,16708522,73225605,03/15/2016
2004,St. Lawrence,40,20684,11699698,6958,5568935,17268633,03/15/2016
2004,Saratoga,41,42921,27575575,9178,9119234,36694809,03/15/2016
2004,Schenectady,42,28257,20368319,8716,9931477,30299796,03/15/2016
2004,Schoharie,43,6130,3629045,2127,1857609,5486654,03/15/2016
2004,Schuyler,44,3842,2124435,1450,1150306,3274741,03/15/2016
2004,Seneca,45,6247,4136603,2396,2428494,6565097,03/15/2016
2004,Steuben,46,19356,11296087,6674,5481608,16777695,03/15/2016
2004,Suffolk,47,281431,263414967,57350,83698436,347113403,03/15/2016
2004,Sullivan,48,11775,8171514,4173,4343351,12514865,03/15/2016
2004,Tioga,49,10348,6746517,3324,3199985,9946502,03/15/2016
2004,Tompkins,50,15315,9874416,3335,3020915,12895331,03/15/2016
2004,Ulster,51,31599,21898498,9299,9837644,31736142,03/15/2016
2004,Warren,52,12703,6473339,3953,3115023,9588362,03/15/2016
2004,Washington,53,11402,7260231,4093,3938163,11198394,03/15/2016
2004,Wayne,54,19448,13919856,5254,5539168,19459024,03/15/2016
2004,Westchester,55,140619,239322144,25312,68215283,307537427,03/15/2016
2004,Wyoming,56,8432,4677187,2396,2106618,6783805,03/15/2016
2004,Yates,57,4786,2195040,1799,1238744,3433784,03/15/2016
2004,New York City,65,540457,118009441,97990,33849054,151858495,03/15/2016
2003,Albany,01,49073,29396897,14366,13395649,42792546,03/15/2016
2003,Allegany,02,8533,4958618,3511,2817232,7775850,03/15/2016
2003,Broome,03,33536,24928886,13994,15518034,40446920,03/15/2016
2003,Cattaraugus,04,14861,7646375,5752,4030288,11676663,03/15/2016
2003,Cayuga,05,14636,8857236,5039,4672609,13529845,03/15/2016
2003,Chautauqua,06,24554,14759437,9398,8403133,23162570,03/15/2016
2003,Chemung,07,15396,8951082,6166,5402784,14353866,03/15/2016
2003,Chenango,08,9659,5993357,3360,2997333,8990690,03/15/2016
2003,Clinton,09,14220,7897684,4181,3434282,11331966,03/15/2016
2003,Columbia,10,10625,5560795,3877,3189457,8750252,03/15/2016
2003,Cortland,11,8062,4701499,2667,2362664,7064163,03/15/2016
2003,Delaware,12,8245,4363376,3855,3095435,7458811,03/15/2016
2003,Dutchess,13,48312,32004461,11548,12369622,44374083,03/15/2016
2003,Erie,14,160997,84736778,57729,46460208,131196986,03/15/2016
2003,Essex,15,7331,3041941,2943,1777814,4819755,03/15/2016
2003,Franklin,16,8195,3912472,2973,1958955,5871427,03/15/2016
2003,Fulton,17,10273,5559098,3979,3052007,8611105,03/15/2016
2003,Genesee,18,11452,8116739,3701,3994705,12111444,03/15/2016
2003,Greene,19,8226,4362348,3200,2605872,6968220,03/15/2016
2003,Hamilton,20,1210,349072,617,279389,628461,03/15/2016
2003,Herkimer,21,11495,6208325,4917,3936171,10144496,03/15/2016
2003,Jefferson,22,15440,6305166,5461,3306202,9611368,03/15/2016
2003,Lewis,23,5379,2317274,1874,1104626,3421900,03/15/2016
2003,Livingston,24,11893,7192653,3287,3082501,10275154,03/15/2016
2003,Madison,25,13344,8133634,3821,3439614,11573248,03/15/2016
2003,Monroe,26,140993,91729593,34808,36656096,128385689,03/15/2016
2003,Montgomery,27,8340,5779402,3872,3960413,9739815,03/15/2016
2003,Nassau,28,251474,227387713,52025,84786966,312174679,03/15/2016
2003,Niagara,29,39333,25870132,14438,13870331,39740463,03/15/2016
2003,Oneida,30,39257,25709214,16144,15467883,41177097,03/15/2016
2003,Onondaga,31,86572,55853572,25650,24853818,80707390,03/15/2016
2003,Ontario,32,19707,12641031,5339,5323083,17964114,03/15/2016
2003,Orange,33,60150,45689020,11949,14526106,60215126,03/15/2016
2003,Orleans,34,7639,5402136,2542,2729690,8131826,03/15/2016
2003,Oswego,35,22976,15260814,6596,6393893,21654707,03/15/2016
2003,Otsego,36,10732,6254315,4247,3740074,9994389,03/15/2016
2003,Putnam,37,21212,20858463,3193,5122167,25980630,03/15/2016
2003,Rensselaer,38,27570,18829954,8014,8128163,26958117,03/15/2016
2003,Rockland,39,50811,53994156,9231,15827523,69821679,03/15/2016
2003,St. Lawrence,40,20434,10798190,6920,5122415,15920605,03/15/2016
2003,Saratoga,41,41600,26024045,9089,8687176,34711221,03/15/2016
2003,Schenectady,42,27786,19399003,8747,9517778,28916781,03/15/2016
2003,Schoharie,43,5955,3319001,2126,1728048,5047049,03/15/2016
2003,Schuyler,44,3732,1996412,1437,1091058,3087470,03/15/2016
2003,Seneca,45,6168,3822892,2416,2255342,6078234,03/15/2016
2003,Steuben,46,19103,10588793,6636,5204928,15793721,03/15/2016
2003,Suffolk,47,272706,244448357,57433,80793259,325241616,03/15/2016
2003,Sullivan,48,11559,7845063,4202,4284496,12129559,03/15/2016
2003,Tioga,49,10133,6701088,3295,3125996,9827084,03/15/2016
2003,Tompkins,50,15116,9307957,3168,2767359,12075316,03/15/2016
2003,Ulster,51,30830,21099902,9473,9883639,30983541,03/15/2016
2003,Warren,52,12361,6288374,3983,3058724,9347098,03/15/2016
2003,Washington,53,11252,6892929,4009,3691962,10584891,03/15/2016
2003,Wayne,54,19252,13170882,5194,5243948,18414830,03/15/2016
2003,Westchester,55,137284,221603578,24925,63057451,284661029,03/15/2016
2003,Wyoming,56,8368,4547517,2362,2041880,6589397,03/15/2016
2003,Yates,57,4663,2124990,1805,1226165,3351155,03/15/2016
2003,New York City,65,471977,104674857,93358,32503644,137178501,03/15/2016
2002,Albany,01,47390,28228062,14484,13381996,41610058,03/15/2016
2002,Allegany,02,8180,4551754,3589,2672491,7224245,03/15/2016
2002,Broome,03,32752,23833907,13903,14920040,38753947,03/15/2016
2002,Cattaraugus,04,14322,6796376,5783,3737018,10533394,03/15/2016
2002,Cayuga,05,14254,8347032,5085,4507852,12854884,03/15/2016
2002,Chautauqua,06,23735,13545482,9657,8076985,21622467,03/15/2016
2002,Chemung,07,14941,8083955,6293,5114468,13198423,03/15/2016
2002,Chenango,08,9463,5714523,3307,2858128,8572651,03/15/2016
2002,Clinton,09,13656,7520159,4182,3313388,10833547,03/15/2016
2002,Columbia,10,10384,5294804,3787,3038903,8333707,03/15/2016
2002,Cortland,11,7808,4253386,2685,2220674,6474060,03/15/2016
2002,Delaware,12,8087,4056122,3844,2923743,6979865,03/15/2016
2002,Dutchess,13,47024,30192074,11082,11505657,41697731,03/15/2016
2002,Erie,14,157962,81050535,58270,45446726,126497261,03/15/2016
2002,Essex,15,7144,2813037,2988,1688228,4501265,03/15/2016
2002,Franklin,16,7921,3663554,3007,1907981,5571535,03/15/2016
2002,Fulton,17,9954,5324012,3973,2973696,8297708,03/15/2016
2002,Genesee,18,11182,7597117,3711,3837170,11434287,03/15/2016
2002,Greene,19,8022,4207673,3187,2563761,6771434,03/15/2016
2002,Hamilton,20,1192,338752,599,264456,603208,03/15/2016
2002,Herkimer,21,11174,5903716,5008,3884908,9788624,03/15/2016
2002,Jefferson,22,14986,5878698,5416,3114251,8992949,03/15/2016
2002,Lewis,23,5263,2154742,1840,1036663,3191405,03/15/2016
2002,Livingston,24,11539,6849249,3300,2990773,9840022,03/15/2016
2002,Madison,25,12915,7747570,3773,3284822,11032392,03/15/2016
2002,Monroe,26,137559,86002616,34266,34637000,120639616,03/15/2016
2002,Montgomery,27,8080,5529332,3883,3936143,9465475,03/15/2016
2002,Nassau,28,244890,208176824,51328,78919471,287096295,03/15/2016
2002,Niagara,29,38195,24363321,14500,13439324,37802645,03/15/2016
2002,Oneida,30,38351,23942384,16287,14739966,38682350,03/15/2016
2002,Onondaga,31,84834,52423508,25312,23286660,75710168,03/15/2016
2002,Ontario,32,19031,12070469,5272,5138918,17209387,03/15/2016
2002,Orange,33,57504,40935942,11903,13643775,54579717,03/15/2016
2002,Orleans,34,7521,4798405,2538,2435671,7234076,03/15/2016
2002,Oswego,35,22112,13864364,6496,5948295,19812659,03/15/2016
2002,Otsego,36,10453,5943959,4218,3608640,9552599,03/15/2016
2002,Putnam,37,20165,19418956,3132,4922450,24341406,03/15/2016
2002,Rensselaer,38,26834,17227532,7916,7511596,24739128,03/15/2016
2002,Rockland,39,49481,50014576,9115,15049135,65063711,03/15/2016
2002,St. Lawrence,40,19745,9987461,6867,4757202,14744663,03/15/2016
2002,Saratoga,41,39869,24568746,8949,8376873,32945619,03/15/2016
2002,Schenectady,42,26942,18093606,8778,8982646,27076252,03/15/2016
2002,Schoharie,43,5830,3077294,2106,1642514,4719808,03/15/2016
2002,Schuyler,44,3604,1749642,1436,977614,2727256,03/15/2016
2002,Seneca,45,5999,3389522,2321,1975413,5364935,03/15/2016
2002,Steuben,46,18797,10044523,6534,4847854,14892377,03/15/2016
2002,Suffolk,47,262947,227190036,56985,77385471,304575507,03/15/2016
2002,Sullivan,48,11143,7235018,4210,4072807,11307825,03/15/2016
2002,Tioga,49,9874,6090804,3253,2868765,8959569,03/15/2016
2002,Tompkins,50,14336,8957205,3216,2845631,11802836,03/15/2016
2002,Ulster,51,29923,19915499,9477,9491893,29407392,03/15/2016
2002,Warren,52,12017,5891535,3881,2870031,8761566,03/15/2016
2002,Washington,53,10934,6346623,3980,3460081,9806704,03/15/2016
2002,Wayne,54,18811,12415740,5059,4929176,17344916,03/15/2016
2002,Westchester,55,132720,203068440,25219,60711665,263780105,03/15/2016
2002,Wyoming,56,8199,4213953,2382,1921507,6135460,03/15/2016
2002,Yates,57,4530,2027967,1751,1167766,3195733,03/15/2016
2002,New York City,65,436371,89615422,87270,30033251,119648673,03/15/2016
2001,Albany,01,45869,26545770,14900,13266991,39812761,03/15/2016
2001,Allegany,02,8014,3910295,3485,2268229,6178524,03/15/2016
2001,Broome,03,31975,21641671,13992,13930626,35572297,03/15/2016
2001,Cattaraugus,04,13800,6065921,5738,3431157,9497078,03/15/2016
2001,Cayuga,05,13697,7398447,5086,4151898,11550345,03/15/2016
2001,Chautauqua,06,23128,12600087,9642,7628470,20228557,03/15/2016
2001,Chemung,07,14341,7574174,6360,5020241,12594415,03/15/2016
2001,Chenango,08,9203,5351130,3279,2675908,8027038,03/15/2016
2001,Clinton,09,13171,6778514,4187,3090685,9869199,03/15/2016
2001,Columbia,10,10226,5107600,3839,3046360,8153960,03/15/2016
2001,Cortland,11,7627,3964375,2594,2038551,6002926,03/15/2016
2001,Delaware,12,7803,3721296,3866,2758885,6480181,03/15/2016
2001,Dutchess,13,45465,27857730,11354,11336960,39194690,03/15/2016
2001,Erie,14,153421,76764768,59341,44949218,121713986,03/15/2016
2001,Essex,15,6958,2628639,3023,1633575,4262214,03/15/2016
2001,Franklin,16,7723,3408654,3017,1810373,5219027,03/15/2016
2001,Fulton,17,9649,5061367,3981,2946226,8007593,03/15/2016
2001,Genesee,18,10975,7208438,3731,3679544,10887982,03/15/2016
2001,Greene,19,7880,3904230,3217,2433407,6337637,03/15/2016
2001,Hamilton,20,1143,306444,636,263628,570072,03/15/2016
2001,Herkimer,21,10934,5425495,5015,3643366,9068861,03/15/2016
2001,Jefferson,22,14287,5536735,5498,3116227,8652962,03/15/2016
2001,Lewis,23,5157,2004836,1859,984854,2989690,03/15/2016
2001,Livingston,24,11292,6404531,3231,2758149,9162680,03/15/2016
2001,Madison,25,12613,7182736,3733,3086560,10269296,03/15/2016
2001,Monroe,26,133926,79798074,34677,33198669,112996743,03/15/2016
2001,Montgomery,27,7766,5233282,3997,3977245,9210527,03/15/2016
2001,Nassau,28,238133,192512136,53317,77855681,270367817,03/15/2016
2001,Niagara,29,36750,22805603,14659,13204964,36010567,03/15/2016
2001,Oneida,30,37269,22520677,16213,14218938,36739615,03/15/2016
2001,Onondaga,31,82211,48999090,25977,22834530,71833620,03/15/2016
2001,Ontario,32,18372,11239645,5212,4866704,16106349,03/15/2016
2001,Orange,33,55070,37679525,12027,13181961,50861486,03/15/2016
2001,Orleans,34,7216,4343969,2590,2351814,6695783,03/15/2016
2001,Oswego,35,21378,11827466,6517,5314755,17142221,03/15/2016
2001,Otsego,36,10177,5561267,4145,3392916,8954183,03/15/2016
2001,Putnam,37,18916,17824340,3144,4828191,22652531,03/15/2016
2001,Rensselaer,38,26030,16094107,8092,7317774,23411881,03/15/2016
2001,Rockland,39,48269,47040601,9248,14705271,61745872,03/15/2016
2001,St. Lawrence,40,19159,9308634,6885,4541896,13850530,03/15/2016
2001,Saratoga,41,38317,23329231,8889,8082851,31412082,03/15/2016
2001,Schenectady,42,26181,16949359,9367,9105773,26055132,03/15/2016
2001,Schoharie,43,5720,2779437,2039,1451555,4230992,03/15/2016
2001,Schuyler,44,3467,1527482,1420,906140,2433622,03/15/2016
2001,Seneca,45,5792,3137749,2298,1847042,4984791,03/15/2016
2001,Steuben,46,17923,9258798,6660,4695903,13954701,03/15/2016
2001,Suffolk,47,252565,205245129,57367,74969440,280214569,03/15/2016
2001,Sullivan,48,10677,6441739,4276,3817483,10259222,03/15/2016
2001,Tioga,49,9632,5623762,3203,2632956,8256718,03/15/2016
2001,Tompkins,50,15116,9105551,3171,2691072,11796623,03/15/2016
2001,Ulster,51,28844,18395121,9572,9113309,27508430,03/15/2016
2001,Warren,52,11385,5324342,3945,2784997,8109339,03/15/2016
2001,Washington,53,10532,5711803,4046,3271687,8983490,03/15/2016
2001,Wayne,54,18226,11378152,5057,4621349,15999501,03/15/2016
2001,Westchester,55,126946,185315029,26391,60477048,245792077,03/15/2016
2001,Wyoming,56,8122,3962247,2387,1819865,5782112,03/15/2016
2001,Yates,57,4340,1879455,1736,1115712,2995167,03/15/2016
2001,New York City,65,414252,80177184,99804,32250765,112427949,03/15/2016
2000,Albany,01,44580,16238277,15217,12875343,29113620,03/15/2016
2000,Allegany,02,7622,2301491,3504,2025827,4327318,03/15/2016
2000,Broome,03,31025,13828650,14334,13782552,27611202,03/15/2016
2000,Cattaraugus,04,13011,3747718,5729,3275072,7022790,03/15/2016
2000,Cayuga,05,13124,4426561,5115,3863878,8290439,03/15/2016
2000,Chautauqua,06,22345,7847974,9812,7312412,15160386,03/15/2016
2000,Chemung,07,14087,4897603,6449,4954908,9852511,03/15/2016
2000,Chenango,08,8844,3432198,3362,2630475,6062673,03/15/2016
2000,Clinton,09,12683,4260334,4139,2920410,7180744,03/15/2016
2000,Columbia,10,9825,3272582,3949,3100329,6372911,03/15/2016
2000,Cortland,11,7335,2438106,2622,1963964,4402070,03/15/2016
2000,Delaware,12,7468,2275138,3911,2626576,4901714,03/15/2016
2000,Dutchess,13,43627,17611416,11587,11424582,29035998,03/15/2016
2000,Erie,14,148482,47481473,60428,43301006,90782479,03/15/2016
2000,Essex,15,6706,1637998,3091,1591603,3229601,03/15/2016
2000,Franklin,16,7425,2143514,3010,1725191,3868705,03/15/2016
2000,Fulton,17,9248,3011016,4101,2722798,5733814,03/15/2016
2000,Genesee,18,10715,4443723,3748,3490635,7934358,03/15/2016
2000,Greene,19,7578,2384312,3301,2381972,4766284,03/15/2016
2000,Hamilton,20,1104,189349,663,262292,451641,03/15/2016
2000,Herkimer,21,10605,3443919,5052,3489456,6933375,03/15/2016
2000,Jefferson,22,13941,3598478,5475,3037814,6636292,03/15/2016
2000,Lewis,23,4967,1306012,1893,968625,2274637,03/15/2016
2000,Livingston,24,10814,3793153,3294,2587511,6380664,03/15/2016
2000,Madison,25,12117,4534077,3849,3064115,7598192,03/15/2016
2000,Monroe,26,128976,48852708,34990,31738275,80590983,03/15/2016
2000,Montgomery,27,7417,2917764,4134,3496562,6414326,03/15/2016
2000,Nassau,28,234188,124153698,54812,77500022,201653720,03/15/2016
2000,Niagara,29,35558,13972861,14774,12678841,26651702,03/15/2016
2000,Oneida,30,36124,14377598,16326,13851233,28228831,03/15/2016
2000,Onondaga,31,80145,30773562,26615,22482171,53255733,03/15/2016
2000,Ontario,32,17881,6961063,5205,4618384,11579447,03/15/2016
2000,Orange,33,53615,23863464,12371,13065296,36928760,03/15/2016
2000,Orleans,34,6935,2637605,2615,2196929,4834534,03/15/2016
2000,Oswego,35,20820,7270051,6570,4752226,12022277,03/15/2016
2000,Otsego,36,9710,3432850,4216,3307292,6740142,03/15/2016
2000,Putnam,37,18037,11137736,3261,4893400,16031136,03/15/2016
2000,Rensselaer,38,25083,9933446,8357,7223171,17156617,03/15/2016
2000,Rockland,39,46994,31144831,9336,14644380,45789211,03/15/2016
2000,St. Lawrence,40,18290,5887207,7004,4327014,10214221,03/15/2016
2000,Saratoga,41,36980,14805631,8913,7804339,22609970,03/15/2016
2000,Schenectady,42,25728,10016226,9560,8500052,18516278,03/15/2016
2000,Schoharie,43,5530,1709494,2088,1405086,3114580,03/15/2016
2000,Schuyler,44,3327,954704,1399,854058,1808762,03/15/2016
2000,Seneca,45,5459,1773145,2383,1706552,3479697,03/15/2016
2000,Steuben,46,16678,5605848,6656,4513622,10119470,03/15/2016
2000,Suffolk,47,244061,127985201,58515,72192117,200177318,03/15/2016
2000,Sullivan,48,10357,4014198,4474,3762804,7777002,03/15/2016
2000,Tioga,49,9230,3528299,3213,2549765,6078064,03/15/2016
2000,Tompkins,50,12989,5102106,3170,2596796,7698902,03/15/2016
2000,Ulster,51,27963,11392297,9789,8869140,20261437,03/15/2016
2000,Warren,52,11013,3190708,4050,2615838,5806546,03/15/2016
2000,Washington,53,10170,3508121,4074,3163124,6671245,03/15/2016
2000,Wayne,54,17711,6869480,5022,4237838,11107318,03/15/2016
2000,Westchester,55,119700,117004877,27283,59819923,176824800,03/15/2016
2000,Wyoming,56,8029,2541326,2436,1793605,4334931,03/15/2016
2000,Yates,57,4180,1173480,1756,1080273,2253753,03/15/2016
2000,New York City,65,401880,52382626,114159,37053488,89436114,03/15/2016
1999,Albany,01,42694,7664211,15636,12922147,20586358,03/15/2016
1999,Allegany,02,7316,1105785,3414,1916436,3022221,03/15/2016
1999,Broome,03,30224,6796138,14330,13432635,20228773,03/15/2016
1999,Cattaraugus,04,12390,1837556,5674,3162773,5000329,03/15/2016
1999,Cayuga,05,12791,2082193,5073,3649019,5731212,03/15/2016
1999,Chautauqua,06,21402,3758295,9807,7130982,10889277,03/15/2016
1999,Chemung,07,13647,2379812,6453,4897513,7277325,03/15/2016
1999,Chenango,08,8632,1676968,3259,2430804,4107772,03/15/2016
1999,Clinton,09,12331,1923919,4004,2612963,4536882,03/15/2016
1999,Columbia,10,9590,1594652,3936,3025425,4620077,03/15/2016
1999,Cortland,11,7031,1129059,2554,1823723,2952782,03/15/2016
1999,Delaware,12,7168,1092169,3889,2536725,3628894,03/15/2016
1999,Dutchess,13,41457,8676444,11619,11437875,20114319,03/15/2016
1999,Erie,14,138055,21711362,61367,43289623,65000985,03/15/2016
1999,Essex,15,6315,764760,3019,1515006,2279766,03/15/2016
1999,Franklin,16,7096,1038705,2947,1654910,2693615,03/15/2016
1999,Fulton,17,8924,1414543,4004,2588850,4003393,03/15/2016
1999,Genesee,18,10294,2098683,3783,3427549,5526232,03/15/2016
1999,Greene,19,7223,1116065,3326,2331627,3447692,03/15/2016
1999,Hamilton,20,1082,90858,676,255958,346816,03/15/2016
1999,Herkimer,21,10408,1630315,5013,3251020,4881335,03/15/2016
1999,Jefferson,22,13489,1724577,5443,2903137,4627714,03/15/2016
1999,Lewis,23,4746,613158,1854,910670,1523828,03/15/2016
1999,Livingston,24,10594,1785836,3223,2413510,4199346,03/15/2016
1999,Madison,25,11799,2192257,3804,2936856,5129113,03/15/2016
1999,Monroe,26,123980,22426288,35760,30750932,53177220,03/15/2016
1999,Montgomery,27,7122,1324687,4139,3237255,4561942,03/15/2016
1999,Nassau,28,228340,64101267,56606,77831063,141932330,03/15/2016
1999,Niagara,29,34090,6398159,14887,12090799,18488958,03/15/2016
1999,Oneida,30,35139,6623381,16611,13329827,19953208,03/15/2016
1999,Onondaga,31,77557,14520366,26763,21876823,36397189,03/15/2016
1999,Ontario,32,17035,3237619,5283,4549973,7787592,03/15/2016
1999,Orange,33,50196,11081878,12259,12423452,23505330,03/15/2016
1999,Orleans,34,6772,1244502,2528,2025150,3269652,03/15/2016
1999,Oswego,35,20243,3711362,6630,4579832,8291194,03/15/2016
1999,Otsego,36,9441,1656471,4113,3154071,4810542,03/15/2016
1999,Putnam,37,17444,5231917,3261,4720870,9952787,03/15/2016
1999,Rensselaer,38,24290,4682674,8428,7056410,11739084,03/15/2016
1999,Rockland,39,45258,15242402,9554,14752907,29995309,03/15/2016
1999,St. Lawrence,40,17669,2843387,6838,4073495,6916882,03/15/2016
1999,Saratoga,41,35570,6967086,8889,7562883,14529969,03/15/2016
1999,Schenectady,42,24918,4705688,9879,8463341,13169029,03/15/2016
1999,Schoharie,43,5437,813313,1992,1284597,2097910,03/15/2016
1999,Schuyler,44,3125,448862,1340,786230,1235092,03/15/2016
1999,Seneca,45,5301,847503,2387,1635637,2483140,03/15/2016
1999,Steuben,46,16043,2625183,6727,4365595,6990778,03/15/2016
1999,Suffolk,47,233201,62587326,57718,71076432,133663758,03/15/2016
1999,Sullivan,48,10042,1838397,4392,3479740,5318137,03/15/2016
1999,Tioga,49,8935,1722234,3034,2361079,4083313,03/15/2016
1999,Tompkins,50,12626,2494897,3145,2590302,5085199,03/15/2016
1999,Ulster,51,27787,5495109,9818,8643188,14138297,03/15/2016
1999,Warren,52,10393,1526327,3972,2498880,4025207,03/15/2016
1999,Washington,53,9786,1652724,3998,2985573,4638297,03/15/2016
1999,Wayne,54,17097,3157458,4896,3921043,7078501,03/15/2016
1999,Westchester,55,117312,54752441,29401,59525028,114277469,03/15/2016
1999,Wyoming,56,7823,1208159,2380,1695454,2903613,03/15/2016
1999,Yates,57,3996,552922,1731,1043973,1596895,03/15/2016
1999,New York City,65,319683,21677515,113557,38231907,59909422,03/15/2016
1998,Albany,01,,,14592,11496984,11496984,03/15/2016
1998,Allegany,02,,,3075,1638939,1638939,03/15/2016
1998,Broome,03,,,13327,12238012,12238012,03/15/2016
1998,Cattaraugus,04,,,5180,2735990,2735990,03/15/2016
1998,Cayuga,05,,,4503,3150667,3150667,03/15/2016
1998,Chautauqua,06,,,8995,6340981,6340981,03/15/2016
1998,Chemung,07,,,6030,4032360,4032360,03/15/2016
1998,Chenango,08,,,2926,2148156,2148156,03/15/2016
1998,Clinton,09,,,3524,2240493,2240493,03/15/2016
1998,Columbia,10,,,3617,2636960,2636960,03/15/2016
1998,Cortland,11,,,2377,1619253,1619253,03/15/2016
1998,Delaware,12,,,3389,2088923,2088923,03/15/2016
1998,Dutchess,13,,,10497,10048331,10048331,03/15/2016
1998,Erie,14,,,57565,39526411,39526411,03/15/2016
1998,Essex,15,,,2640,1264491,1264491,03/15/2016
1998,Franklin,16,,,2582,1440416,1440416,03/15/2016
1998,Fulton,17,,,3655,2215446,2215446,03/15/2016
1998,Genesee,18,,,3469,3033070,3033070,03/15/2016
1998,Greene,19,,,2937,2025805,2025805,03/15/2016
1998,Hamilton,20,,,575,206832,206832,03/15/2016
1998,Herkimer,21,,,4553,2862983,2862983,03/15/2016
1998,Jefferson,22,,,4866,2559972,2559972,03/15/2016
1998,Lewis,23,,,1630,794041,794041,03/15/2016
1998,Livingston,24,,,2980,2154322,2154322,03/15/2016
1998,Madison,25,,,3374,2489747,2489747,03/15/2016
1998,Monroe,26,,,32869,27343150,27343150,03/15/2016
1998,Montgomery,27,,,3633,2703375,2703375,03/15/2016
1998,Nassau,28,,,44080,58931663,58931663,03/15/2016
1998,Niagara,29,,,13818,10451411,10451411,03/15/2016
1998,Oneida,30,,,15700,12396097,12396097,03/15/2016
1998,Onondaga,31,,,24888,19772711,19772711,03/15/2016
1998,Ontario,32,,,4692,3849774,3849774,03/15/2016
1998,Orange,33,,,11006,10586796,10586796,03/15/2016
1998,Orleans,34,,,2254,1663328,1663328,03/15/2016
1998,Oswego,35,,,5900,3635053,3635053,03/15/2016
1998,Otsego,36,,,3611,2630054,2630054,03/15/2016
1998,Putnam,37,,,3027,4229073,4229073,03/15/2016
1998,Rensselaer,38,,,7965,6444580,6444580,03/15/2016
1998,Rockland,39,,,8107,12015749,12015749,03/15/2016
1998,St. Lawrence,40,,,6337,3638701,3638701,03/15/2016
1998,Saratoga,41,,,8188,6771738,6771738,03/15/2016
1998,Schenectady,42,,,9114,7705929,7705929,03/15/2016
1998,Schoharie,43,,,1793,1099760,1099760,03/15/2016
1998,Schuyler,44,,,1126,628294,628294,03/15/2016
1998,Seneca,45,,,2132,1366046,1366046,03/15/2016
1998,Steuben,46,,,6054,3725350,3725350,03/15/2016
1998,Suffolk,47,,,53106,64263746,64263746,03/15/2016
1998,Sullivan,48,,,3789,2844007,2844007,03/15/2016
1998,Tioga,49,,,2735,2095944,2095944,03/15/2016
1998,Tompkins,50,,,2993,2382294,2382294,03/15/2016
1998,Ulster,51,,,8758,7434761,7434761,03/15/2016
1998,Warren,52,,,3602,2179919,2179919,03/15/2016
1998,Washington,53,,,3642,2600680,2600680,03/15/2016
1998,Wayne,54,,,4379,3377315,3377315,03/15/2016
1998,Westchester,55,,,26482,51210917,51210917,03/15/2016
1998,Wyoming,56,,,2186,1502822,1502822,03/15/2016
1998,Yates,57,,,1481,881067,881067,03/15/2016
1998,New York City,65,,,99003,31797998,31797998,03/15/2016
