mixedUseAssessmentKey,provalLrsnId,realEstatePropertyCode,assessmentChangeReasonTypeDsc,mixedUseAssessmentDate,commercialLandAmt,commercialImprovementAmt,totalCommercialAmt,residentialLandAmt,residentialImprovementAmt,totalResidentialAmt
3,8773,05031006,,2010-01-01T00:00:00.000Z,123000,186800,309800,273900,193400,467300
7,8773,05031006,01- Annual,2014-01-01T00:00:00.000Z,123000,254900,377900,273900,504300,778200
11,8862,05038013,01- Annual,2013-01-01T00:00:00.000Z,73900,85100,159000,280500,169500,450000
15,8862,05038013,,2011-01-01T00:00:00.000Z,73900,88900,162800,280500,64000,344500
19,9321,05056002,,2010-01-01T00:00:00.000Z,469300,0,469300,2744000,1000,2745000
23,9712,06002031,,2009-01-01T00:00:00.000Z,156500,219000,375500,66000,44800,110800
27,9712,06002031,,2012-01-01T00:00:00.000Z,166500,192800,359300,56000,65400,121400
31,10406,06028015,01- Annual,2014-01-01T00:00:00.000Z,74500,274100,348600,132000,185500,317500
35,10406,06028015,01- Annual,2013-01-01T00:00:00.000Z,74500,258500,333000,132000,96800,228800
39,10855,07006012,,2009-01-01T00:00:00.000Z,451900,571400,1023300,264000,108600,372600
43,10855,07006012,,2012-01-01T00:00:00.000Z,495900,635600,1131500,220000,184800,404800
47,10859,07006016,01- Annual,2016-01-01T00:00:00.000Z,52500,246300,298800,421400,1399800,1821200
51,10859,07006016,,2011-01-01T00:00:00.000Z,48300,192800,241100,367300,777200,1144500
55,10859,07006016,,2008-01-01T00:00:00.000Z,63000,208400,271400,488900,683500,1172400
59,11215,07007037,,2009-01-01T00:00:00.000Z,142500,234500,377000,519300,327200,846500
63,11215,07007037,,2012-01-01T00:00:00.000Z,118800,287700,406500,322600,704400,1027000
67,11215,07007037,01- Annual,2015-01-01T00:00:00.000Z,118800,355400,474200,356600,745000,1101600
71,11406,07012015,,2011-01-01T00:00:00.000Z,376500,24400,400900,110000,99600,209600
75,11406,07012015,,2008-01-01T00:00:00.000Z,354500,13000,367500,132000,81600,213600
79,15138,10028012,,2010-01-01T00:00:00.000Z,164000,484200,648200,336000,21800,357800
83,15138,10028012,01- Annual,2015-01-01T00:00:00.000Z,500000,345200,845200,0,911100,911100
87,15235,10035023,01- Annual,2013-01-01T00:00:00.000Z,1102000,134200,1236200,198000,118300,316300
91,16194,11012006,,2008-01-01T00:00:00.000Z,36200,0,36200,1313800,0,1313800
95,16206,11012020,,2008-01-01T00:00:00.000Z,58500,0,58500,2122700,0,2122700
99,19075,13018009,01- Annual,2018-01-01T00:00:00.000Z,106500,36900,143400,6103300,1623900,7727200
103,19079,13018016,01- Annual,2018-01-01T00:00:00.000Z,34300,29600,63900,1965400,1299100,3264500
107,19601,13031015,01- Annual,2013-01-01T00:00:00.000Z,177500,237800,415300,60000,476900,536900
111,21915,14022010,,2012-01-01T00:00:00.000Z,124600,179700,304300,180000,133700,313700
115,21915,14022010,,2009-12-01T00:00:00.000Z,106600,183200,289800,198000,89800,287800
119,21915,14022010,01- Annual,2015-01-01T00:00:00.000Z,348100,73200,421300,0,298600,298600
123,22483,14032004,01- Annual,2017-01-01T00:00:00.000Z,101400,593600,695000,6511100,23699500,30210600
127,22510,14035005,01- Annual,2013-01-01T00:00:00.000Z,61900,0,61900,3006100,0,3006100
131,22514,14035011,01- Annual,2013-01-01T00:00:00.000Z,41200,0,41200,2004100,0,2004100
135,22519,14035016,01- Annual,2013-01-01T00:00:00.000Z,44200,0,44200,2146400,0,2146400
139,22523,14035021,01- Annual,2013-01-01T00:00:00.000Z,12900,0,12900,626300,0,626300
143,23311,14042574,03- Board of Equalization,2015-11-03T00:00:00.000Z,287700,2186700,2474400,29491000,119712500,149203500
147,23311,14042574,03- Board of Equalization,2016-09-30T00:00:00.000Z,287700,2219100,2506800,31023000,113668800,144691800
151,23311,14042574,01- Annual,2013-01-01T00:00:00.000Z,287700,1786100,2073800,26810000,116931100,143741100
155,23311,14042574,,2011-01-01T00:00:00.000Z,263700,1640900,1904600,22980000,91550300,114530300
159,23343,14045008,,2010-01-01T00:00:00.000Z,1289300,6493700,7783000,28504000,91856700,120360700
163,23343,14045008,,2009-01-01T00:00:00.000Z,1611700,7354300,8966000,33594000,114854700,148448700
167,23343,14045008,01- Annual,2020-01-01T00:00:00.000Z,1746000,9854700,11600700,43774000,145234900,189008900
171,23343,14045008,03- Board of Equalization,2017-08-31T00:00:00.000Z,1611700,7547400,9159100,43774000,112848800,156622800
175,23343,14045008,01- Annual,2015-01-01T00:00:00.000Z,1611700,9397900,11009600,39193000,134474900,173667900
179,23344,14046006,01- Annual,2016-01-01T00:00:00.000Z,18700,0,18700,2818400,0,2818400
183,23344,14046006,01- Annual,2018-01-01T00:00:00.000Z,18700,0,18700,2992400,0,2992400
187,23344,14046006,,2009-01-01T00:00:00.000Z,18700,0,18700,2296500,0,2296500
191,23344,14046006,01- Annual,2020-01-01T00:00:00.000Z,20200,0,20200,2992400,0,2992400
195,23348,14046026,,2010-01-01T00:00:00.000Z,1200,0,1200,150300,0,150300
199,23348,14046026,01- Annual,2019-01-01T00:00:00.000Z,1400,0,1400,230800,0,230800
203,23348,14046026,01- Annual,2015-01-01T00:00:00.000Z,1400,0,1400,206600,0,206600
207,23349,14046027,01- Annual,2014-01-01T00:00:00.000Z,8000,0,8000,1041300,0,1041300
211,23349,14046027,01- Annual,2013-01-01T00:00:00.000Z,8000,0,8000,1041300,0,1041300
215,23349,14046027,,2011-01-01T00:00:00.000Z,7300,0,7300,892500,0,892500
219,23350,14046028,,2012-01-01T00:00:00.000Z,9300,0,9300,1217800,0,1217800
223,23350,14046028,,2008-01-01T00:00:00.000Z,9300,0,9300,1148200,0,1148200
227,23350,14046028,01- Annual,2017-01-01T00:00:00.000Z,9300,0,9300,1496200,0,1496200
231,23351,14046029,01- Annual,2016-01-01T00:00:00.000Z,155800,1290800,1446600,23510100,90163000,113673100
235,23351,14046029,01- Annual,2017-01-01T00:00:00.000Z,155800,1306900,1462700,24961300,91482100,116443400
239,23351,14046029,03- Board of Equalization,2018-09-19T00:00:00.000Z,155800,897200,1053000,24961300,91238700,116200000
243,23351,14046029,,2008-01-01T00:00:00.000Z,155800,1004100,1159900,19156400,76005800,95162200
247,23351,14046029,,2012-01-01T00:00:00.000Z,155800,1087200,1243000,20317400,85940900,106258300
251,23353,14047019,,2012-01-01T00:00:00.000Z,339600,4048800,4388400,23348600,179595400,202944000
255,23353,14047019,,2008-01-01T00:00:00.000Z,339600,4060900,4400500,22014400,151153100,173167500
259,23353,14047019,03- Board of Equalization,2016-09-30T00:00:00.000Z,339600,6688000,7027600,27017600,199063000,226080600
263,23353,14047019,03- Board of Equalization,2015-11-03T00:00:00.000Z,339600,6592400,6932000,25683400,196751900,222435300
267,23354,14047020,01- Annual,2014-01-01T00:00:00.000Z,387300,0,387300,26631400,0,26631400
271,23354,14047020,01- Annual,2013-01-01T00:00:00.000Z,387300,0,387300,26631400,0,26631400
275,23354,14047020,,2011-01-01T00:00:00.000Z,355000,0,355000,22826900,0,22826900
279,23846,14050036,,2011-01-01T00:00:00.000Z,539000,1105800,1644800,26280000,100065900,126345900
283,23846,14050036,01- Annual,2013-01-01T00:00:00.000Z,588000,4302000,4890000,30660000,121763100,152423100
287,23846,14050036,01- Annual,2014-01-01T00:00:00.000Z,588000,2101500,2689500,30660000,135195800,165855800
291,23846,14050036,01- Annual,2017-01-01T00:00:00.000Z,588000,3309900,3897900,37410000,124849300,162259300
295,23850,14051019,01- Annual,2014-01-01T00:00:00.000Z,552000,0,552000,16590000,1000,16591000
299,23850,14051019,01- Annual,2013-01-01T00:00:00.000Z,552000,0,552000,16590000,1000,16591000
303,23850,14051019,,2011-01-01T00:00:00.000Z,506000,0,506000,14220000,1000,14221000
307,24284,14060015,,2009-01-01T00:00:00.000Z,3478000,1000,3479000,2013600,0,2013600
311,24298,14060038,,2009-01-01T00:00:00.000Z,579300,1000,580300,335400,0,335400
315,24313,14060065,,2009-01-01T00:00:00.000Z,801800,0,801800,464200,0,464200
319,25775,15062003,,2012-01-01T00:00:00.000Z,227200,127700,354900,120000,102600,222600
323,25815,15064001,,2010-01-01T00:00:00.000Z,367400,221200,588600,112000,70100,182100
327,25815,15064001,,2008-01-01T00:00:00.000Z,347400,303800,651200,132000,51400,183400
331,25841,15066001,01- Annual,2013-01-01T00:00:00.000Z,464400,420400,884800,120000,104300,224300
335,25841,15066001,01- Annual,2014-01-01T00:00:00.000Z,464400,437100,901500,120000,191300,311300
339,25865,15067008,,2010-01-01T00:00:00.000Z,504600,6100,510700,56000,43800,99800
343,25865,15067008,,2008-01-01T00:00:00.000Z,494600,48000,542600,66000,37700,103700
347,25996,15074008,,2012-01-01T00:00:00.000Z,33900,1688800,1722700,2899400,76248400,79147800
351,25996,15074008,01- Annual,2013-01-01T00:00:00.000Z,33900,1709800,1743700,2899400,11233800,14133200
355,25996,15074008,03- Board of Equalization,2016-09-19T00:00:00.000Z,33900,1862900,1896800,3355000,14651100,18006100
359,25996,15074008,03- Board of Equalization,2018-08-21T00:00:00.000Z,33900,1902700,1936600,3562100,14811200,18373300
363,25997,15074009,01- Annual,2020-01-01T00:00:00.000Z,37400,0,37400,3550000,15802200,19352200
367,25997,15074009,01- Annual,2019-01-01T00:00:00.000Z,33900,0,33900,3562100,15760900,19323000
371,25997,15074009,05- Review,2015-09-03T00:00:00.000Z,33900,0,33900,3189400,14545500,17734900
375,25997,15074009,,2008-01-01T00:00:00.000Z,33900,0,33900,2724400,0,2724400
379,25997,15074009,,2010-01-01T00:00:00.000Z,27100,0,27100,2311600,0,2311600
383,25998,15074010,,2009-01-01T00:00:00.000Z,25400,0,25400,2043300,0,2043300
387,25998,15074010,01- Annual,2015-01-01T00:00:00.000Z,25400,0,25400,2392000,10938600,13330600
391,25998,15074010,03- Board of Equalization,2019-10-10T00:00:00.000Z,25900,0,25900,2662500,11445700,14108200
395,25998,15074010,01- Annual,2017-01-01T00:00:00.000Z,25400,0,25400,2671600,10938100,13609700
399,25999,15074011,01- Annual,2018-01-01T00:00:00.000Z,25700,0,25700,2695500,0,2695500
403,25999,15074011,01- Annual,2016-01-01T00:00:00.000Z,25700,0,25700,2538700,11122300,13661000
407,25999,15074011,01- Annual,2014-01-01T00:00:00.000Z,25700,0,25700,2194000,10681500,12875500
411,25999,15074011,,2011-01-01T00:00:00.000Z,23500,0,23500,1880600,0,1880600
2,8773,05031006,,2011-01-01T00:00:00.000Z,123000,203600,326600,273900,250000,523900
6,8773,05031006,01- Annual,2013-01-01T00:00:00.000Z,123000,238000,361000,273900,286900,560800
10,8862,05038013,01- Annual,2014-01-01T00:00:00.000Z,73900,91900,165800,280500,213100,493600
14,8862,05038013,,2010-01-01T00:00:00.000Z,73900,84200,158100,280500,33900,314400
18,9321,05056002,,2011-01-01T00:00:00.000Z,449700,0,449700,2695000,1000,2696000
22,9712,06002031,,2008-01-01T00:00:00.000Z,156500,213900,370400,66000,40800,106800
26,9712,06002031,,2011-01-01T00:00:00.000Z,166500,163500,330000,56000,55900,111900
30,10406,06028015,01- Annual,2015-01-01T00:00:00.000Z,207100,141500,348600,0,316900,316900
34,10406,06028015,,2010-01-01T00:00:00.000Z,74500,224600,299100,132000,67500,199500
38,10855,07006012,,2008-01-01T00:00:00.000Z,583900,420100,1004000,132000,217500,349500
42,10855,07006012,,2011-01-01T00:00:00.000Z,495900,498000,993900,220000,132500,352500
46,10859,07006016,01- Annual,2015-01-01T00:00:00.000Z,52500,221100,273600,401600,875300,1276900
50,10859,07006016,,2012-01-01T00:00:00.000Z,52500,188600,241100,363100,829000,1192100
54,10859,07006016,,2009-01-01T00:00:00.000Z,63000,187100,250100,488900,591700,1080600
58,11215,07007037,,2008-01-01T00:00:00.000Z,142500,299500,442000,519300,473200,992500
62,11215,07007037,,2011-01-01T00:00:00.000Z,109300,267800,377100,332100,582400,914500
66,11215,07007037,01- Annual,2016-01-01T00:00:00.000Z,118800,285300,404100,377600,575300,952900
70,11406,07012015,,2012-01-01T00:00:00.000Z,366500,60200,426700,120000,102600,222600
74,11406,07012015,,2009-01-01T00:00:00.000Z,354500,17200,371700,132000,100800,232800
78,15138,10028012,01- Annual,2013-01-01T00:00:00.000Z,140000,647800,787800,360000,182000,542000
82,15138,10028012,01- Annual,2014-01-01T00:00:00.000Z,140000,647800,787800,360000,299900,659900
86,15235,10035023,,2010-01-01T00:00:00.000Z,1102000,13200,1115200,198000,62200,260200
90,16193,11012005,,2008-01-01T00:00:00.000Z,30300,0,30300,1097900,0,1097900
94,16197,11012010,,2008-01-01T00:00:00.000Z,18800,0,18800,680300,0,680300
98,16211,11012026,,2008-01-01T00:00:00.000Z,50800,0,50800,1843700,0,1843700
102,19078,13018014,01- Annual,2018-01-01T00:00:00.000Z,54000,29600,83600,3093300,1299100,4392400
106,19601,13031015,,2009-01-01T00:00:00.000Z,171500,101300,272800,66000,462600,528600
110,19601,13031015,,2012-01-01T00:00:00.000Z,177500,125000,302500,60000,496500,556500
114,21915,14022010,01- Annual,2013-01-01T00:00:00.000Z,124600,209100,333700,180000,106200,286200
118,21915,14022010,01- Annual,2014-01-01T00:00:00.000Z,174000,247300,421300,174100,44400,218500
122,22482,14032003,01- Annual,2017-01-01T00:00:00.000Z,87500,0,87500,5615000,20439400,26054400
126,22508,14035003,01- Annual,2013-01-01T00:00:00.000Z,41200,0,41200,2004100,0,2004100
130,22513,14035010,01- Annual,2013-01-01T00:00:00.000Z,41200,0,41200,2004100,0,2004100
134,22518,14035015,01- Annual,2013-01-01T00:00:00.000Z,41200,0,41200,2004100,0,2004100
138,22522,14035020,01- Annual,2013-01-01T00:00:00.000Z,12900,0,12900,626300,0,626300
142,23311,14042574,01- Annual,2016-01-01T00:00:00.000Z,287700,2219100,2506800,31023000,119753600,150776600
146,23311,14042574,01- Annual,2014-01-01T00:00:00.000Z,287700,1935900,2223600,26810000,130922900,157732900
150,23311,14042574,01- Annual,2020-01-01T00:00:00.000Z,311700,2174000,2485700,32938000,127987000,160925000
154,23311,14042574,,2010-01-01T00:00:00.000Z,230200,1569100,1799300,21448000,85602800,107050800
158,23343,14045008,,2011-01-01T00:00:00.000Z,1477400,6681500,8158900,27995000,102096000,130091000
162,23343,14045008,,2009-10-01T00:00:00.000Z,1611700,7354300,8966000,33594000,104160200,137754200
166,23343,14045008,01- Annual,2013-01-01T00:00:00.000Z,1611700,8427600,10039300,35630000,128250900,163880900
170,23343,14045008,01- Annual,2018-01-01T00:00:00.000Z,1611700,7637500,9249200,43774000,123264200,167038200
174,23343,14045008,03- Board of Equalization,2014-08-29T00:00:00.000Z,1611700,9546700,11158400,35630000,121967900,157597900
178,23343,14045008,01- Annual,2017-01-01T00:00:00.000Z,1611700,7657400,9269100,43774000,114729900,158503900
182,23344,14046006,01- Annual,2017-01-01T00:00:00.000Z,18700,0,18700,2992400,0,2992400
186,23344,14046006,,2008-01-01T00:00:00.000Z,18700,0,18700,2296500,0,2296500
190,23344,14046006,,2012-01-01T00:00:00.000Z,18700,0,18700,2435700,0,2435700
194,23348,14046026,,2011-01-01T00:00:00.000Z,1300,0,1300,161000,0,161000
198,23348,14046026,01- Annual,2013-01-01T00:00:00.000Z,1400,0,1400,187800,0,187800
202,23348,14046026,01- Annual,2014-01-01T00:00:00.000Z,1400,0,1400,187800,0,187800
206,23349,14046027,01- Annual,2015-01-01T00:00:00.000Z,8000,0,8000,1145400,0,1145400
210,23349,14046027,01- Annual,2019-01-01T00:00:00.000Z,8000,0,8000,1279300,0,1279300
214,23349,14046027,,2010-01-01T00:00:00.000Z,6400,0,6400,833000,0,833000
218,23350,14046028,01- Annual,2020-01-01T00:00:00.000Z,10100,0,10100,1496200,0,1496200
222,23350,14046028,,2009-01-01T00:00:00.000Z,9300,0,9300,1148200,0,1148200
226,23350,14046028,01- Annual,2018-01-01T00:00:00.000Z,9300,0,9300,1496200,0,1496200
230,23350,14046028,01- Annual,2016-01-01T00:00:00.000Z,9300,0,9300,1409200,0,1409200
234,23351,14046029,01- Annual,2014-01-01T00:00:00.000Z,155800,1278200,1434000,20317400,95657000,115974400
238,23351,14046029,01- Annual,2019-01-01T00:00:00.000Z,155800,1191600,1347400,24961300,93367100,118328400
242,23351,14046029,01- Annual,2013-01-01T00:00:00.000Z,155800,1170100,1325900,20317400,97428600,117746000
246,23351,14046029,,2011-01-01T00:00:00.000Z,142800,1016100,1158900,17414900,76342600,93757500
250,23353,14047019,01- Annual,2020-01-01T00:00:00.000Z,367900,7149700,7517600,28685400,214118300,242803700
254,23353,14047019,,2009-01-01T00:00:00.000Z,339600,3869400,4209000,22014400,145767500,167781900
258,23353,14047019,01- Annual,2018-01-01T00:00:00.000Z,339600,0,339600,28685400,0,28685400
262,23353,14047019,01- Annual,2015-01-01T00:00:00.000Z,339600,6685000,7024600,25683400,203793900,229477300
266,23354,14047020,01- Annual,2015-01-01T00:00:00.000Z,387300,0,387300,29294600,0,29294600
270,23354,14047020,01- Annual,2019-01-01T00:00:00.000Z,387300,0,387300,32718600,0,32718600
274,23354,14047020,,2010-01-01T00:00:00.000Z,309800,0,309800,21305200,0,21305200
278,23846,14050036,,2012-01-01T00:00:00.000Z,588000,1857000,2445000,30660000,123550600,154210600
282,23846,14050036,,2008-01-01T00:00:00.000Z,588000,1274000,1862000,28908000,107826400,136734400
286,23846,14050036,01- Annual,2018-01-01T00:00:00.000Z,588000,2963900,3551900,37410000,130926400,168336400
290,23846,14050036,01- Annual,2016-01-01T00:00:00.000Z,588000,2286000,2874000,35235000,133728100,168963100
294,23850,14051019,01- Annual,2015-01-01T00:00:00.000Z,552000,0,552000,18249000,1000,18250000
298,23850,14051019,01- Annual,2020-01-01T00:00:00.000Z,598000,0,598000,20382000,1000,20383000
302,23850,14051019,,2010-01-01T00:00:00.000Z,441600,0,441600,13272000,1000,13273000
306,24283,14060013,,2008-01-01T00:00:00.000Z,1767500,216700,1984200,0,0,0
310,24296,14060036,,2008-01-01T00:00:00.000Z,2329700,184000,2513700,0,0,0
314,24310,14060061,,2009-01-01T00:00:00.000Z,18000,0,18000,10400,0,10400
318,25775,15062003,01- Annual,2013-01-01T00:00:00.000Z,227200,135500,362700,120000,95300,215300
322,25775,15062003,01- Annual,2014-01-01T00:00:00.000Z,227200,135500,362700,120000,178800,298800
326,25815,15064001,01- Annual,2013-01-01T00:00:00.000Z,359400,318100,677500,120000,95300,215300
330,25841,15066001,,2008-01-01T00:00:00.000Z,452400,407700,860100,132000,59800,191800
334,25841,15066001,,2010-01-01T00:00:00.000Z,472400,323400,795800,112000,82500,194500
338,25865,15067008,01- Annual,2014-01-01T00:00:00.000Z,500600,68200,568800,60000,65300,125300
342,25865,15067008,01- Annual,2013-01-01T00:00:00.000Z,500600,59500,560100,60000,65300,125300
346,25996,15074008,,2010-01-01T00:00:00.000Z,27100,1029400,1056500,2311600,61292200,63603800
350,25996,15074008,,2008-01-01T00:00:00.000Z,33900,1293800,1327700,2724400,75149800,77874200
354,25996,15074008,05- Review,2015-09-03T00:00:00.000Z,33900,1834500,1868400,3189400,14545500,17734900
358,25996,15074008,01- Annual,2019-01-01T00:00:00.000Z,33900,1904800,1938700,3562100,15760900,19323000
362,25996,15074008,01- Annual,2020-01-01T00:00:00.000Z,37400,1607400,1644800,3550000,15802200,19352200
366,25997,15074009,03- Board of Equalization,2018-08-21T00:00:00.000Z,33900,0,33900,3562100,14811200,18373300
370,25997,15074009,03- Board of Equalization,2016-09-19T00:00:00.000Z,33900,0,33900,3355000,14651100,18006100
374,25997,15074009,01- Annual,2013-01-01T00:00:00.000Z,33900,0,33900,2899400,11233800,14133200
378,25997,15074009,,2012-01-01T00:00:00.000Z,33900,0,33900,2899400,0,2899400
382,25998,15074010,,2011-01-01T00:00:00.000Z,23300,0,23300,1863900,0,1863900
386,25998,15074010,01- Annual,2014-01-01T00:00:00.000Z,25400,0,25400,2174600,10581600,12756200
390,25998,15074010,01- Annual,2016-01-01T00:00:00.000Z,25400,0,25400,2516300,11018400,13534700
394,25998,15074010,01- Annual,2018-01-01T00:00:00.000Z,25400,0,25400,2671600,0,2671600
398,25999,15074011,01- Annual,2017-01-01T00:00:00.000Z,25700,0,25700,2695500,11041300,13736800
402,25999,15074011,03- Board of Equalization,2019-10-10T00:00:00.000Z,26100,0,26100,2686300,11553700,14240000
406,25999,15074011,01- Annual,2015-01-01T00:00:00.000Z,25700,0,25700,2413400,11041800,13455200
410,25999,15074011,,2009-01-01T00:00:00.000Z,25700,0,25700,2061500,0,2061500
414,26000,15074012,,2010-01-01T00:00:00.000Z,13700,0,13700,1166100,0,1166100
418,26000,15074012,,2008-01-01T00:00:00.000Z,17100,0,17100,1374400,0,1374400
422,26000,15074012,05- Review,2015-09-03T00:00:00.000Z,17100,0,17100,1608900,7324300,8933200
426,26000,15074012,01- Annual,2019-01-01T00:00:00.000Z,17100,0,17100,1797000,7936300,9733300
430,26000,15074012,01- Annual,2020-01-01T00:00:00.000Z,18800,0,18800,1790800,7957100,9747900
434,26001,15074013,03- Board of Equalization,2018-08-21T00:00:00.000Z,17100,0,17100,1797000,7458100,9255100
438,26001,15074013,03- Board of Equalization,2016-09-19T00:00:00.000Z,17100,0,17100,1692500,7377500,9070000
442,26001,15074013,01- Annual,2013-01-01T00:00:00.000Z,17100,0,17100,1462700,5656700,7119400
446,26001,15074013,,2012-01-01T00:00:00.000Z,17100,0,17100,1462700,0,1462700
450,26002,15074014,,2011-01-01T00:00:00.000Z,15700,0,15700,1253700,0,1253700
454,26002,15074014,01- Annual,2014-01-01T00:00:00.000Z,17100,0,17100,1462700,7087700,8550400
458,26002,15074014,01- Annual,2016-01-01T00:00:00.000Z,17100,0,17100,1692500,7380200,9072700
462,26002,15074014,01- Annual,2018-01-01T00:00:00.000Z,17100,0,17100,1797000,0,1797000
466,26003,15074015,01- Annual,2017-01-01T00:00:00.000Z,8600,0,8600,898500,3714800,4613300
470,26003,15074015,03- Board of Equalization,2019-10-10T00:00:00.000Z,8700,0,8700,895400,3887200,4782600
474,26003,15074015,01- Annual,2015-01-01T00:00:00.000Z,8600,0,8600,804500,3715000,4519500
478,26003,15074015,,2009-01-01T00:00:00.000Z,8600,0,8600,687200,0,687200
482,26004,15074016,,2010-01-01T00:00:00.000Z,24600,0,24600,2094900,0,2094900
486,26004,15074016,,2008-01-01T00:00:00.000Z,30700,0,30700,2469000,0,2469000
490,26004,15074016,05- Review,2015-09-03T00:00:00.000Z,30700,0,30700,2890400,13204300,16094700
494,26004,15074016,01- Annual,2019-01-01T00:00:00.000Z,30700,0,30700,3228200,14307800,17536000
498,26004,15074016,01- Annual,2020-01-01T00:00:00.000Z,33900,0,33900,3217200,14345300,17562500
502,26005,15074017,03- Board of Equalization,2018-08-21T00:00:00.000Z,6700,0,6700,703200,2941200,3644400
506,26005,15074017,03- Board of Equalization,2016-09-19T00:00:00.000Z,6700,0,6700,662300,2909400,3571700
510,26005,15074017,01- Annual,2013-01-01T00:00:00.000Z,6700,0,6700,572400,2230800,2803200
514,26005,15074017,,2012-01-01T00:00:00.000Z,6700,0,6700,572400,0,572400
518,26006,15074018,,2011-01-01T00:00:00.000Z,13900,0,13900,1107500,0,1107500
522,26006,15074018,01- Annual,2014-01-01T00:00:00.000Z,15100,0,15100,1292100,6289100,7581200
526,26006,15074018,01- Annual,2016-01-01T00:00:00.000Z,15100,0,15100,1495100,6548700,8043800
530,26006,15074018,01- Annual,2018-01-01T00:00:00.000Z,15100,0,15100,1587400,0,1587400
534,26007,15074019,01- Annual,2017-01-01T00:00:00.000Z,8600,0,8600,898500,3818000,4716500
538,26007,15074019,03- Board of Equalization,2019-10-10T00:00:00.000Z,8700,0,8700,895400,3995200,4890600
542,26007,15074019,01- Annual,2015-01-01T00:00:00.000Z,8600,0,8600,804500,3818200,4622700
546,26007,15074019,,2009-01-01T00:00:00.000Z,8600,0,8600,687200,0,687200
550,26012,15075007,01- Annual,2019-01-01T00:00:00.000Z,8400,0,8400,2018000,1000,2019000
554,26013,15075008,01- Annual,2020-01-01T00:00:00.000Z,1800,0,1800,404600,0,404600
558,26014,15075011,01- Annual,2019-01-01T00:00:00.000Z,12300,0,12300,2948000,0,2948000
562,26015,15075012,01- Annual,2020-01-01T00:00:00.000Z,4500,0,4500,985100,0,985100
566,26016,15075013,01- Annual,2019-01-01T00:00:00.000Z,8400,0,8400,2018000,1000,2019000
570,26017,15075014,01- Annual,2020-01-01T00:00:00.000Z,13700,0,13700,3034500,0,3034500
574,26018,15075016,01- Annual,2019-01-01T00:00:00.000Z,8400,0,8400,2018000,0,2018000
578,26019,15075017,01- Annual,2020-01-01T00:00:00.000Z,7300,0,7300,1618400,0,1618400
582,26020,15075018,01- Annual,2019-01-01T00:00:00.000Z,16400,0,16400,3930700,0,3930700
586,26021,15075019,01- Annual,2020-01-01T00:00:00.000Z,4600,0,4600,1011500,0,1011500
590,26022,15075020,01- Annual,2019-01-01T00:00:00.000Z,33800,0,33800,8071900,1000,8072900
594,26051,15078002,,2010-01-01T00:00:00.000Z,15000,59600,74600,56000,41200,97200
598,26051,15078002,,2008-01-01T00:00:00.000Z,5000,76300,81300,66000,31900,97900
602,26052,15078003,,2009-01-01T00:00:00.000Z,46800,1000,47800,436400,0,436400
606,26053,15078004,,2010-01-01T00:00:00.000Z,167100,1000,168100,1651100,0,1651100
610,26053,15078004,,2008-01-01T00:00:00.000Z,208800,1000,209800,1946000,0,1946000
614,26054,15078005,,2009-01-01T00:00:00.000Z,91200,0,91200,850100,0,850100
618,26055,15078006,01- Annual,2017-01-01T00:00:00.000Z,19900,0,19900,4758900,1000,4759900
622,26056,15078010,01- Annual,2019-01-01T00:00:00.000Z,8400,0,8400,2018000,1000,2019000
626,26057,15078011,01- Annual,2018-01-01T00:00:00.000Z,6300,0,6300,1513700,0,1513700
630,26058,15078012,01- Annual,2017-01-01T00:00:00.000Z,4100,0,4100,982700,0,982700
634,26059,15078013,,2009-01-01T00:00:00.000Z,146000,0,146000,1360000,0,1360000
638,26060,15078014,,2008-01-01T00:00:00.000Z,97300,0,97300,906700,0,906700
642,26060,15078014,,2010-01-01T00:00:00.000Z,77900,0,77900,769300,0,769300
646,26061,15078015,,2009-01-01T00:00:00.000Z,121600,0,121600,1133300,0,1133300
650,26062,15078016,,2008-01-01T00:00:00.000Z,121600,0,121600,1133300,0,1133300
654,26062,15078016,,2010-01-01T00:00:00.000Z,97300,0,97300,961600,0,961600
658,26063,15078017,,2009-01-01T00:00:00.000Z,121600,0,121600,1133300,0,1133300
662,26064,15078018,,2008-01-01T00:00:00.000Z,96600,0,96600,899800,0,899800
666,26064,15078018,,2010-01-01T00:00:00.000Z,77300,0,77300,763400,0,763400
670,26067,15078022,01- Annual,2019-01-01T00:00:00.000Z,9600,0,9600,2304400,0,2304400
674,26068,15078023,,2012-01-01T00:00:00.000Z,46300,1000,47300,457200,0,457200
678,26068,15078023,01- Annual,2013-01-01T00:00:00.000Z,46300,1000,47300,457200,0,457200
682,26069,15078024,01- Annual,2020-01-01T00:00:00.000Z,36700,0,36700,8103200,0,8103200
686,26395,15087028,03- Board of Equalization,2018-10-24T00:00:00.000Z,58682100,189199600,247881700,0,0,0
690,26395,15087028,03- Board of Equalization,2015-10-07T00:00:00.000Z,58682100,214418000,273100100,0,0,0
694,27080,16022001,,2009-01-01T00:00:00.000Z,264000,982800,1246800,34020000,97301600,131321600
698,28239,16033008,01- Annual,2020-01-01T00:00:00.000Z,85700,65400,151100,3363700,2340800,5704500
702,28241,16033010,01- Annual,2020-01-01T00:00:00.000Z,277100,65500,342600,10880800,2343600,13224400
706,28243,16033012,01- Annual,2020-01-01T00:00:00.000Z,405100,65500,470600,15904800,2343600,18248400
710,28245,16033014,01- Annual,2020-01-01T00:00:00.000Z,80500,65400,145900,3161900,2340800,5502700
714,28247,16033017,01- Annual,2020-01-01T00:00:00.000Z,88600,65400,154000,3478000,2340800,5818800
718,28249,16033021,01- Annual,2020-01-01T00:00:00.000Z,9900,65400,75300,390200,2340800,2731000
722,28251,16034001,01- Annual,2020-01-01T00:00:00.000Z,206800,1357300,1564100,22404100,104062000,126466100
726,28251,16034001,,2009-01-01T00:00:00.000Z,191000,1270300,1461300,17199000,78407400,95606400
730,28251,16034001,03- Board of Equalization,2016-09-06T00:00:00.000Z,191000,1483600,1674600,21107900,96389100,117497000
734,28251,16034001,01- Annual,2018-01-01T00:00:00.000Z,190900,0,190900,22404100,0,22404100
738,28251,16034001,03- Board of Equalization,2019-10-15T00:00:00.000Z,190900,1361900,1552800,22404100,96649100,119053200
742,28252,16034002,01- Annual,2014-01-01T00:00:00.000Z,20800,0,20800,1706800,0,1706800
746,28252,16034002,,2008-01-01T00:00:00.000Z,17900,0,17900,1609200,0,1609200
750,28252,16034002,,2010-01-01T00:00:00.000Z,14300,0,14300,1365400,0,1365400
754,28255,16034031,,2011-01-01T00:00:00.000Z,19500,0,19500,1741600,0,1741600
758,28255,16034031,01- Annual,2013-01-01T00:00:00.000Z,24800,0,24800,2031900,0,2031900
762,28255,16034031,01- Annual,2018-01-01T00:00:00.000Z,21300,0,21300,2500000,0,2500000
766,28617,16038001,,2008-01-01T00:00:00.000Z,9255900,1000,9256900,5793400,0,5793400
770,28618,16038002,,2008-11-01T00:00:00.000Z,344400,0,344400,231000,0,231000
774,28620,16038004,,2008-01-01T00:00:00.000Z,4859500,0,4859500,3041600,0,3041600
778,28622,16038006,,2008-11-01T00:00:00.000Z,4728200,0,4728200,3171400,0,3171400
782,28623,16038008,,2009-01-01T00:00:00.000Z,2364100,1000,2365100,1585700,0,1585700
786,28624,16038009,,2008-01-01T00:00:00.000Z,2454800,0,2454800,1536500,0,1536500
790,28626,16038011,,2008-11-01T00:00:00.000Z,74700,0,74700,50100,0,50100
794,28627,16038012,,2009-01-01T00:00:00.000Z,182000,0,182000,122100,0,122100
798,28628,16038013,,2008-01-01T00:00:00.000Z,211700,0,211700,132500,0,132500
802,28665,17003010,,2010-01-01T00:00:00.000Z,0,0,0,269200,0,269200
806,28665,17003010,01- Annual,2014-01-01T00:00:00.000Z,0,0,0,333200,0,333200
810,28666,17003011,01- Annual,2020-01-01T00:00:00.000Z,0,0,0,2788600,0,2788600
814,28666,17003011,01- Annual,2018-01-01T00:00:00.000Z,0,0,0,2434300,0,2434300
818,28666,17003011,,2011-01-01T00:00:00.000Z,0,0,0,287000,0,287000
822,28667,17003012,,2012-01-01T00:00:00.000Z,0,0,0,888000,0,888000
826,28667,17003012,01- Annual,2017-01-01T00:00:00.000Z,0,0,0,7361900,0,7361900
830,28667,17003012,01- Annual,2016-01-01T00:00:00.000Z,0,0,0,6933900,0,6933900
834,28926,17003298,01- Annual,2015-01-01T00:00:00.000Z,0,0,0,20900,0,20900
838,28926,17003298,01- Annual,2019-01-01T00:00:00.000Z,0,0,0,139400,0,139400
842,28926,17003298,01- Annual,2013-01-01T00:00:00.000Z,0,0,0,16700,0,16700
846,28927,17003299,,2010-01-01T00:00:00.000Z,0,0,0,33600,0,33600
850,28927,17003299,01- Annual,2014-01-01T00:00:00.000Z,0,0,0,41700,0,41700
854,28928,17003300,01- Annual,2020-01-01T00:00:00.000Z,0,0,0,348500,0,348500
858,28928,17003300,01- Annual,2018-01-01T00:00:00.000Z,0,0,0,304200,0,304200
862,28928,17003300,,2011-01-01T00:00:00.000Z,0,0,0,36000,0,36000
866,29225,17005002,,2011-01-01T00:00:00.000Z,107600,0,107600,4799200,0,4799200
870,29226,17005003,,2012-01-01T00:00:00.000Z,79100,0,79100,3771500,0,3771500
874,29229,17005006,,2010-01-01T00:00:00.000Z,117600,0,117600,5656000,0,5656000
878,29230,17005007,,2011-01-01T00:00:00.000Z,39300,0,39300,1750700,0,1750700
882,29231,17005008,,2012-01-01T00:00:00.000Z,51500,0,51500,2457000,0,2457000
886,29233,17005010,,2010-01-01T00:00:00.000Z,45100,0,45100,2169800,0,2169800
890,29234,17005011,,2011-01-01T00:00:00.000Z,118700,0,118700,5295800,0,5295800
894,29284,17011007,,2012-01-01T00:00:00.000Z,88400,0,88400,828100,0,828100
898,29286,17011009,,2011-01-01T00:00:00.000Z,109100,0,109100,558000,0,558000
902,29289,17011013,,2009-01-01T00:00:00.000Z,200200,0,200200,895100,0,895100
906,29290,17011015,,2011-01-01T00:00:00.000Z,408400,0,408400,2089200,0,2089200
910,29291,17011016,,2009-01-01T00:00:00.000Z,1284700,0,1284700,5744800,0,5744800
914,29292,17011017,,2011-01-01T00:00:00.000Z,504200,1000,505200,4416800,0,4416800
918,29329,17013017,01- Annual,2014-01-01T00:00:00.000Z,40700,429800,470500,18233500,107386200,125619700
922,29329,17013017,01- Annual,2017-01-01T00:00:00.000Z,40700,667100,707800,26134700,120873000,147007700
926,29329,17013017,,2010-01-01T00:00:00.000Z,32600,346000,378600,17041700,76112000,93153700
930,29329,17013017,01- Annual,2020-01-01T00:00:00.000Z,44100,725400,769500,26134700,135773500,161908200
934,29330,17013019,,2008-01-01T00:00:00.000Z,55300,0,55300,27303200,68087300,95390500
938,29330,17013019,01- Annual,2018-01-01T00:00:00.000Z,55300,0,55300,35527300,0,35527300
942,29330,17013019,01- Annual,2015-01-01T00:00:00.000Z,55300,0,55300,31809400,89993700,121803100
946,29332,17014001,01- Annual,2016-01-01T00:00:00.000Z,901700,4793800,5695500,20574000,68005100,88579100
950,29332,17014001,01- Annual,2018-01-01T00:00:00.000Z,901700,4285100,5186800,21844000,77764800,99608800
954,29332,17014001,01- Annual,2013-01-01T00:00:00.000Z,901700,0,901700,17780000,0,17780000
958,32270,18003111,,2010-01-01T00:00:00.000Z,86400,839900,926300,32200000,120695200,152895200
962,32270,18003111,01- Annual,2018-01-01T00:00:00.000Z,108000,1091900,1199900,49450000,141612200,191062200
966,32270,18003111,03- Board of Equalization,2019-10-24T00:00:00.000Z,108000,763700,871700,49450000,157126900,206576900
970,32270,18003111,01- Annual,2016-01-01T00:00:00.000Z,108000,1107200,1215200,46575000,153457400,200032400
974,32270,18003111,03- Board of Equalization,2013-09-26T00:00:00.000Z,108000,940800,1048800,40250000,154350200,194600200
978,32675,18003602,01- Annual,2017-01-01T00:00:00.000Z,144000,1402700,1546700,48504000,162008200,210512200
982,32675,18003602,01- Annual,2020-01-01T00:00:00.000Z,156000,1232800,1388800,48504000,187203200,235707200
986,32675,18003602,,2010-09-01T00:00:00.000Z,115200,901700,1016900,31584000,120949500,152533500
990,32675,18003602,01- Annual,2013-01-01T00:00:00.000Z,144000,1084400,1228400,33840000,171758300,205598300
994,32685,18004066,,2010-01-01T00:00:00.000Z,490900,4426000,4916900,13982900,69918400,83901300
998,32685,18004066,05- Review,2014-12-13T00:00:00.000Z,589100,6449900,7039000,16779500,101366300,118145800
1002,32685,18004066,01- Annual,2017-01-01T00:00:00.000Z,552200,6953700,7505900,19326300,101555600,120881900
1006,32685,18004066,01- Annual,2016-01-01T00:00:00.000Z,613600,6554500,7168100,20225200,110146000,130371200
1010,32685,18004066,03- Board of Equalization,2019-10-31T00:00:00.000Z,527200,6793600,7320800,18466700,104154500,122621200
1014,32691,18005040,01- Annual,2014-01-01T00:00:00.000Z,359500,0,359500,10241400,0,10241400
1018,32691,18005040,01- Annual,2019-01-01T00:00:00.000Z,309700,0,309700,10836600,0,10836600
1022,32691,18005040,05- Review,2015-12-13T00:00:00.000Z,337900,0,337900,10589700,0,10589700
1026,32691,18005040,05- Review,2014-12-13T00:00:00.000Z,345100,0,345100,9831700,0,9831700
1030,32691,18005040,,2009-01-01T00:00:00.000Z,359500,0,359500,9656200,0,9656200
1034,32889,18007031,01- Annual,2013-01-01T00:00:00.000Z,75000,101700,176700,18550000,56476800,75026800
1038,32889,18007031,,2012-01-01T00:00:00.000Z,75000,86000,161000,15840000,55682300,71522300
1042,32942,18013004,,2008-01-01T00:00:00.000Z,974900,0,974900,1621200,0,1621200
1046,32946,18013008,,2008-01-01T00:00:00.000Z,356000,0,356000,592000,0,592000
1050,33220,18029007,,2009-01-01T00:00:00.000Z,1490500,1000,1491500,9834000,0,9834000
1054,33220,18029007,,2010-01-01T00:00:00.000Z,1192400,1000,1193400,8344000,0,8344000
1058,33220,18029007,01- Annual,2017-01-01T00:00:00.000Z,1245400,11763500,13008900,11248000,53728300,64976300
1062,33352,18038019,,2010-01-01T00:00:00.000Z,918300,0,918300,6013100,0,6013100
1066,33353,18038020,,2012-01-01T00:00:00.000Z,362600,0,362600,2442300,3255800,5698100
1070,33356,18038023,,2011-01-01T00:00:00.000Z,327200,0,327200,2195500,0,2195500
1074,33424,18041002,01- Annual,2013-01-01T00:00:00.000Z,11000,896100,907100,240000,210000,450000
1078,33424,18041002,01- Annual,2015-01-01T00:00:00.000Z,251500,637100,888600,0,633800,633800
1082,33610,18054007,01- Annual,2020-01-01T00:00:00.000Z,144400,145000,289400,663400,1708400,2371800
1086,33610,18054007,,2009-01-01T00:00:00.000Z,165000,50100,215100,514800,914300,1429100
1090,33610,18054007,,2010-01-01T00:00:00.000Z,132000,64300,196300,514800,900000,1414800
1094,33614,18054011,,2012-01-01T00:00:00.000Z,15000,340900,355900,198000,383800,581800
1098,33614,18054011,,2008-01-01T00:00:00.000Z,15000,338200,353200,198000,71400,269400
1102,33616,18054013,01- Annual,2015-01-01T00:00:00.000Z,534000,518000,1052000,0,600300,600300
1106,33616,18054013,,2010-01-01T00:00:00.000Z,310000,313700,623700,224000,115800,339800
1110,34352,18084003,,2012-01-01T00:00:00.000Z,326100,77100,403200,14980000,12957900,27937900
1114,34352,18084003,,2008-01-01T00:00:00.000Z,326100,190200,516300,14124000,16076200,30200200
1118,34352,18084003,01- Annual,2015-01-01T00:00:00.000Z,326100,168300,494400,16478000,8754000,25232000
1122,34490,19007002,01- Annual,2017-01-01T00:00:00.000Z,70100,60500,130600,1729600,930700,2660300
1126,34494,19007006,01- Annual,2017-01-01T00:00:00.000Z,60800,51900,112700,1500500,797700,2298200
1130,35639,20012018,01- Annual,2020-01-01T00:00:00.000Z,207300,1000,208300,2588100,0,2588100
1134,35643,20012024,01- Annual,2020-01-01T00:00:00.000Z,394200,0,394200,4921200,0,4921200
1138,40065,23034017,05- Review,2017-04-03T00:00:00.000Z,1912300,1000,1913300,10022900,0,10022900
1142,40065,23034017,01- Annual,2020-01-01T00:00:00.000Z,1912300,2558100,4470400,9339500,45284200,54623700
1146,40066,23034018,03- Board of Equalization,2018-07-26T00:00:00.000Z,2218800,0,2218800,11919900,0,11919900
1150,40067,23034019,05- Review,2017-04-03T00:00:00.000Z,131200,0,131200,687500,0,687500
1154,40415,23040008,01- Annual,2017-01-01T00:00:00.000Z,63500,0,63500,1827300,0,1827300
1158,40994,24015015,01- Annual,2019-01-01T00:00:00.000Z,588000,770800,1358800,10505100,33520700,44025800
1162,40994,24015015,01- Annual,2016-01-01T00:00:00.000Z,588000,2096700,2684700,12255900,13799100,26055000
1166,40994,24015015,,2011-01-01T00:00:00.000Z,0,767000,767000,11280000,6470600,17750600
1170,40995,24015017,,2012-01-01T00:00:00.000Z,757600,0,757600,0,0,0
1174,40995,24015017,01- Annual,2013-01-01T00:00:00.000Z,52000,0,52000,904100,0,904100
1178,40995,24015017,01- Annual,2017-01-01T00:00:00.000Z,43400,0,43400,955700,0,955700
1182,42115,25016009,,2008-01-01T00:00:00.000Z,3357400,1000,3358400,11379000,0,11379000
1186,43303,27002001,,2008-01-01T00:00:00.000Z,0,0,0,29831100,3187500,33018600
1190,43303,27002001,,2011-01-01T00:00:00.000Z,0,0,0,25326000,424700,25750700
1194,43303,27002001,01- Annual,2019-01-01T00:00:00.000Z,0,0,0,38384400,10420900,48805300
1198,43303,27002001,01- Annual,2020-01-01T00:00:00.000Z,0,0,0,38384400,13630300,52014700
1202,43306,27002004,01- Annual,2016-01-01T00:00:00.000Z,4400,76000,80400,4888400,265900,5154300
1206,43306,27002004,05- Review,2019-03-26T00:00:00.000Z,0,345900,345900,5132800,619900,5752700
1210,43306,27002004,,2012-01-01T00:00:00.000Z,100000,65900,165900,4272900,53100,4326000
1214,43306,27002004,,2009-01-01T00:00:00.000Z,120000,63500,183500,3999600,53100,4052700
1218,43307,27002005,01- Annual,2013-01-01T00:00:00.000Z,0,0,0,15214500,1235600,16450100
1222,43307,27002005,01- Annual,2017-01-01T00:00:00.000Z,0,0,0,18276300,468800,18745100
1226,43307,27002005,01- Annual,2015-01-01T00:00:00.000Z,0,0,0,16614800,1755000,18369800
1230,43307,27002005,05- Review,2020-03-31T00:00:00.000Z,0,0,0,18276300,4109900,22386200
1234,43308,27002006,01- Annual,2014-01-01T00:00:00.000Z,0,0,0,14089300,2451700,16541000
1238,43308,27002006,01- Annual,2018-01-01T00:00:00.000Z,0,0,0,16924700,3942200,20866900
1242,43308,27002006,,2010-01-01T00:00:00.000Z,0,0,0,11195800,199100,11394900
415,26000,15074012,,2012-01-01T00:00:00.000Z,17100,0,17100,1462700,0,1462700
419,26000,15074012,01- Annual,2013-01-01T00:00:00.000Z,17100,0,17100,1462700,5656700,7119400
423,26000,15074012,03- Board of Equalization,2016-09-19T00:00:00.000Z,17100,0,17100,1692500,7377500,9070000
427,26000,15074012,03- Board of Equalization,2018-08-21T00:00:00.000Z,17100,0,17100,1797000,7458100,9255100
431,26001,15074013,01- Annual,2020-01-01T00:00:00.000Z,18800,0,18800,1790800,7957100,9747900
435,26001,15074013,01- Annual,2019-01-01T00:00:00.000Z,17100,0,17100,1797000,7936300,9733300
439,26001,15074013,05- Review,2015-09-03T00:00:00.000Z,17100,0,17100,1608900,7324300,8933200
443,26001,15074013,,2008-01-01T00:00:00.000Z,17100,0,17100,1374400,0,1374400
447,26001,15074013,,2010-01-01T00:00:00.000Z,13700,0,13700,1166100,0,1166100
451,26002,15074014,,2009-01-01T00:00:00.000Z,17100,0,17100,1374400,0,1374400
455,26002,15074014,01- Annual,2015-01-01T00:00:00.000Z,17100,0,17100,1608900,7326800,8935700
459,26002,15074014,03- Board of Equalization,2019-10-10T00:00:00.000Z,17400,0,17400,1790800,7666500,9457300
463,26002,15074014,01- Annual,2017-01-01T00:00:00.000Z,17100,0,17100,1797000,7326500,9123500
467,26003,15074015,01- Annual,2018-01-01T00:00:00.000Z,8600,0,8600,898500,0,898500
471,26003,15074015,01- Annual,2016-01-01T00:00:00.000Z,8600,0,8600,846200,3742100,4588300
475,26003,15074015,01- Annual,2014-01-01T00:00:00.000Z,8600,0,8600,731300,3593800,4325100
479,26003,15074015,,2011-01-01T00:00:00.000Z,7800,0,7800,626900,0,626900
483,26004,15074016,,2012-01-01T00:00:00.000Z,30700,0,30700,2627600,0,2627600
487,26004,15074016,01- Annual,2013-01-01T00:00:00.000Z,30700,0,30700,2627600,10198100,12825700
491,26004,15074016,03- Board of Equalization,2016-09-19T00:00:00.000Z,30700,0,30700,3040500,13300300,16340800
495,26004,15074016,03- Board of Equalization,2018-08-21T00:00:00.000Z,30700,0,30700,3228200,13445600,16673800
499,26005,15074017,01- Annual,2020-01-01T00:00:00.000Z,7400,0,7400,700800,3138000,3838800
503,26005,15074017,01- Annual,2019-01-01T00:00:00.000Z,6700,0,6700,703200,3129800,3833000
507,26005,15074017,05- Review,2015-09-03T00:00:00.000Z,6700,0,6700,629600,2888500,3518100
511,26005,15074017,,2008-01-01T00:00:00.000Z,6700,0,6700,537800,0,537800
515,26005,15074017,,2010-01-01T00:00:00.000Z,5400,0,5400,456300,0,456300
519,26006,15074018,,2009-01-01T00:00:00.000Z,15100,0,15100,1214100,0,1214100
523,26006,15074018,01- Annual,2015-01-01T00:00:00.000Z,15100,0,15100,1421300,6501300,7922600
527,26006,15074018,03- Board of Equalization,2019-10-10T00:00:00.000Z,15400,0,15400,1582000,6802700,8384700
531,26006,15074018,01- Annual,2017-01-01T00:00:00.000Z,15100,0,15100,1587400,6500900,8088300
535,26007,15074019,01- Annual,2018-01-01T00:00:00.000Z,8600,0,8600,898500,0,898500
539,26007,15074019,01- Annual,2016-01-01T00:00:00.000Z,8600,0,8600,846200,3846000,4692200
543,26007,15074019,01- Annual,2014-01-01T00:00:00.000Z,8600,0,8600,731300,3693600,4424900
547,26007,15074019,,2011-01-01T00:00:00.000Z,7800,0,7800,626900,0,626900
551,26012,15075007,01- Annual,2018-01-01T00:00:00.000Z,8400,0,8400,2018000,1000,2019000
555,26013,15075008,01- Annual,2017-01-01T00:00:00.000Z,1700,0,1700,403600,0,403600
559,26014,15075011,01- Annual,2018-01-01T00:00:00.000Z,12300,0,12300,2948000,0,2948000
563,26015,15075012,01- Annual,2017-01-01T00:00:00.000Z,4100,0,4100,982700,0,982700
567,26016,15075013,01- Annual,2018-01-01T00:00:00.000Z,8400,0,8400,2018000,1000,2019000
571,26017,15075014,01- Annual,2017-01-01T00:00:00.000Z,12700,0,12700,3027000,0,3027000
575,26018,15075016,01- Annual,2018-01-01T00:00:00.000Z,8400,0,8400,2018000,0,2018000
579,26019,15075017,01- Annual,2017-01-01T00:00:00.000Z,6800,0,6800,1614400,0,1614400
583,26020,15075018,01- Annual,2018-01-01T00:00:00.000Z,16400,0,16400,3930700,0,3930700
587,26021,15075019,01- Annual,2017-01-01T00:00:00.000Z,4200,0,4200,1009000,1000,1010000
591,26022,15075020,01- Annual,2018-01-01T00:00:00.000Z,33800,0,33800,8071900,1000,8072900
595,26051,15078002,,2012-01-01T00:00:00.000Z,11000,72500,83500,60000,56400,116400
599,26051,15078002,01- Annual,2013-01-01T00:00:00.000Z,11000,81400,92400,60000,48800,108800
603,26052,15078003,,2011-01-01T00:00:00.000Z,42900,1000,43900,396700,0,396700
607,26053,15078004,,2012-01-01T00:00:00.000Z,208800,1000,209800,2063900,0,2063900
611,26053,15078004,01- Annual,2013-01-01T00:00:00.000Z,208900,1000,209900,2063900,0,2063900
615,26054,15078005,,2011-01-01T00:00:00.000Z,83600,0,83600,772800,0,772800
619,26055,15078006,01- Annual,2018-01-01T00:00:00.000Z,19900,0,19900,4758900,1000,4759900
623,26056,15078010,01- Annual,2018-01-01T00:00:00.000Z,8400,0,8400,2018000,1000,2019000
627,26057,15078011,01- Annual,2019-01-01T00:00:00.000Z,6300,0,6300,1513700,0,1513700
631,26059,15078013,,2010-01-01T00:00:00.000Z,116800,0,116800,1153900,0,1153900
635,26059,15078013,,2008-01-01T00:00:00.000Z,146000,1000,147000,1360000,0,1360000
639,26060,15078014,,2009-01-01T00:00:00.000Z,97300,0,97300,906700,0,906700
643,26061,15078015,,2010-01-01T00:00:00.000Z,97300,0,97300,961600,0,961600
647,26061,15078015,,2008-01-01T00:00:00.000Z,121600,1000,122600,1133300,0,1133300
651,26062,15078016,,2009-01-01T00:00:00.000Z,121600,0,121600,1133300,0,1133300
655,26063,15078017,,2010-01-01T00:00:00.000Z,97300,0,97300,961600,0,961600
659,26063,15078017,,2008-01-01T00:00:00.000Z,121600,1000,122600,1133300,0,1133300
663,26064,15078018,,2009-01-01T00:00:00.000Z,96600,0,96600,899800,0,899800
667,26066,15078021,01- Annual,2017-01-01T00:00:00.000Z,6300,0,6300,1513700,1000,1514700
671,26067,15078022,01- Annual,2018-01-01T00:00:00.000Z,9600,0,9600,2304400,0,2304400
675,26068,15078023,,2011-01-01T00:00:00.000Z,42400,1000,43400,391900,0,391900
679,26069,15078024,01- Annual,2017-01-01T00:00:00.000Z,36600,0,36600,8747500,0,8747500
683,26395,15087028,03- Board of Equalization,2019-10-31T00:00:00.000Z,58682100,185254500,243936600,0,0,0
687,26395,15087028,01- Annual,2018-01-01T00:00:00.000Z,58682100,211584500,270266600,0,0,0
691,26395,15087028,01- Annual,2016-01-01T00:00:00.000Z,58682100,217162600,275844700,0,0,0
695,27080,16022001,,2009-07-01T00:00:00.000Z,0,32638400,32638400,0,309900,309900
699,28239,16033008,05- Review,2020-03-06T00:00:00.000Z,89800,36100,125900,3523400,1290700,4814100
703,28241,16033010,05- Review,2020-03-06T00:00:00.000Z,290300,116700,407000,11397600,4175100,15572700
707,28243,16033012,05- Review,2020-03-06T00:00:00.000Z,424300,170500,594800,16660200,6102900,22763100
711,28245,16033014,05- Review,2020-03-06T00:00:00.000Z,84400,33900,118300,3312000,1213200,4525200
715,28247,16033017,05- Review,2020-03-06T00:00:00.000Z,1211400,0,1211400,0,0,0
719,28249,16033021,05- Review,2020-03-06T00:00:00.000Z,10400,4200,14600,408700,149700,558400
723,28251,16034001,,2010-01-01T00:00:00.000Z,152800,1104000,1256800,14593100,65774600,80367700
727,28251,16034001,,2008-01-01T00:00:00.000Z,191000,1402100,1593100,17199000,81695200,98894200
731,28251,16034001,01- Annual,2016-01-01T00:00:00.000Z,191000,1483600,1674600,21107900,96443400,117551300
735,28251,16034001,03- Board of Equalization,2017-08-31T00:00:00.000Z,190900,1196900,1387800,22404100,94771500,117175600
739,28252,16034002,01- Annual,2019-01-01T00:00:00.000Z,17900,0,17900,2100000,0,2100000
743,28252,16034002,01- Annual,2015-01-01T00:00:00.000Z,17900,0,17900,1877500,0,1877500
747,28252,16034002,,2009-01-01T00:00:00.000Z,17900,0,17900,1609200,0,1609200
751,28252,16034002,01- Annual,2020-01-01T00:00:00.000Z,19400,0,19400,2100000,0,2100000
755,28255,16034031,,2012-01-01T00:00:00.000Z,24800,0,24800,2031900,0,2031900
759,28255,16034031,01- Annual,2016-01-01T00:00:00.000Z,21300,0,21300,2351200,0,2351200
763,28255,16034031,01- Annual,2017-01-01T00:00:00.000Z,21300,0,21300,2500000,0,2500000
767,28617,16038001,,2009-01-01T00:00:00.000Z,9962200,1000,9963200,6682100,0,6682100
771,28619,16038003,,2008-11-01T00:00:00.000Z,4849700,1000,4850700,3252900,0,3252900
775,28621,16038005,,2008-01-01T00:00:00.000Z,6224800,1000,6225800,3896200,0,3896200
779,28622,16038006,,2009-01-01T00:00:00.000Z,4728200,0,4728200,3171400,0,3171400
783,28623,16038008,,2008-11-01T00:00:00.000Z,2364100,1000,2365100,1585700,0,1585700
787,28625,16038010,,2008-01-01T00:00:00.000Z,2196500,0,2196500,1374800,0,1374800
791,28626,16038011,,2009-01-01T00:00:00.000Z,74700,0,74700,50100,0,50100
795,28627,16038012,,2008-11-01T00:00:00.000Z,182000,0,182000,122100,0,122100
799,28665,17003010,01- Annual,2013-01-01T00:00:00.000Z,0,0,0,333200,0,333200
803,28665,17003010,01- Annual,2019-01-01T00:00:00.000Z,0,0,0,2788600,0,2788600
807,28665,17003010,01- Annual,2015-01-01T00:00:00.000Z,0,0,0,369200,0,369200
811,28666,17003011,01- Annual,2016-01-01T00:00:00.000Z,0,0,0,2626500,0,2626500
815,28666,17003011,01- Annual,2017-01-01T00:00:00.000Z,0,0,0,2788600,0,2788600
819,28666,17003011,,2012-01-01T00:00:00.000Z,0,0,0,333200,0,333200
823,28667,17003012,,2011-01-01T00:00:00.000Z,0,0,0,762400,0,762400
1246,43309,27002010,,2009-01-01T00:00:00.000Z,0,0,0,10491000,159200,10650200
1250,43309,27002010,,2012-01-01T00:00:00.000Z,0,0,0,11207900,159200,11367100
1254,43309,27002010,05- Review,2019-03-26T00:00:00.000Z,0,0,0,13348800,1616000,14964800
1258,43309,27002010,01- Annual,2016-01-01T00:00:00.000Z,11500,0,11500,12713100,693300,13406400
1262,43310,27003001,01- Annual,2020-01-01T00:00:00.000Z,0,0,0,10094100,3593400,13687500
1266,43310,27003001,01- Annual,2019-01-01T00:00:00.000Z,0,0,0,10094100,2747300,12841400
1270,43310,27003001,,2011-01-01T00:00:00.000Z,0,0,0,6680700,119400,6800100
1274,43310,27003001,01- Annual,2013-01-01T00:00:00.000Z,0,0,0,8406800,682500,9089300
1278,43313,27004003,05- Review,2013-08-30T00:00:00.000Z,0,0,0,3104700,136900,3241600
1282,43313,27004003,01- Annual,2017-01-01T00:00:00.000Z,0,0,0,3740800,95300,3836100
1286,43313,27004003,01- Annual,2015-01-01T00:00:00.000Z,0,0,0,3400700,356700,3757400
1290,43313,27004003,05- Review,2020-03-31T00:00:00.000Z,0,0,0,3740800,835000,4575800
1294,43385,27007077,01- Annual,2014-01-01T00:00:00.000Z,0,0,0,8418500,1460900,9879400
1298,43385,27007077,01- Annual,2018-01-01T00:00:00.000Z,0,0,0,10088200,2349100,12437300
1302,43385,27007077,,2010-01-01T00:00:00.000Z,0,0,0,6689600,119400,6809000
1306,44098,28004003,,2009-01-01T00:00:00.000Z,109500,210100,319600,26400000,50073700,76473700
1310,44098,28004003,,2010-01-01T00:00:00.000Z,87600,174400,262000,22400000,43615100,66015100
1314,44098,28004003,03- Board of Equalization,2017-08-31T00:00:00.000Z,91300,267900,359200,29600000,58445000,88045000
1318,44098,28004003,01- Annual,2019-01-01T00:00:00.000Z,91300,308500,399800,24000000,72892500,96892500
1322,44098,28004003,01- Annual,2017-01-01T00:00:00.000Z,91300,267900,359200,29600000,60227500,89827500
1326,44099,28004004,,2009-01-01T00:00:00.000Z,227500,0,227500,7797700,10280900,18078600
1330,44711,28018001,,2009-01-01T00:00:00.000Z,180000,116400,296400,6336000,6077200,12413200
1334,44711,28018001,,2010-01-01T00:00:00.000Z,144000,56300,200300,5376000,6120800,11496800
1338,44711,28018001,05- Review,2019-03-18T00:00:00.000Z,150000,0,150000,6000000,9719800,15719800
1342,45694,29003010,01- Annual,2020-01-01T00:00:00.000Z,49500,113800,163300,24795900,74091700,98887600
1346,45694,29003010,01- Annual,2014-01-01T00:00:00.000Z,49800,133800,183600,22781700,51909000,74690700
1350,45694,29003010,05- Review,2015-06-26T00:00:00.000Z,49800,141200,191000,27275500,50552200,77827700
1354,45694,29003010,,2011-01-01T00:00:00.000Z,45800,111700,157500,22781700,36160700,58942400
1358,45695,29003019,,2008-01-01T00:00:00.000Z,3300,0,3300,1504000,0,1504000
1362,45695,29003019,,2012-01-01T00:00:00.000Z,2700,0,2700,1253300,0,1253300
1366,45695,29003019,01- Annual,2015-01-01T00:00:00.000Z,2700,0,2700,1504000,0,1504000
1370,45695,29003019,01- Annual,2017-01-01T00:00:00.000Z,2700,0,2700,1686300,0,1686300
1374,51206,31022005,,2008-01-01T00:00:00.000Z,12200,0,12200,191800,0,191800
1378,51221,31024007,,2009-01-01T00:00:00.000Z,204500,125100,329600,132000,210400,342400
1382,51221,31024007,,2011-01-01T00:00:00.000Z,226500,75900,302400,110000,223400,333400
1386,51294,31025049,,2010-11-01T00:00:00.000Z,0,0,0,0,0,0
1390,51331,31026001,,2012-01-01T00:00:00.000Z,71800,190500,262300,60000,51300,111300
1394,51331,31026001,01- Annual,2014-01-01T00:00:00.000Z,175700,111500,287200,60000,191600,251600
1398,51655,32001002,03- Board of Equalization,2015-11-03T00:00:00.000Z,24500,138288,162788,12418900,111105012,123523912
1402,51655,32001002,01- Annual,2018-01-01T00:00:00.000Z,24500,0,24500,17657400,0,17657400
1406,51655,32001002,,2008-01-01T00:00:00.000Z,29400,182000,211400,12418900,72687300,85106200
1410,51655,32001002,,2011-01-01T00:00:00.000Z,22500,112000,134500,10349100,64857000,75206100
1414,51656,32001003,01- Annual,2020-01-01T00:00:00.000Z,2600,0,2600,1687900,0,1687900
1418,51656,32001003,01- Annual,2013-01-01T00:00:00.000Z,2300,0,2300,1079200,0,1079200
1422,51656,32001003,01- Annual,2018-01-01T00:00:00.000Z,2300,0,2300,1687900,0,1687900
1426,51656,32001003,01- Annual,2014-01-01T00:00:00.000Z,0,0,0,203066300,0,203066300
1430,51658,32001005,01- Annual,2016-01-01T00:00:00.000Z,135000,143800,278800,23100000,28584300,51684300
1434,51658,32001005,01- Annual,2019-01-01T00:00:00.000Z,135000,269700,404700,19800000,49810200,69610200
1438,51658,32001005,01- Annual,2013-01-01T00:00:00.000Z,135000,148700,283700,19800000,30827400,50627400
1442,51658,32001005,,2010-10-01T00:00:00.000Z,129600,114400,244000,18480000,23685500,42165500
1446,51687,32001046,01- Annual,2013-01-01T00:00:00.000Z,24200,0,24200,11162200,0,11162200
1450,51687,32001046,01- Annual,2018-01-01T00:00:00.000Z,24200,0,24200,17457600,0,17457600
1454,51687,32001046,04- Court Order,,0,0,0,0,0,0
1458,51688,32001047,01- Annual,2014-01-01T00:00:00.000Z,0,0,0,64136300,0,64136300
1462,51688,32001047,01- Annual,2018-01-01T00:00:00.000Z,700,0,700,533100,0,533100
1466,51688,32001047,,2009-01-01T00:00:00.000Z,900,0,900,374900,0,374900
1470,51688,32001047,,2010-01-01T00:00:00.000Z,700,0,700,318100,0,318100
1474,51689,32001048,01- Annual,2013-01-01T00:00:00.000Z,25200,0,25200,11644200,0,11644200
1478,51689,32001048,03- Board of Equalization,2017-10-31T00:00:00.000Z,25200,0,25200,22460800,0,22460800
1482,51689,32001048,01- Annual,2015-01-01T00:00:00.000Z,25200,0,25200,12808600,0,12808600
1486,51690,32001049,03- Board of Equalization,2019-10-30T00:00:00.000Z,15500,0,15500,11172700,5463900,16636600
1490,51690,32001049,01- Annual,2017-01-01T00:00:00.000Z,15500,0,15500,13779600,0,13779600
1494,51690,32001049,,2009-01-01T00:00:00.000Z,18600,0,18600,7858100,0,7858100
1498,51690,32001049,,2010-01-01T00:00:00.000Z,14900,0,14900,6667400,0,6667400
1502,52294,32003006,01- Annual,2013-01-01T00:00:00.000Z,778500,604400,1382900,60000,61100,121100
1506,52294,32003006,01- Annual,2014-01-01T00:00:00.000Z,778500,669100,1447600,60000,93900,153900
1510,52342,32006008,,2009-01-01T00:00:00.000Z,528000,674100,1202100,264000,149800,413800
1514,52342,32006008,,2011-01-01T00:00:00.000Z,453200,469500,922700,220000,146800,366800
1518,53213,32024002,,2012-08-01T00:00:00.000Z,75000,227600,302600,21660000,18025800,39685800
1522,53213,32024002,01- Annual,2013-01-01T00:00:00.000Z,75000,227600,302600,21660000,22064900,43724900
1526,53213,32024002,05- Review,2014-06-24T00:00:00.000Z,75000,235700,310700,21660000,74135400,95795400
1530,53213,32024002,01- Annual,2016-01-01T00:00:00.000Z,75000,205900,280900,25270000,78791700,104061700
1534,53213,32024002,03- Board of Equalization,2017-08-31T00:00:00.000Z,75000,242100,317100,26714000,18217800,44931800
1538,53554,34020024,,2008-01-01T00:00:00.000Z,93800,0,93800,17556000,12000000,29556000
1542,53556,34020030,01- Annual,2013-01-01T00:00:00.000Z,4106200,13660200,17766400,26520000,100592400,127112400
1546,53556,34020030,01- Annual,2018-01-01T00:00:00.000Z,2677500,26456800,29134300,26520000,122550100,149070100
1550,53556,34020030,01- Annual,2020-01-01T00:00:00.000Z,3480700,20316700,23797400,38012000,109800600,147812600
1554,53556,34020030,01- Annual,2015-01-01T00:00:00.000Z,2677500,20072500,22750000,29172000,123069600,152241600
1558,53765,34020255,01- Annual,2014-01-01T00:00:00.000Z,41600,263800,305400,21810000,129471500,151281500
1562,53765,34020255,01- Annual,2019-01-01T00:00:00.000Z,41600,564500,606100,26795100,165536400,192331500
1566,53765,34020255,,2011-01-01T00:00:00.000Z,38200,251600,289800,18694300,109085700,127780000
1570,53765,34020255,,2009-01-01T00:00:00.000Z,41600,247600,289200,20601900,103534800,124136700
1574,53766,34020256,,2012-01-01T00:00:00.000Z,30400,0,30400,15920000,0,15920000
1578,53766,34020256,01- Annual,2018-01-01T00:00:00.000Z,30400,0,30400,19558900,0,19558900
1582,53766,34020256,01- Annual,2014-01-01T00:00:00.000Z,30400,0,30400,15920000,0,15920000
1586,54061,34027025,01- Annual,2016-01-01T00:00:00.000Z,403700,840000,1243700,49977000,103657700,153634700
1590,54061,34027025,,2011-01-01T00:00:00.000Z,370100,717600,1087700,39120000,105288100,144408100
1594,54061,34027025,,2008-01-01T00:00:00.000Z,306000,1975600,2281600,43032000,102332300,145364300
1598,54072,35001008,01- Annual,2013-01-01T00:00:00.000Z,272700,667100,939800,26950000,59507000,86457000
1602,54072,35001008,,2010-01-01T00:00:00.000Z,218200,484000,702200,21560000,44401200,65961200
1606,54072,35001008,01- Annual,2014-01-01T00:00:00.000Z,272700,1185000,1457700,26950000,63527000,90477000
1610,54072,35001008,01- Annual,2018-01-01T00:00:00.000Z,272700,1769300,2042000,33110000,73389500,106499500
1614,54077,35001019,01- Annual,2014-01-01T00:00:00.000Z,365600,1847100,2212700,24360000,71333600,95693600
1618,54077,35001019,01- Annual,2017-01-01T00:00:00.000Z,365600,781400,1147000,29928000,70245000,100173000
1622,54077,35001019,01- Annual,2013-01-01T00:00:00.000Z,365600,1289000,1654600,24360000,69350000,93710000
1626,54280,35003001,01- Annual,2014-01-01T00:00:00.000Z,336800,1000,337800,12303900,0,12303900
1630,54281,35003002,01- Annual,2019-01-01T00:00:00.000Z,220200,1000,221200,15658500,0,15658500
1634,54281,35003002,01- Annual,2016-01-01T00:00:00.000Z,216200,1000,217200,14613400,0,14613400
1638,54282,35003003,01- Annual,2014-01-01T00:00:00.000Z,242300,2301800,2544100,9980900,129894800,139875700
1642,54282,35003003,,2009-01-01T00:00:00.000Z,242300,4157400,4399700,9410600,107386200,116796800
1646,54282,35003003,,2011-01-01T00:00:00.000Z,222100,1914000,2136100,8555100,106549900,115105000
1650,54283,35003004,,2010-01-01T00:00:00.000Z,174300,0,174300,7179600,0,7179600
1654,54283,35003004,,2008-01-01T00:00:00.000Z,217900,0,217900,8461700,0,8461700
827,28667,17003012,01- Annual,2018-01-01T00:00:00.000Z,0,0,0,6426700,0,6426700
831,28667,17003012,01- Annual,2020-01-01T00:00:00.000Z,0,0,0,7361900,0,7361900
835,28926,17003298,01- Annual,2014-01-01T00:00:00.000Z,0,0,0,16700,0,16700
839,28926,17003298,,2010-01-01T00:00:00.000Z,0,0,0,13300,0,13300
843,28927,17003299,01- Annual,2013-01-01T00:00:00.000Z,0,0,0,41700,0,41700
847,28927,17003299,01- Annual,2019-01-01T00:00:00.000Z,0,0,0,348500,0,348500
851,28927,17003299,01- Annual,2015-01-01T00:00:00.000Z,0,0,0,48400,0,48400
855,28928,17003300,01- Annual,2016-01-01T00:00:00.000Z,0,0,0,328200,0,328200
859,28928,17003300,01- Annual,2017-01-01T00:00:00.000Z,0,0,0,348500,0,348500
863,28928,17003300,,2012-01-01T00:00:00.000Z,0,0,0,41700,0,41700
867,29225,17005002,,2010-01-01T00:00:00.000Z,93900,0,93900,4518000,0,4518000
871,29227,17005004,,2012-01-01T00:00:00.000Z,80400,0,80400,3835100,0,3835100
875,29229,17005006,,2011-01-01T00:00:00.000Z,134700,0,134700,6008100,0,6008100
879,29230,17005007,,2010-01-01T00:00:00.000Z,34300,0,34300,1648200,0,1648200
883,29232,17005009,,2012-01-01T00:00:00.000Z,53900,0,53900,2572900,0,2572900
887,29233,17005010,,2011-01-01T00:00:00.000Z,51700,0,51700,2304900,0,2304900
891,29234,17005011,,2010-01-01T00:00:00.000Z,103600,0,103600,4985400,0,4985400
895,29284,17011007,,2011-01-01T00:00:00.000Z,81400,0,81400,713400,0,713400
899,29286,17011009,,2010-01-01T00:00:00.000Z,95200,0,95200,520800,0,520800
903,29289,17011013,,2008-01-01T00:00:00.000Z,200200,0,200200,895100,1000,896100
907,29290,17011015,,2010-01-01T00:00:00.000Z,356400,0,356400,1949900,0,1949900
911,29291,17011016,,2008-01-01T00:00:00.000Z,1284700,0,1284700,5744800,1000,5745800
915,29293,17011018,,2011-01-01T00:00:00.000Z,485400,1000,486400,4252100,0,4252100
919,29329,17013017,01- Annual,2015-01-01T00:00:00.000Z,40700,534900,575600,23399600,113152300,136551900
923,29329,17013017,01- Annual,2018-01-01T00:00:00.000Z,40700,0,40700,26134700,0,26134700
927,29329,17013017,,2008-01-01T00:00:00.000Z,40700,385300,426000,20084800,85644400,105729200
931,29330,17013019,01- Annual,2020-01-01T00:00:00.000Z,59900,0,59900,35527300,107985000,143512300
935,29330,17013019,,2010-01-01T00:00:00.000Z,44200,0,44200,23166300,60509100,83675400
939,29330,17013019,01- Annual,2017-01-01T00:00:00.000Z,55300,0,55300,35527300,96134100,131661400
943,29330,17013019,01- Annual,2014-01-01T00:00:00.000Z,55300,0,55300,24786500,85407700,110194200
947,29332,17014001,05- Review,2015-07-28T00:00:00.000Z,901700,4564800,5466500,19558000,65459600,85017600
951,29332,17014001,,2011-01-01T00:00:00.000Z,826500,0,826500,15240000,20000,15260000
955,32270,18003111,01- Annual,2013-01-01T00:00:00.000Z,108000,940800,1048800,40250000,161311500,201561500
959,32270,18003111,,2009-11-01T00:00:00.000Z,108000,861100,969100,37950000,134205800,172155800
963,32270,18003111,03- Board of Equalization,2017-10-10T00:00:00.000Z,108000,866900,974900,49450000,137262000,186712000
967,32270,18003111,03- Board of Equalization,2019-10-24T00:00:00.000Z,108000,763800,871800,49450000,156811600,206261600
971,32270,18003111,03- Board of Equalization,2015-09-28T00:00:00.000Z,201600,1022216,1223816,44275000,148228584,192503584
975,32270,18003111,01- Annual,2014-01-01T00:00:00.000Z,108000,1140600,1248600,40250000,158869400,199119400
979,32675,18003602,03- Board of Equalization,2015-11-03T00:00:00.000Z,144000,1347300,1491300,43428000,164129700,207557700
983,32675,18003602,01- Annual,2018-01-01T00:00:00.000Z,144000,1100200,1244200,48504000,155261900,203765900
987,32675,18003602,,2010-01-01T00:00:00.000Z,115200,801900,917100,31584000,130646300,162230300
991,32685,18004066,01- Annual,2013-01-01T00:00:00.000Z,613600,6398100,7011700,17478600,102251700,119730300
995,32685,18004066,,2012-01-01T00:00:00.000Z,613600,6010200,6623800,14981600,101700300,116681900
999,32685,18004066,01- Annual,2018-01-01T00:00:00.000Z,376300,0,376300,13169700,0,13169700
1003,32685,18004066,03- Board of Equalization,2019-09-12T00:00:00.000Z,527700,6671500,7199200,18466200,104276600,122742800
1007,32685,18004066,03- Board of Equalization,2014-10-13T00:00:00.000Z,613600,6718600,7332200,17478600,105589900,123068500
1011,32685,18004066,01- Annual,2020-01-01T00:00:00.000Z,527200,7164600,7691800,18466700,110007900,128474600
1015,32691,18005040,01- Annual,2015-01-01T00:00:00.000Z,359500,0,359500,11265600,0,11265600
1019,32691,18005040,03- Board of Equalization,2019-09-12T00:00:00.000Z,309200,0,309200,10822000,0,10822000
1023,32691,18005040,03- Board of Equalization,2016-10-04T00:00:00.000Z,330700,0,330700,10902736,0,10902736
1027,32691,18005040,,2011-01-01T00:00:00.000Z,329600,0,329600,8778400,0,8778400
1031,32691,18005040,,2008-01-01T00:00:00.000Z,359500,0,359500,9656200,0,9656200
1035,32889,18007031,,2008-01-01T00:00:00.000Z,75000,88900,163900,17424000,37541100,54965100
1039,32889,18007031,,2011-01-01T00:00:00.000Z,68800,81400,150200,15840000,42410800,58250800
1043,32943,18013005,,2008-01-01T00:00:00.000Z,1577200,0,1577200,2622900,0,2622900
1047,32947,18013009,,2008-01-01T00:00:00.000Z,245100,0,245100,407600,0,407600
1051,33220,18029007,01- Annual,2013-01-01T00:00:00.000Z,1245400,7393500,8638900,9120000,46910900,56030900
1055,33220,18029007,01- Annual,2018-01-01T00:00:00.000Z,1245400,11078000,12323400,9120000,56373200,65493200
1059,33220,18029007,01- Annual,2016-01-01T00:00:00.000Z,1245400,9121200,10366600,10640000,52946000,63586000
1063,33352,18038019,,2012-01-01T00:00:00.000Z,956600,0,956600,6442600,1983700,8426300
1067,33353,18038020,,2010-01-01T00:00:00.000Z,348100,0,348100,2279500,0,2279500
1071,33424,18041002,,2011-01-01T00:00:00.000Z,11000,841100,852100,220000,199100,419100
1075,33424,18041002,,2009-01-01T00:00:00.000Z,11000,927100,938100,264000,137900,401900
1079,33610,18054007,01- Annual,2016-01-01T00:00:00.000Z,137500,76100,213600,631800,1483600,2115400
1083,33610,18054007,01- Annual,2019-01-01T00:00:00.000Z,144400,132400,276800,663400,1744600,2408000
1087,33610,18054007,05- Review,2013-08-21T00:00:00.000Z,137500,49500,187000,546000,1191800,1737800
1091,33610,18054007,,2012-01-01T00:00:00.000Z,137500,89700,227200,546000,1091300,1637300
1095,33614,18054011,,2010-01-01T00:00:00.000Z,15000,317400,332400,198000,248000,446000
1099,33614,18054011,01- Annual,2015-01-01T00:00:00.000Z,213100,554800,767900,0,539400,539400
1103,33616,18054013,,2008-01-01T00:00:00.000Z,270000,421500,691500,264000,95300,359300
1107,33616,18054013,,2012-01-01T00:00:00.000Z,294000,333300,627300,240000,174700,414700
1111,34352,18084003,,2010-01-01T00:00:00.000Z,260900,101900,362800,11984000,7566600,19550600
1115,34352,18084003,01- Annual,2016-01-01T00:00:00.000Z,326100,157800,483900,17334000,8598700,25932700
1119,34352,18084003,01- Annual,2018-01-01T00:00:00.000Z,326100,613100,939200,18404000,15310500,33714500
1123,34491,19007003,01- Annual,2017-01-01T00:00:00.000Z,114100,99400,213500,2815600,1529000,4344600
1127,34495,19007007,01- Annual,2017-01-01T00:00:00.000Z,60800,51900,112700,1500800,797700,2298500
1131,35640,20012019,01- Annual,2020-01-01T00:00:00.000Z,852900,0,852900,10648200,0,10648200
1135,35975,20012359,01- Annual,2015-01-01T00:00:00.000Z,132200,793600,925800,12551000,39268400,51819400
1139,40065,23034017,03- Board of Equalization,2018-07-26T00:00:00.000Z,1738500,0,1738500,9339500,0,9339500
1143,40066,23034018,01- Annual,2020-01-01T00:00:00.000Z,2440700,14495900,16936600,11919900,42567100,54487000
1147,40066,23034018,05- Review,2017-04-03T00:00:00.000Z,2440700,1000,2441700,12792000,0,12792000
1151,40067,23034019,01- Annual,2018-01-01T00:00:00.000Z,119300,0,119300,640600,0,640600
1155,40416,23040009,01- Annual,2017-01-01T00:00:00.000Z,381500,0,381500,10974700,1000,10975700
1159,40994,24015015,03- Board of Equalization,2018-11-14T00:00:00.000Z,588000,3005200,3593200,10505100,18002700,28507800
1163,40994,24015015,01- Annual,2013-01-01T00:00:00.000Z,705600,1250100,1955700,12255900,9414000,21669900
1167,40994,24015015,01- Annual,2020-01-01T00:00:00.000Z,646800,902600,1549400,10505100,35533200,46038300
1171,40995,24015017,,2010-01-01T00:00:00.000Z,606100,0,606100,0,0,0
1175,40995,24015017,01- Annual,2015-01-01T00:00:00.000Z,43400,0,43400,852400,0,852400
1179,42114,25016006,,2008-01-01T00:00:00.000Z,2280900,0,2280900,7730600,0,7730600
1183,42117,25016011,,2008-01-01T00:00:00.000Z,184300,0,184300,624500,0,624500
1187,43303,27002001,01- Annual,2013-01-01T00:00:00.000Z,0,0,0,31869700,2588900,34458600
1191,43303,27002001,01- Annual,2017-01-01T00:00:00.000Z,0,0,0,38384400,982300,39366700
1195,43303,27002001,01- Annual,2015-01-01T00:00:00.000Z,0,0,0,34894900,3677400,38572300
1199,43303,27002001,05- Review,2020-03-31T00:00:00.000Z,0,0,0,38384400,8611300,46995700
1203,43306,27002004,01- Annual,2014-01-01T00:00:00.000Z,100000,92800,192800,4272900,747200,5020100
1207,43306,27002004,01- Annual,2018-01-01T00:00:00.000Z,0,345600,345600,5132800,1201600,6334400
1211,43306,27002004,,2010-01-01T00:00:00.000Z,96000,58800,154800,3395400,53100,3448500
1215,43306,27002004,,2008-01-01T00:00:00.000Z,120000,70500,190500,3999600,390000,4389600
1219,43307,27002005,,2010-01-01T00:00:00.000Z,0,0,0,12089900,212300,12302200
1223,43307,27002005,01- Annual,2018-01-01T00:00:00.000Z,0,0,0,18276300,4252700,22529000
1227,43307,27002005,01- Annual,2014-01-01T00:00:00.000Z,0,0,0,15214500,2644800,17859300
1231,43308,27002006,05- Review,2020-03-31T00:00:00.000Z,0,0,0,16924700,3809800,20734500
1235,43308,27002006,01- Annual,2015-01-01T00:00:00.000Z,0,0,0,15386100,1626900,17013000
4,8773,05031006,,2009-01-01T00:00:00.000Z,156800,181100,337900,349100,204700,553800
8,8773,05031006,01- Annual,2015-01-01T00:00:00.000Z,396900,-19000,377900,0,792300,792300
12,8862,05038013,,2008-01-01T00:00:00.000Z,87000,66500,153500,210400,139100,349500
16,8862,05038013,,2012-01-01T00:00:00.000Z,73900,85100,159000,280500,96500,377000
20,9321,05056002,,2009-01-01T00:00:00.000Z,586600,0,586600,3234000,1000,3235000
24,9712,06002031,01- Annual,2013-01-01T00:00:00.000Z,166500,215600,382100,56000,56200,112200
28,9712,06002031,01- Annual,2014-01-01T00:00:00.000Z,166500,233400,399900,56000,99600,155600
32,10406,06028015,,2012-01-01T00:00:00.000Z,74500,245800,320300,132000,105800,237800
36,10406,06028015,,2009-01-01T00:00:00.000Z,74500,276200,350700,132000,104400,236400
40,10855,07006012,01- Annual,2013-01-01T00:00:00.000Z,495900,643400,1139300,220000,192800,412800
44,10855,07006012,01- Annual,2014-01-01T00:00:00.000Z,495900,684500,1180400,220000,352800,572800
48,10859,07006016,01- Annual,2014-01-01T00:00:00.000Z,8400,240500,248900,363100,845900,1209000
52,10859,07006016,,2010-01-01T00:00:00.000Z,50400,171400,221800,365200,687600,1052800
56,10859,07006016,01- Annual,2020-01-01T00:00:00.000Z,52500,390500,443000,442400,1313600,1756000
60,11215,07007037,01- Annual,2013-01-01T00:00:00.000Z,118800,292000,410800,322600,700000,1022600
64,11215,07007037,01- Annual,2019-01-01T00:00:00.000Z,118800,702800,821600,396500,798000,1194500
68,11406,07012015,01- Annual,2015-01-01T00:00:00.000Z,486500,-33100,453400,0,316900,316900
72,11406,07012015,,2010-01-01T00:00:00.000Z,374500,3800,378300,112000,84400,196400
76,15138,10028012,,2008-01-01T00:00:00.000Z,104000,619300,723300,396000,12900,408900
80,15138,10028012,,2011-01-01T00:00:00.000Z,170000,534800,704800,330000,28600,358600
84,15235,10035023,,2012-01-01T00:00:00.000Z,1102000,117400,1219400,198000,120700,318700
88,15235,10035023,,2009-01-01T00:00:00.000Z,1102000,122000,1224000,198000,110400,308400
92,16195,11012008,,2008-01-01T00:00:00.000Z,37800,0,37800,1371400,0,1371400
96,16207,11012021,,2008-01-01T00:00:00.000Z,56000,0,56000,2029900,0,2029900
100,19076,13018012,01- Annual,2018-01-01T00:00:00.000Z,10700,29600,40300,612400,1299100,1911500
104,19080,13018017,01- Annual,2018-01-01T00:00:00.000Z,9100,29600,38700,523300,1299100,1822400
108,19601,13031015,,2010-01-01T00:00:00.000Z,181500,84400,265900,56000,390000,446000
112,21915,14022010,,2011-01-01T00:00:00.000Z,139600,146300,285900,165000,101700,266700
116,21915,14022010,,2009-01-01T00:00:00.000Z,238600,500800,739400,66000,36800,102800
120,22480,14032001,01- Annual,2017-01-01T00:00:00.000Z,142200,534100,676300,9129900,33230700,42360600
124,22506,14035001,01- Annual,2013-01-01T00:00:00.000Z,55000,0,55000,2674500,0,2674500
128,22511,14035006,01- Annual,2013-01-01T00:00:00.000Z,51600,0,51600,2505100,0,2505100
132,22516,14035013,01- Annual,2013-01-01T00:00:00.000Z,41200,0,41200,2004100,0,2004100
136,22520,14035018,01- Annual,2013-01-01T00:00:00.000Z,12900,0,12900,626300,0,626300
140,22750,14041013,01- Annual,,0,0,0,0,0,0
144,23311,14042574,01- Annual,2015-01-01T00:00:00.000Z,287700,2218100,2505800,29491000,124247100,153738100
148,23311,14042574,01- Annual,2018-01-01T00:00:00.000Z,287700,1921800,2209500,32938000,111902800,144840800
152,23311,14042574,,2008-01-01T00:00:00.000Z,287700,1511600,1799300,25278000,93891000,119169000
156,23311,14042574,,2012-01-01T00:00:00.000Z,287700,1666000,1953700,26810000,105883200,132693200
160,23343,14045008,,2012-10-01T00:00:00.000Z,1611700,8446100,10057800,35630000,117263600,152893600
164,23343,14045008,,2008-01-01T00:00:00.000Z,1611700,7468400,9080100,33594000,96140900,129734900
168,23343,14045008,01- Annual,2019-01-01T00:00:00.000Z,1611700,9484100,11095800,43774000,122543800,166317800
172,23343,14045008,03- Board of Equalization,2016-09-06T00:00:00.000Z,1611700,7938800,9550500,41229000,106429900,147658900
176,23343,14045008,01- Annual,2016-01-01T00:00:00.000Z,1611700,8256800,9868500,41229000,121990500,163219500
180,23344,14046006,01- Annual,2015-01-01T00:00:00.000Z,18700,0,18700,2679200,0,2679200
184,23344,14046006,01- Annual,2019-01-01T00:00:00.000Z,18700,0,18700,2992400,0,2992400
188,23344,14046006,,2010-01-01T00:00:00.000Z,14900,0,14900,1948500,0,1948500
192,23348,14046026,01- Annual,2020-01-01T00:00:00.000Z,1600,0,1600,230800,0,230800
196,23348,14046026,,2009-01-01T00:00:00.000Z,1400,0,1400,177100,0,177100
200,23348,14046026,01- Annual,2018-01-01T00:00:00.000Z,1400,0,1400,230800,0,230800
204,23348,14046026,01- Annual,2016-01-01T00:00:00.000Z,1400,0,1400,217400,0,217400
208,23349,14046027,01- Annual,2017-01-01T00:00:00.000Z,8000,0,8000,1279300,0,1279300
212,23349,14046027,,2008-01-01T00:00:00.000Z,8000,0,8000,981800,0,981800
216,23349,14046027,,2012-01-01T00:00:00.000Z,8000,0,8000,1041300,0,1041300
220,23350,14046028,,2011-01-01T00:00:00.000Z,8600,0,8600,1043900,0,1043900
224,23350,14046028,01- Annual,2013-01-01T00:00:00.000Z,9300,0,9300,1217800,0,1217800
228,23350,14046028,01- Annual,2014-01-01T00:00:00.000Z,9300,0,9300,1217800,0,1217800
232,23351,14046029,01- Annual,2015-01-01T00:00:00.000Z,155800,1271600,1427400,22349100,89113900,111463000
236,23351,14046029,01- Annual,2018-01-01T00:00:00.000Z,155800,897200,1053000,24961300,92100500,117061800
240,23351,14046029,03- Board of Equalization,2013-08-12T00:00:00.000Z,155800,1099700,1255500,20317400,95093800,115411200
244,23351,14046029,,2009-01-01T00:00:00.000Z,155800,971200,1127000,19156400,75958400,95114800
248,23351,14046029,01- Annual,2020-01-01T00:00:00.000Z,168700,1391600,1560300,24961300,94401000,119362300
252,23353,14047019,,2011-01-01T00:00:00.000Z,311300,3671500,3982800,20013100,158549400,178562500
256,23353,14047019,01- Annual,2013-01-01T00:00:00.000Z,339600,4161800,4501400,23348600,186308100,209656700
260,23353,14047019,01- Annual,2017-01-01T00:00:00.000Z,339600,5589500,5929100,28685400,192111700,220797100
264,23353,14047019,01- Annual,2016-01-01T00:00:00.000Z,339600,6688000,7027600,27017600,201300800,228318400
268,23354,14047020,01- Annual,2017-01-01T00:00:00.000Z,387300,0,387300,32718600,0,32718600
272,23354,14047020,,2008-01-01T00:00:00.000Z,387300,0,387300,25109600,0,25109600
276,23354,14047020,,2012-01-01T00:00:00.000Z,387300,0,387300,26631400,0,26631400
280,23846,14050036,,2010-01-01T00:00:00.000Z,470400,1083500,1553900,24528000,94678900,119206900
284,23846,14050036,01- Annual,2020-01-01T00:00:00.000Z,637000,3375300,4012300,37410000,139934300,177344300
288,23846,14050036,03- Board of Equalization,2014-09-09T00:00:00.000Z,588000,2101500,2689500,30660000,130982200,161642200
292,23850,14051019,01- Annual,2017-01-01T00:00:00.000Z,552000,0,552000,20382000,1000,20383000
296,23850,14051019,01- Annual,2018-01-01T00:00:00.000Z,552000,0,552000,20382000,1000,20383000
300,23850,14051019,,2008-01-01T00:00:00.000Z,552000,0,552000,15642000,1000,15643000
304,23850,14051019,,2012-01-01T00:00:00.000Z,552000,0,552000,16590000,1000,16591000
308,24294,14060026,,2009-01-01T00:00:00.000Z,6064400,1000,6065400,3511000,0,3511000
312,24302,14060050,,2009-01-01T00:00:00.000Z,16897000,1000,16898000,9782400,0,9782400
316,25775,15062003,,2009-01-01T00:00:00.000Z,215200,164900,380100,132000,78700,210700
320,25775,15062003,,2011-01-01T00:00:00.000Z,237200,96200,333400,110000,94800,204800
324,25815,15064001,,2011-01-01T00:00:00.000Z,369400,235700,605100,110000,99600,209600
328,25815,15064001,,2009-01-01T00:00:00.000Z,347400,312000,659400,132000,83900,215900
332,25841,15066001,,2012-01-01T00:00:00.000Z,464400,387700,852100,120000,122900,242900
336,25841,15066001,01- Annual,2015-01-01T00:00:00.000Z,584400,317100,901500,0,316900,316900
340,25865,15067008,,2011-01-01T00:00:00.000Z,505600,20500,526100,55000,56900,111900
344,25865,15067008,,2009-01-01T00:00:00.000Z,494600,29300,523900,66000,46900,112900
348,25996,15074008,,2011-01-01T00:00:00.000Z,31100,1395500,1426600,2485200,62575200,65060400
352,25996,15074008,01- Annual,2014-01-01T00:00:00.000Z,33900,1863700,1897600,2899400,14075600,16975000
356,25996,15074008,01- Annual,2016-01-01T00:00:00.000Z,33900,1862900,1896800,3355000,14656500,18011500
360,25996,15074008,01- Annual,2018-01-01T00:00:00.000Z,33900,0,33900,3562100,0,3562100
364,25997,15074009,01- Annual,2017-01-01T00:00:00.000Z,33900,0,33900,3562100,14549700,18111800
368,25997,15074009,03- Board of Equalization,2019-10-10T00:00:00.000Z,34500,0,34500,3550000,15225000,18775000
372,25997,15074009,01- Annual,2015-01-01T00:00:00.000Z,33900,0,33900,3189400,14550400,17739800
376,25997,15074009,,2009-01-01T00:00:00.000Z,33900,0,33900,2724400,0,2724400
380,25998,15074010,,2010-01-01T00:00:00.000Z,20400,0,20400,1733700,0,1733700
384,25998,15074010,,2008-01-01T00:00:00.000Z,25400,0,25400,2043300,0,2043300
388,25998,15074010,05- Review,2015-09-03T00:00:00.000Z,25400,0,25400,2392000,10934900,13326900
392,25998,15074010,01- Annual,2019-01-01T00:00:00.000Z,25400,0,25400,2671600,11848600,14520200
396,25998,15074010,01- Annual,2020-01-01T00:00:00.000Z,28000,0,28000,2662500,11879700,14542200
400,25999,15074011,03- Board of Equalization,2018-08-21T00:00:00.000Z,25700,0,25700,2695500,11239700,13935200
404,25999,15074011,03- Board of Equalization,2016-09-19T00:00:00.000Z,25700,0,25700,2538700,11118200,13656900
408,25999,15074011,01- Annual,2013-01-01T00:00:00.000Z,25700,0,25700,2194000,8524900,10718900
412,25999,15074011,,2012-01-01T00:00:00.000Z,25700,0,25700,2194000,0,2194000
416,26000,15074012,,2011-01-01T00:00:00.000Z,15700,0,15700,1253700,0,1253700
1,8773,05031006,,2012-01-01T00:00:00.000Z,123000,231900,354900,273900,291600,565500
5,8773,05031006,,2008-01-01T00:00:00.000Z,156800,193200,350000,349100,160700,509800
9,8862,05038013,01- Annual,2015-01-01T00:00:00.000Z,383400,-217600,165800,0,621600,621600
13,8862,05038013,,2009-01-01T00:00:00.000Z,87000,98300,185300,280500,106400,386900
17,9321,05056002,,2012-01-01T00:00:00.000Z,488900,0,488900,2940000,0,2940000
21,9321,05056002,,2008-01-01T00:00:00.000Z,586600,0,586600,3234000,1000,3235000
25,9712,06002031,,2010-01-01T00:00:00.000Z,166500,153800,320300,56000,37500,93500
29,9712,06002031,01- Annual,2015-01-01T00:00:00.000Z,222500,177400,399900,0,158500,158500
33,10406,06028015,,2011-01-01T00:00:00.000Z,74500,233700,308200,132000,91900,223900
37,10406,06028015,,2008-01-01T00:00:00.000Z,108400,234700,343100,132000,86100,218100
41,10855,07006012,,2010-01-01T00:00:00.000Z,491900,472800,964700,224000,90400,314400
45,10855,07006012,01- Annual,2015-01-01T00:00:00.000Z,715900,464500,1180400,0,633800,633800
49,10859,07006016,01- Annual,2019-01-01T00:00:00.000Z,52500,371300,423800,442400,1275700,1718100
53,10859,07006016,01- Annual,2013-01-01T00:00:00.000Z,52500,191100,243600,363100,841700,1204800
57,11215,07007037,01- Annual,2020-01-01T00:00:00.000Z,118800,740200,859000,396500,953700,1350200
61,11215,07007037,,2010-01-01T00:00:00.000Z,114000,233700,347700,327400,515900,843300
65,11215,07007037,01- Annual,2014-01-01T00:00:00.000Z,40300,384000,424300,322600,703400,1026000
69,11406,07012015,01- Annual,2014-01-01T00:00:00.000Z,366500,86900,453400,120000,191300,311300
73,11406,07012015,01- Annual,2013-01-01T00:00:00.000Z,366500,66700,433200,120000,104300,224300
77,15138,10028012,,2009-01-01T00:00:00.000Z,104000,594400,698400,396000,28000,424000
81,15138,10028012,,2012-01-01T00:00:00.000Z,140000,647800,787800,360000,100400,460400
85,15235,10035023,,2011-01-01T00:00:00.000Z,1102000,43500,1145500,198000,87800,285800
89,15235,10035023,,2008-01-01T00:00:00.000Z,1102000,108100,1210100,198000,77100,275100
93,16196,11012009,,2008-01-01T00:00:00.000Z,34100,0,34100,1235700,0,1235700
97,16210,11012025,,2008-01-01T00:00:00.000Z,67000,0,67000,2428600,0,2428600
101,19077,13018013,01- Annual,2018-01-01T00:00:00.000Z,45000,29600,74600,2580300,1299100,3879400
105,19601,13031015,,2008-01-01T00:00:00.000Z,171500,232200,403700,66000,18300,84300
109,19601,13031015,,2011-01-01T00:00:00.000Z,182500,84900,267400,55000,445100,500100
113,21915,14022010,,2010-01-01T00:00:00.000Z,136600,135300,271900,168000,74800,242800
117,21915,14022010,,2008-01-01T00:00:00.000Z,238600,136500,375100,66000,28200,94200
121,22481,14032002,01- Annual,2017-01-01T00:00:00.000Z,23900,0,23900,1534000,5582700,7116700
125,22507,14035002,01- Annual,2013-01-01T00:00:00.000Z,41200,0,41200,2004100,0,2004100
129,22512,14035008,01- Annual,2013-01-01T00:00:00.000Z,82500,0,82500,4008200,0,4008200
133,22517,14035014,01- Annual,2013-01-01T00:00:00.000Z,41200,0,41200,2004100,0,2004100
137,22521,14035019,01- Annual,2013-01-01T00:00:00.000Z,12900,0,12900,626300,0,626300
141,23311,14042574,01- Annual,2017-01-01T00:00:00.000Z,287700,2261800,2549500,32938000,112999200,145937200
145,23311,14042574,03- Board of Equalization,2014-09-09T00:00:00.000Z,287700,1889100,2176800,26810000,126024000,152834000
149,23311,14042574,01- Annual,2019-01-01T00:00:00.000Z,287700,2048400,2336100,32938000,121394400,154332400
153,23311,14042574,,2009-01-01T00:00:00.000Z,287700,1439700,1727400,25278000,81508800,106786800
157,23343,14045008,,2012-01-01T00:00:00.000Z,1611700,8427600,10039300,35630000,128250900,163880900
161,23343,14045008,,2010-10-01T00:00:00.000Z,1289300,6234700,7524000,28504000,88194800,116698800
165,23343,14045008,01- Annual,2013-01-01T00:00:00.000Z,1611700,8427600,10039300,35630000,128250900,163880900
169,23343,14045008,03- Board of Equalization,2018-07-25T00:00:00.000Z,1611700,7637500,9249200,43774000,121872400,165646400
173,23343,14045008,01- Annual,2014-01-01T00:00:00.000Z,1611700,9546700,11158400,35630000,137308900,172938900
177,23343,14045008,03- Board of Equalization,2015-07-20T00:00:00.000Z,1649600,7682600,9332200,39193000,116757800,155950800
181,23344,14046006,01- Annual,2014-01-01T00:00:00.000Z,18700,0,18700,2435700,0,2435700
185,23344,14046006,01- Annual,2013-01-01T00:00:00.000Z,18700,0,18700,2435700,0,2435700
189,23344,14046006,,2011-01-01T00:00:00.000Z,17100,0,17100,2087700,0,2087700
193,23348,14046026,,2012-01-01T00:00:00.000Z,1400,0,1400,187800,0,187800
197,23348,14046026,,2008-01-01T00:00:00.000Z,1400,0,1400,177100,0,177100
201,23348,14046026,01- Annual,2017-01-01T00:00:00.000Z,1400,0,1400,230800,0,230800
205,23349,14046027,01- Annual,2016-01-01T00:00:00.000Z,8000,0,8000,1204900,0,1204900
209,23349,14046027,01- Annual,2018-01-01T00:00:00.000Z,8000,0,8000,1279300,0,1279300
213,23349,14046027,,2009-01-01T00:00:00.000Z,8000,0,8000,981800,0,981800
217,23349,14046027,01- Annual,2020-01-01T00:00:00.000Z,8600,0,8600,1279300,0,1279300
221,23350,14046028,,2010-01-01T00:00:00.000Z,7500,0,7500,974300,0,974300
225,23350,14046028,01- Annual,2019-01-01T00:00:00.000Z,9300,0,9300,1496200,0,1496200
229,23350,14046028,01- Annual,2015-01-01T00:00:00.000Z,9300,0,9300,1339600,0,1339600
233,23351,14046029,03- Board of Equalization,2014-10-06T00:00:00.000Z,155800,1015200,1171000,20317400,67225500,87542900
237,23351,14046029,03- Board of Equalization,2017-10-24T00:00:00.000Z,155800,919500,1075300,24961300,88328700,113290000
241,23351,14046029,,2009-09-01T00:00:00.000Z,155800,971200,1127000,19156400,77861500,97017900
245,23351,14046029,,2010-01-01T00:00:00.000Z,124600,920800,1045400,16253900,70169800,86423700
249,23351,14046029,03- Board of Equalization,2019-10-30T00:00:00.000Z,155800,1191600,1347400,24961300,88354100,113315400
253,23353,14047019,,2010-01-01T00:00:00.000Z,271700,3464600,3736300,18678800,129817800,148496600
257,23353,14047019,01- Annual,2019-01-01T00:00:00.000Z,339600,6781900,7121500,28685400,203928700,232614100
261,23353,14047019,01- Annual,2014-01-01T00:00:00.000Z,339600,4195400,4535000,23348600,198297800,221646400
265,23354,14047020,01- Annual,2016-01-01T00:00:00.000Z,387300,0,387300,30816400,0,30816400
269,23354,14047020,01- Annual,2018-01-01T00:00:00.000Z,387300,0,387300,32718600,0,32718600
273,23354,14047020,,2009-01-01T00:00:00.000Z,387300,0,387300,25109600,0,25109600
277,23354,14047020,01- Annual,2020-01-01T00:00:00.000Z,419600,0,419600,32718600,0,32718600
281,23846,14050036,,2009-01-01T00:00:00.000Z,588000,1177200,1765200,28908000,102627600,131535600
285,23846,14050036,01- Annual,2019-01-01T00:00:00.000Z,588000,3130900,3718900,37410000,132055500,169465500
289,23846,14050036,01- Annual,2015-01-01T00:00:00.000Z,588000,2177200,2765200,33495000,129326900,162821900
293,23850,14051019,01- Annual,2016-01-01T00:00:00.000Z,552000,0,552000,19197000,1000,19198000
297,23850,14051019,01- Annual,2019-01-01T00:00:00.000Z,552000,0,552000,20382000,1000,20383000
301,23850,14051019,,2009-01-01T00:00:00.000Z,552000,0,552000,15642000,1000,15643000
305,24283,14060013,,2009-01-01T00:00:00.000Z,4325600,1000,4326600,2504300,0,2504300
309,24296,14060036,,2009-01-01T00:00:00.000Z,5345200,1000,5346200,3094600,0,3094600
313,24307,14060058,,2009-01-01T00:00:00.000Z,3758800,1000,3759800,2176100,0,2176100
317,25775,15062003,,2008-01-01T00:00:00.000Z,215200,141300,356500,132000,51400,183400
321,25775,15062003,,2010-01-01T00:00:00.000Z,235200,96200,331400,112000,65800,177800
325,25815,15064001,,2012-01-01T00:00:00.000Z,359400,284800,644200,120000,112700,232700
329,25841,15066001,,2009-01-01T00:00:00.000Z,452400,424700,877100,132000,98500,230500
333,25841,15066001,,2011-01-01T00:00:00.000Z,474400,326000,800400,110000,109100,219100
337,25865,15067008,01- Annual,2015-01-01T00:00:00.000Z,560600,46200,606800,0,154600,154600
341,25865,15067008,,2012-01-01T00:00:00.000Z,500600,59500,560100,60000,61400,121400
345,25923,15070001,,2010-01-01T00:00:00.000Z,1480500,3893400,5373900,0,0,0
349,25996,15074008,,2009-01-01T00:00:00.000Z,33900,1247000,1280900,2724400,76490500,79214900
353,25996,15074008,01- Annual,2015-01-01T00:00:00.000Z,33900,1834500,1868400,3189400,14550400,17739800
357,25996,15074008,03- Board of Equalization,2019-10-10T00:00:00.000Z,34500,1443300,1477800,3550000,15225000,18775000
361,25996,15074008,01- Annual,2017-01-01T00:00:00.000Z,33900,2262000,2295900,3562100,14549700,18111800
365,25997,15074009,01- Annual,2018-01-01T00:00:00.000Z,33900,0,33900,3562100,0,3562100
369,25997,15074009,01- Annual,2016-01-01T00:00:00.000Z,33900,0,33900,3355000,14656500,18011500
373,25997,15074009,01- Annual,2014-01-01T00:00:00.000Z,33900,0,33900,2899400,14075600,16975000
377,25997,15074009,,2011-01-01T00:00:00.000Z,31100,0,31100,2485200,0,2485200
381,25998,15074010,,2012-01-01T00:00:00.000Z,25400,0,25400,2174600,0,2174600
385,25998,15074010,01- Annual,2013-01-01T00:00:00.000Z,25400,0,25400,2174600,8445300,10619900
389,25998,15074010,03- Board of Equalization,2016-09-19T00:00:00.000Z,25400,0,25400,2516300,11014300,13530600
393,25998,15074010,03- Board of Equalization,2018-08-21T00:00:00.000Z,25400,0,25400,2671600,11134700,13806300
397,25999,15074011,01- Annual,2020-01-01T00:00:00.000Z,28300,0,28300,2686300,11991700,14678000
401,25999,15074011,01- Annual,2019-01-01T00:00:00.000Z,25700,0,25700,2695500,11960400,14655900
405,25999,15074011,05- Review,2015-09-03T00:00:00.000Z,25700,0,25700,2413400,11038000,13451400
409,25999,15074011,,2008-01-01T00:00:00.000Z,25700,0,25700,2061500,0,2061500
413,25999,15074011,,2010-01-01T00:00:00.000Z,20500,0,20500,1749200,0,1749200
1658,54283,35003004,01- Annual,2019-01-01T00:00:00.000Z,217900,0,217900,11025900,0,11025900
1662,54284,35003005,01- Annual,2016-01-01T00:00:00.000Z,217900,0,217900,10384800,0,10384800
1666,54284,35003005,01- Annual,2018-01-01T00:00:00.000Z,217900,0,217900,11025900,0,11025900
1670,54284,35003005,01- Annual,2013-01-01T00:00:00.000Z,217900,0,217900,8974500,0,8974500
1674,54284,35003005,01- Annual,2020-01-01T00:00:00.000Z,236000,0,236000,11025900,0,11025900
1678,54285,35003006,,2011-01-01T00:00:00.000Z,148800,2070400,2219200,6000000,82072500,88072500
1682,54285,35003006,,2009-01-01T00:00:00.000Z,162400,0,162400,6600000,12816800,19416800
1686,54285,35003006,03- Board of Equalization,2017-10-31T00:00:00.000Z,162400,1899600,2062000,8762400,89608700,98371100
1690,54285,35003006,01- Annual,2014-01-01T00:00:00.000Z,162400,2325500,2487900,7000000,94669200,101669200
1694,54286,35003007,01- Annual,2015-01-01T00:00:00.000Z,162400,0,162400,7700000,0,7700000
1698,54286,35003007,01- Annual,2017-01-01T00:00:00.000Z,162400,0,162400,8600000,0,8600000
1702,54286,35003007,,2012-01-01T00:00:00.000Z,162400,0,162400,7000000,0,7000000
1706,54287,35003008,01- Annual,2020-01-01T00:00:00.000Z,175900,0,175900,8600000,0,8600000
1710,54287,35003008,01- Annual,2013-01-01T00:00:00.000Z,162400,0,162400,7000000,0,7000000
1714,54287,35003008,01- Annual,2018-01-01T00:00:00.000Z,162400,0,162400,8600000,0,8600000
1718,54287,35003008,01- Annual,2016-01-01T00:00:00.000Z,162400,0,162400,8100000,0,8100000
1722,54290,35003011,05- Review,2014-09-08T00:00:00.000Z,2327400,1000,2328400,44078300,0,44078300
1726,54293,35003015,01- Annual,2016-01-01T00:00:00.000Z,232000,1000,233000,15680300,0,15680300
1730,54293,35003015,01- Annual,2020-01-01T00:00:00.000Z,213200,0,213200,16840400,0,16840400
1734,54294,35003016,01- Annual,2018-01-01T00:00:00.000Z,102800,0,102800,8793500,0,8793500
1738,54294,35003016,05- Review,2014-09-08T00:00:00.000Z,121100,1000,122100,7075800,0,7075800
1742,54295,35003017,01- Annual,2016-01-01T00:00:00.000Z,121100,1000,122100,8187700,0,8187700
1746,54295,35003017,01- Annual,2020-01-01T00:00:00.000Z,111300,0,111300,8793500,0,8793500
1750,54296,35003018,01- Annual,2018-01-01T00:00:00.000Z,102800,0,102800,8796700,0,8796700
1754,54296,35003018,05- Review,2014-09-08T00:00:00.000Z,121200,1000,122200,7078400,0,7078400
1758,54297,35003019,01- Annual,2016-01-01T00:00:00.000Z,121400,1000,122400,8207300,0,8207300
1762,54298,35003020,01- Annual,2014-01-01T00:00:00.000Z,156000,1000,157000,5699400,0,5699400
1766,54299,35003021,01- Annual,2015-01-01T00:00:00.000Z,113100,1000,114100,7269800,0,7269800
1770,54325,35005022,01- Annual,2019-01-01T00:00:00.000Z,37700,70900,108600,25714000,77239500,102953500
1774,54325,35005022,01- Annual,2018-01-01T00:00:00.000Z,37700,70800,108500,25714000,76810400,102524400
1778,54325,35005022,01- Annual,2015-01-01T00:00:00.000Z,37700,70000,107700,23023000,76519600,99542600
1782,54325,35005022,,2010-01-01T00:00:00.000Z,30100,40500,70600,16744000,46730500,63474500
1786,54334,35005031,01- Annual,2013-01-01T00:00:00.000Z,21162600,102560400,123723000,35280000,139529400,174809400
1790,54334,35005031,,2011-01-01T00:00:00.000Z,19399100,106863300,126262400,30240000,79110600,109350600
1794,54334,35005031,01- Annual,2016-01-01T00:00:00.000Z,21162600,115744400,136907000,40824000,138609300,179433300
1798,54334,35005031,01- Annual,2018-01-01T00:00:00.000Z,21162600,167319800,188482400,43344000,138845100,182189100
1802,54334,35005031,01- Annual,2019-01-01T00:00:00.000Z,21162600,136915700,158078300,43344000,145455500,188799500
1806,55126,35008005,01- Annual,2018-01-01T00:00:00.000Z,158100,861800,1019900,18120000,30850100,48970100
1810,55126,35008005,01- Annual,2015-01-01T00:00:00.000Z,158100,637300,795400,23254000,27087700,50341700
1814,55126,35008005,,2010-01-01T00:00:00.000Z,126500,37100,163600,16912000,11426100,28338100
1818,55126,35008005,,2008-11-01T00:00:00.000Z,158100,86000,244100,19932000,21470800,41402800
1822,55375,35010023,,2012-01-01T00:00:00.000Z,185500,660000,845500,36512100,45636200,82148300
1826,55375,35010023,01- Annual,2018-01-01T00:00:00.000Z,185500,0,185500,44857700,0,44857700
1830,55380,35010032,01- Annual,2020-01-01T00:00:00.000Z,226300,0,226300,50520000,116135700,166655700
1834,55380,35010032,01- Annual,2016-01-01T00:00:00.000Z,208900,0,208900,47582800,101376100,148958900
1838,55380,35010032,,2011-01-01T00:00:00.000Z,191500,0,191500,35246500,49120000,84366500
1842,55381,35010033,,2010-01-01T00:00:00.000Z,159600,0,159600,31413600,43350100,74763700
1846,55381,35010033,01- Annual,2015-01-01T00:00:00.000Z,199500,0,199500,43193700,85276000,128469700
1850,55381,35010033,01- Annual,2019-01-01T00:00:00.000Z,199500,0,199500,48242300,92779900,141022200
1854,55383,35011007,,2010-01-01T00:00:00.000Z,164200,491800,656000,31823900,70551500,102375400
1858,55383,35011007,,2009-01-01T00:00:00.000Z,205200,704600,909800,37506800,81070300,118577100
1862,55384,35011008,,2010-01-01T00:00:00.000Z,160500,0,160500,31120100,112994900,144115000
1866,55663,36018005,,2011-01-01T00:00:00.000Z,216400,655300,871700,110000,252000,362000
1870,55663,36018005,,2009-01-01T00:00:00.000Z,380000,564700,944700,132000,230500,362500
1874,55672,36018014,01- Annual,2015-01-01T00:00:00.000Z,496800,2827500,3324300,63756000,148387000,212143000
1878,55672,36018014,01- Annual,2019-01-01T00:00:00.000Z,496800,2463000,2959800,92450000,176738000,269188000
1882,55672,36018014,03- Board of Equalization,2017-10-17T00:00:00.000Z,496800,1989800,2486600,92450000,132265300,224715300
1886,55672,36018014,,2010-01-01T00:00:00.000Z,397400,799100,1196500,60200000,111494300,171694300
1890,56542,37010004,,2011-01-01T00:00:00.000Z,195800,15000,210800,452300,147400,599700
1894,56542,37010004,,2009-01-01T00:00:00.000Z,217500,15000,232500,502500,147400,649900
1898,58083,38011004,01- Annual,2014-01-01T00:00:00.000Z,53400,1802700,1856100,7985100,199725000,207710100
1902,58083,38011004,01- Annual,2018-01-01T00:00:00.000Z,53400,1819900,1873300,9642000,194044400,203686400
1906,58083,38011004,,2008-01-01T00:00:00.000Z,41000,524900,565900,7210500,151949600,159160100
1910,58083,38011004,,2012-01-01T00:00:00.000Z,53400,1435300,1488700,7985100,170898400,178883500
1914,58084,38011005,,2011-01-01T00:00:00.000Z,24900,0,24900,3108300,0,3108300
1918,58084,38011005,,2009-01-01T00:00:00.000Z,20800,0,20800,3657100,0,3657100
1922,58084,38011005,01- Annual,2016-01-01T00:00:00.000Z,27100,0,27100,4657400,0,4657400
1926,58086,38011007,01- Annual,2015-01-01T00:00:00.000Z,79100,0,79100,13013500,0,13013500
1930,58086,38011007,01- Annual,2019-01-01T00:00:00.000Z,79100,0,79100,14285200,0,14285200
1934,58086,38011007,,2010-01-01T00:00:00.000Z,76000,0,76000,9079900,0,9079900
1938,58087,38011008,01- Annual,2020-01-01T00:00:00.000Z,56800,0,56800,9321300,0,9321300
1942,58087,38011008,01- Annual,2013-01-01T00:00:00.000Z,51600,0,51600,7719500,0,7719500
1946,58087,38011008,01- Annual,2017-01-01T00:00:00.000Z,51600,0,51600,9321300,0,9321300
1950,58087,38011008,01- Annual,2014-01-01T00:00:00.000Z,51600,0,51600,7719500,0,7719500
1954,58088,38011009,01- Annual,2018-01-01T00:00:00.000Z,11100,0,11100,1996400,0,1996400
1958,58088,38011009,,2008-01-01T00:00:00.000Z,8500,0,8500,1492900,0,1492900
1962,58088,38011009,,2012-01-01T00:00:00.000Z,11100,0,11100,1653300,0,1653300
1966,58089,38011010,,2011-01-01T00:00:00.000Z,8000,0,8000,993700,0,993700
1970,58089,38011010,,2009-01-01T00:00:00.000Z,6600,0,6600,1169200,0,1169200
1974,58089,38011010,01- Annual,2016-01-01T00:00:00.000Z,8700,0,8700,1488900,0,1488900
1978,58091,38011012,01- Annual,2015-01-01T00:00:00.000Z,106900,0,106900,17583100,0,17583100
1982,58091,38011012,01- Annual,2019-01-01T00:00:00.000Z,106900,0,106900,19301400,0,19301400
1986,58091,38011012,,2010-01-01T00:00:00.000Z,102600,0,102600,12268200,0,12268200
1990,58092,38011011,01- Annual,2020-01-01T00:00:00.000Z,13200,0,13200,2166800,0,2166800
1994,58092,38011011,,2009-01-01T00:00:00.000Z,9200,0,9200,1620400,0,1620400
1998,58092,38011011,01- Annual,2017-01-01T00:00:00.000Z,12000,0,12000,2166800,0,2166800
2002,58092,38011011,01- Annual,2014-01-01T00:00:00.000Z,12000,0,12000,1794400,0,1794400
2006,58116,18016019,,2008-01-01T00:00:00.000Z,12754300,82094500,94848800,19800000,39934300,59734300
2010,58116,18016019,,2011-01-01T00:00:00.000Z,11691500,66977000,78668500,18000000,45147700,63147700
2014,58264,15058015,,2010-01-01T00:00:00.000Z,151500,1167300,1318800,12264000,51354300,63618300
2018,58410,19015052,01- Annual,2013-01-01T00:00:00.000Z,33000,337700,370700,180000,67400,247400
2022,58410,19015052,,2012-01-01T00:00:00.000Z,33000,305100,338100,180000,169100,349100
2026,58884,14038008,01- Annual,2014-01-01T00:00:00.000Z,429000,2984400,3413400,16170000,68485100,84655100
2030,58884,14038008,01- Annual,2020-01-01T00:00:00.000Z,464800,3422700,3887500,19866000,81773700,101639700
2034,58884,14038008,,2010-01-01T00:00:00.000Z,343200,2800800,3144000,12936000,49669700,62605700
2038,58884,14038008,,2008-01-01T00:00:00.000Z,429000,3226600,3655600,15246000,61703800,76949800
2042,58908,06028028,01- Annual,2018-01-01T00:00:00.000Z,31000,0,31000,813400,0,813400
2046,58908,06028028,05- Review,2015-02-27T00:00:00.000Z,0,0,0,506500,0,506500
2050,59638,18027013,01- Annual,2014-01-01T00:00:00.000Z,845300,3223700,4069000,17640000,86669200,104309200
2054,59638,18027013,01- Annual,2018-01-01T00:00:00.000Z,845300,4023900,4869200,21672000,93006500,114678500
2058,59638,18027013,,2008-01-01T00:00:00.000Z,845300,3048400,3893700,16632000,70997200,87629200
2062,59638,18027013,,2010-01-01T00:00:00.000Z,676300,2344800,3021100,14112000,57339900,71451900
2066,59699,06026052,01- Annual,2015-01-01T00:00:00.000Z,867000,1355400,2222400,1452000,8515800,9967800
2070,60209,14043031,01- Annual,2013-01-01T00:00:00.000Z,576000,3064700,3640700,34930000,140106300,175036300
417,26000,15074012,,2009-01-01T00:00:00.000Z,17100,0,17100,1374400,0,1374400
421,26000,15074012,01- Annual,2015-01-01T00:00:00.000Z,17100,0,17100,1608900,7326800,8935700
425,26000,15074012,03- Board of Equalization,2019-10-10T00:00:00.000Z,17400,0,17400,1790800,7666500,9457300
429,26000,15074012,01- Annual,2017-01-01T00:00:00.000Z,17100,0,17100,1797000,7326500,9123500
433,26001,15074013,01- Annual,2018-01-01T00:00:00.000Z,17100,0,17100,1797000,0,1797000
437,26001,15074013,01- Annual,2016-01-01T00:00:00.000Z,17100,0,17100,1692500,7380200,9072700
441,26001,15074013,01- Annual,2014-01-01T00:00:00.000Z,17100,0,17100,1462700,7087700,8550400
445,26001,15074013,,2011-01-01T00:00:00.000Z,15700,0,15700,1253700,0,1253700
449,26002,15074014,,2012-01-01T00:00:00.000Z,17100,0,17100,1462700,0,1462700
453,26002,15074014,01- Annual,2013-01-01T00:00:00.000Z,17100,0,17100,1462700,5656700,7119400
457,26002,15074014,03- Board of Equalization,2016-09-19T00:00:00.000Z,17100,0,17100,1692500,7377500,9070000
461,26002,15074014,03- Board of Equalization,2018-08-21T00:00:00.000Z,17100,0,17100,1797000,7458100,9255100
465,26003,15074015,01- Annual,2020-01-01T00:00:00.000Z,9400,0,9400,895400,4034600,4930000
469,26003,15074015,01- Annual,2019-01-01T00:00:00.000Z,8600,0,8600,898500,4024100,4922600
473,26003,15074015,05- Review,2015-09-03T00:00:00.000Z,8600,0,8600,804500,3713700,4518200
477,26003,15074015,,2008-01-01T00:00:00.000Z,8600,0,8600,687200,0,687200
481,26003,15074015,,2010-01-01T00:00:00.000Z,6800,0,6800,583100,0,583100
485,26004,15074016,,2009-01-01T00:00:00.000Z,30700,0,30700,2469000,0,2469000
489,26004,15074016,01- Annual,2015-01-01T00:00:00.000Z,30700,0,30700,2890400,13208900,16099300
493,26004,15074016,03- Board of Equalization,2019-10-10T00:00:00.000Z,31200,0,31200,3217200,13821300,17038500
497,26004,15074016,01- Annual,2017-01-01T00:00:00.000Z,30700,0,30700,3228200,13208300,16436500
501,26005,15074017,01- Annual,2018-01-01T00:00:00.000Z,6700,0,6700,703200,0,703200
505,26005,15074017,01- Annual,2016-01-01T00:00:00.000Z,6700,0,6700,662300,2910500,3572800
509,26005,15074017,01- Annual,2014-01-01T00:00:00.000Z,6700,0,6700,572400,2795100,3367500
513,26005,15074017,,2011-01-01T00:00:00.000Z,6100,0,6100,490600,0,490600
517,26006,15074018,,2012-01-01T00:00:00.000Z,15100,0,15100,1292100,0,1292100
521,26006,15074018,01- Annual,2013-01-01T00:00:00.000Z,15100,0,15100,1292100,5019400,6311500
525,26006,15074018,03- Board of Equalization,2016-09-19T00:00:00.000Z,15100,0,15100,1495100,6546400,8041500
529,26006,15074018,03- Board of Equalization,2018-08-21T00:00:00.000Z,15100,0,15100,1587400,6617800,8205200
533,26007,15074019,01- Annual,2020-01-01T00:00:00.000Z,9400,0,9400,895400,4146700,5042100
537,26007,15074019,01- Annual,2019-01-01T00:00:00.000Z,8600,0,8600,898500,4135800,5034300
541,26007,15074019,05- Review,2015-09-03T00:00:00.000Z,8600,0,8600,804500,3816900,4621400
545,26007,15074019,,2008-01-01T00:00:00.000Z,8600,0,8600,687200,0,687200
549,26007,15074019,,2010-01-01T00:00:00.000Z,6800,0,6800,583100,0,583100
553,26012,15075007,01- Annual,2020-01-01T00:00:00.000Z,9200,0,9200,2023000,0,2023000
557,26013,15075008,01- Annual,2019-01-01T00:00:00.000Z,1700,0,1700,403600,0,403600
561,26014,15075011,01- Annual,2020-01-01T00:00:00.000Z,13400,0,13400,2955300,0,2955300
565,26015,15075012,01- Annual,2019-01-01T00:00:00.000Z,4100,0,4100,982700,0,982700
569,26016,15075013,01- Annual,2020-01-01T00:00:00.000Z,9200,0,9200,2023000,0,2023000
573,26017,15075014,01- Annual,2019-01-01T00:00:00.000Z,12700,0,12700,3027000,0,3027000
577,26018,15075016,01- Annual,2020-01-01T00:00:00.000Z,9200,0,9200,2023000,0,2023000
581,26019,15075017,01- Annual,2019-01-01T00:00:00.000Z,6800,0,6800,1614400,0,1614400
585,26020,15075018,01- Annual,2020-01-01T00:00:00.000Z,17900,0,17900,3940400,0,3940400
589,26021,15075019,01- Annual,2019-01-01T00:00:00.000Z,4200,0,4200,1009000,1000,1010000
593,26022,15075020,01- Annual,2020-01-01T00:00:00.000Z,36700,0,36700,8091900,0,8091900
597,26051,15078002,,2009-01-01T00:00:00.000Z,5000,76500,81500,66000,49200,115200
601,26052,15078003,,2008-01-01T00:00:00.000Z,46800,1000,47800,436400,0,436400
605,26052,15078003,,2010-01-01T00:00:00.000Z,37500,1000,38500,370300,0,370300
609,26053,15078004,,2009-01-01T00:00:00.000Z,208800,1000,209800,1946000,0,1946000
613,26054,15078005,,2008-01-01T00:00:00.000Z,91200,0,91200,850100,0,850100
617,26054,15078005,,2010-01-01T00:00:00.000Z,73000,0,73000,721300,0,721300
621,26055,15078006,01- Annual,2020-01-01T00:00:00.000Z,20700,1000,21700,4558600,0,4558600
625,26057,15078011,01- Annual,2017-01-01T00:00:00.000Z,6300,0,6300,1513700,0,1513700
629,26058,15078012,01- Annual,2018-01-01T00:00:00.000Z,4100,0,4100,982700,0,982700
633,26059,15078013,,2011-01-01T00:00:00.000Z,133800,0,133800,1236400,0,1236400
637,26060,15078014,01- Annual,2013-01-01T00:00:00.000Z,97300,0,97300,961600,0,961600
641,26060,15078014,,2012-01-01T00:00:00.000Z,97300,0,97300,961600,0,961600
645,26061,15078015,,2011-01-01T00:00:00.000Z,111500,0,111500,1030300,0,1030300
649,26062,15078016,01- Annual,2013-01-01T00:00:00.000Z,121600,0,121600,1202000,0,1202000
653,26062,15078016,,2012-01-01T00:00:00.000Z,121600,0,121600,1202000,0,1202000
657,26063,15078017,,2011-01-01T00:00:00.000Z,111500,0,111500,1030300,0,1030300
661,26064,15078018,01- Annual,2013-01-01T00:00:00.000Z,96600,0,96600,954300,0,954300
665,26064,15078018,,2012-01-01T00:00:00.000Z,96600,0,96600,954300,0,954300
669,26066,15078021,01- Annual,2019-01-01T00:00:00.000Z,6300,0,6300,1513700,1000,1514700
673,26068,15078023,,2010-01-01T00:00:00.000Z,37000,1000,38000,365800,0,365800
677,26068,15078023,,2008-01-01T00:00:00.000Z,46300,1000,47300,431100,0,431100
681,26069,15078024,01- Annual,2019-01-01T00:00:00.000Z,36600,0,36600,8747500,0,8747500
685,26395,15087028,01- Annual,2019-01-01T00:00:00.000Z,58682100,211129500,269811600,0,0,0
689,26395,15087028,01- Annual,2015-01-01T00:00:00.000Z,58682100,228099100,286781200,0,0,0
693,27080,16022001,,2008-01-01T00:00:00.000Z,264000,234500,498500,34020000,23213800,57233800
697,27082,16022004,01- Annual,2020-01-01T00:00:00.000Z,14890200,46565500,61455700,32653400,0,32653400
701,28240,16033009,01- Annual,2020-01-01T00:00:00.000Z,85700,65400,151100,3363700,2340800,5704500
705,28242,16033011,01- Annual,2020-01-01T00:00:00.000Z,284400,65500,349900,11167400,2343600,13511000
709,28244,16033013,01- Annual,2020-01-01T00:00:00.000Z,125900,65400,191300,4942600,2340800,7283400
713,28246,16033016,01- Annual,2020-01-01T00:00:00.000Z,66300,65400,131700,2603500,2340800,4944300
717,28248,16033018,01- Annual,2020-01-01T00:00:00.000Z,371000,65500,436500,14564700,2343600,16908300
721,28250,16033022,01- Annual,2020-01-01T00:00:00.000Z,73600,65400,139000,2890700,2340800,5231500
725,28251,16034001,,2012-01-01T00:00:00.000Z,222800,1277200,1500000,18241400,87823500,106064900
729,28251,16034001,05- Review,2015-09-03T00:00:00.000Z,191000,1460500,1651500,20065500,96012600,116078100
733,28251,16034001,01- Annual,2014-01-01T00:00:00.000Z,222800,1370900,1593700,18241400,101262500,119503900
737,28251,16034001,01- Annual,2019-01-01T00:00:00.000Z,190900,1361900,1552800,22404100,99819800,122223900
741,28252,16034002,01- Annual,2018-01-01T00:00:00.000Z,17900,0,17900,2100000,0,2100000
745,28252,16034002,01- Annual,2013-01-01T00:00:00.000Z,20800,0,20800,1706800,0,1706800
749,28252,16034002,,2011-01-01T00:00:00.000Z,16400,0,16400,1462900,0,1462900
753,28255,16034031,,2010-01-01T00:00:00.000Z,17000,0,17000,1625500,0,1625500
757,28255,16034031,,2008-01-01T00:00:00.000Z,21300,0,21300,1915800,0,1915800
761,28255,16034031,01- Annual,2014-01-01T00:00:00.000Z,24800,0,24800,2031900,0,2031900
765,28617,16038001,,2008-11-01T00:00:00.000Z,9962200,1000,9963200,6682100,0,6682100
769,28618,16038002,,2008-01-01T00:00:00.000Z,369100,0,369100,231000,0,231000
773,28619,16038003,,2009-01-01T00:00:00.000Z,4849700,1000,4850700,3252900,0,3252900
777,28621,16038005,,2008-11-01T00:00:00.000Z,6699800,1000,6700800,4493900,0,4493900
781,28623,16038008,,2008-01-01T00:00:00.000Z,2196500,1000,2197500,1374800,0,1374800
785,28624,16038009,,2009-01-01T00:00:00.000Z,2642100,0,2642100,1772200,0,1772200
789,28625,16038010,,2008-11-01T00:00:00.000Z,2364100,0,2364100,1585700,0,1585700
793,28627,16038012,,2008-01-01T00:00:00.000Z,169100,0,169100,105900,0,105900
797,28628,16038013,,2009-01-01T00:00:00.000Z,227900,0,227900,152900,0,152900
801,28665,17003010,,2011-01-01T00:00:00.000Z,0,0,0,287000,0,287000
805,28665,17003010,01- Annual,2018-01-01T00:00:00.000Z,0,0,0,2434300,0,2434300
809,28665,17003010,01- Annual,2020-01-01T00:00:00.000Z,0,0,0,2788600,0,2788600
813,28666,17003011,01- Annual,2014-01-01T00:00:00.000Z,0,0,0,333200,0,333200
817,28666,17003011,,2010-01-01T00:00:00.000Z,0,0,0,269200,0,269200
821,28667,17003012,01- Annual,2013-01-01T00:00:00.000Z,0,0,0,888000,0,888000
825,28667,17003012,01- Annual,2019-01-01T00:00:00.000Z,0,0,0,7361900,0,7361900
829,28667,17003012,01- Annual,2015-01-01T00:00:00.000Z,0,0,0,973900,0,973900
833,28926,17003298,01- Annual,2016-01-01T00:00:00.000Z,0,0,0,131300,0,131300
837,28926,17003298,01- Annual,2017-01-01T00:00:00.000Z,0,0,0,139400,0,139400
841,28926,17003298,,2012-01-01T00:00:00.000Z,0,0,0,16700,0,16700
845,28927,17003299,,2011-01-01T00:00:00.000Z,0,0,0,36000,0,36000
849,28927,17003299,01- Annual,2018-01-01T00:00:00.000Z,0,0,0,304200,0,304200
853,28927,17003299,01- Annual,2020-01-01T00:00:00.000Z,0,0,0,348500,0,348500
857,28928,17003300,01- Annual,2014-01-01T00:00:00.000Z,0,0,0,41700,0,41700
861,28928,17003300,,2010-01-01T00:00:00.000Z,0,0,0,33600,0,33600
865,29225,17005002,,2012-01-01T00:00:00.000Z,117400,0,117400,5599100,0,5599100
869,29226,17005003,,2011-01-01T00:00:00.000Z,72500,0,72500,3232700,0,3232700
873,29227,17005004,,2010-01-01T00:00:00.000Z,64300,0,64300,3094600,0,3094600
877,29230,17005007,,2012-01-01T00:00:00.000Z,42800,0,42800,2042500,0,2042500
881,29231,17005008,,2011-01-01T00:00:00.000Z,47200,0,47200,2106000,0,2106000
885,29232,17005009,,2010-01-01T00:00:00.000Z,43200,0,43200,2076100,0,2076100
889,29234,17005011,,2012-01-01T00:00:00.000Z,129500,0,129500,6178400,0,6178400
893,29283,17011006,,2012-01-01T00:00:00.000Z,110700,0,110700,1036700,0,1036700
897,29285,17011008,,2012-01-01T00:00:00.000Z,67500,0,67500,631900,0,631900
901,29286,17011009,,2009-01-01T00:00:00.000Z,125700,0,125700,562000,0,562000
905,29289,17011013,,2011-01-01T00:00:00.000Z,173700,0,173700,888700,0,888700
909,29290,17011015,,2009-01-01T00:00:00.000Z,470500,0,470500,2104100,0,2104100
913,29291,17011016,,2011-01-01T00:00:00.000Z,1115000,0,1115000,5704100,0,5704100
917,29319,17012013,01- Annual,2014-01-01T00:00:00.000Z,0,0,0,642700,0,642700
921,29329,17013017,01- Annual,2019-01-01T00:00:00.000Z,40700,637400,678100,26134700,126355600,152490300
925,29329,17013017,,2012-01-01T00:00:00.000Z,40700,371800,412500,18233500,105987600,124221100
929,29329,17013017,01- Annual,2013-01-01T00:00:00.000Z,40700,382000,422700,18233500,106396000,124629500
933,29330,17013019,,2009-01-01T00:00:00.000Z,55300,0,55300,27303200,68087300,95390500
937,29330,17013019,,2011-01-01T00:00:00.000Z,50700,0,50700,24786500,72702000,97488500
941,29330,17013019,01- Annual,2016-01-01T00:00:00.000Z,55300,0,55300,33461800,96519900,129981700
945,29332,17014001,01- Annual,2017-01-01T00:00:00.000Z,901700,4960400,5862100,21844000,74540500,96384500
949,29332,17014001,01- Annual,2020-01-01T00:00:00.000Z,976800,4632100,5608900,21844000,93084200,114928200
953,29332,17014001,,2010-01-01T00:00:00.000Z,721300,0,721300,14224000,20000,14244000
957,32270,18003111,,2009-01-01T00:00:00.000Z,108000,972700,1080700,37950000,142916200,180866200
961,32270,18003111,,2011-01-01T00:00:00.000Z,99000,866800,965800,34500000,131019300,165519300
965,32270,18003111,01- Annual,2020-01-01T00:00:00.000Z,117000,779500,896500,49450000,166115900,215565900
969,32270,18003111,05- Review,2018-08-14T00:00:00.000Z,108000,1091900,1199900,49450000,140782300,190232300
973,32270,18003111,01- Annual,2015-01-01T00:00:00.000Z,108000,1135100,1243100,44275000,165571500,209846500
977,32675,18003602,01- Annual,2015-01-01T00:00:00.000Z,144000,1385500,1529500,43428000,172222700,215650700
981,32675,18003602,01- Annual,2019-01-01T00:00:00.000Z,144000,1184400,1328400,48504000,175793100,224297100
985,32675,18003602,,2012-01-01T00:00:00.000Z,144000,1055900,1199900,33840000,164881700,198721700
989,32675,18003602,,2008-01-01T00:00:00.000Z,144000,859200,1003200,37224000,132412500,169636500
993,32685,18004066,,2009-01-01T00:00:00.000Z,613600,4460400,5074000,16479800,76430000,92909800
997,32685,18004066,05- Review,2015-12-13T00:00:00.000Z,576800,6074100,6650900,18072800,100042100,118114900
1001,32685,18004066,05- Review,2013-12-13T00:00:00.000Z,601300,6270100,6871400,17129000,100206700,117335700
1005,32685,18004066,03- Board of Equalization,2018-07-25T00:00:00.000Z,539900,6311300,6851200,18896900,101269300,120166200
1009,32685,18004066,01- Annual,2014-01-01T00:00:00.000Z,613600,6718600,7332200,17478600,107478300,124956900
1013,32691,18005040,03- Board of Equalization,2019-10-31T00:00:00.000Z,309700,0,309700,10821500,0,10821500
1017,32691,18005040,03- Board of Equalization,2018-07-25T00:00:00.000Z,316400,0,316400,11072400,0,11072400
1021,32691,18005040,01- Annual,2017-01-01T00:00:00.000Z,323600,0,323600,11324100,0,11324100
1025,32691,18005040,05- Review,2013-12-13T00:00:00.000Z,352300,0,352300,10036600,0,10036600
1029,32691,18005040,,2010-01-01T00:00:00.000Z,287600,0,287600,8193100,0,8193100
1033,32889,18007031,05- Review,2013-08-16T00:00:00.000Z,75000,101700,176700,18550000,56453900,75003900
1037,32889,18007031,,2010-01-01T00:00:00.000Z,60000,78500,138500,14784000,36674100,51458100
1041,32941,18013003,,2008-01-01T00:00:00.000Z,2854700,1000,2855700,4747500,0,4747500
1045,32945,18013007,,2008-01-01T00:00:00.000Z,69000,0,69000,114800,0,114800
1049,33220,18029007,,2008-01-01T00:00:00.000Z,1490500,1000,1491500,9834000,0,9834000
1053,33220,18029007,,2012-01-01T00:00:00.000Z,1490500,10673100,12163600,8940000,0,8940000
1057,33220,18029007,01- Annual,2019-01-01T00:00:00.000Z,1245400,11087200,12332600,9120000,57890300,67010300
1061,33220,18029007,01- Annual,2014-01-01T00:00:00.000Z,1245400,7783800,9029200,9120000,48202500,57322500
1065,33353,18038020,,2011-01-01T00:00:00.000Z,333600,0,333600,2238800,0,2238800
1069,33356,18038023,,2012-01-01T00:00:00.000Z,355600,0,355600,2395100,0,2395100
1073,33424,18041002,,2010-01-01T00:00:00.000Z,11000,836200,847200,224000,140300,364300
1077,33424,18041002,01- Annual,2014-01-01T00:00:00.000Z,11000,877600,888600,240000,307900,547900
1081,33610,18054007,01- Annual,2015-01-01T00:00:00.000Z,137500,76400,213900,600600,1518000,2118600
1085,33610,18054007,,2008-01-01T00:00:00.000Z,165000,74600,239600,514800,1077200,1592000
1089,33610,18054007,,2008-11-01T00:00:00.000Z,165000,74600,239600,514800,954500,1469300
1093,33614,18054011,,2011-01-01T00:00:00.000Z,15000,319300,334300,198000,325900,523900
1097,33614,18054011,,2009-01-01T00:00:00.000Z,15000,345500,360500,198000,330600,528600
1101,33616,18054013,01- Annual,2014-01-01T00:00:00.000Z,294000,287800,581800,240000,261200,501200
1105,33616,18054013,01- Annual,2013-01-01T00:00:00.000Z,294000,262600,556600,240000,171600,411600
1109,34352,18084003,,2011-01-01T00:00:00.000Z,298900,93400,392300,12840000,9146400,21986400
1113,34352,18084003,,2009-01-01T00:00:00.000Z,326100,169600,495700,14124000,14862400,28986400
1117,34352,18084003,01- Annual,2014-01-01T00:00:00.000Z,326100,184100,510200,14980000,9355100,24335100
1121,34352,18084003,01- Annual,2019-01-01T00:00:00.000Z,326100,614000,940100,18404000,11760200,30164200
1125,34493,19007005,01- Annual,2017-01-01T00:00:00.000Z,60800,51900,112700,1500500,797700,2298200
1129,35637,20012009,01- Annual,2020-01-01T00:00:00.000Z,123300,0,123300,1539200,1000,1540200
1133,35642,20012021,01- Annual,2020-01-01T00:00:00.000Z,2810300,1000,2811300,35085000,0,35085000
1137,40065,23034017,01- Annual,2017-01-01T00:00:00.000Z,1912300,1000,1913300,11518700,0,11518700
1141,40065,23034017,01- Annual,2019-01-01T00:00:00.000Z,1738500,1236400,2974900,9339500,5270900,14610400
1145,40066,23034018,01- Annual,2018-01-01T00:00:00.000Z,2218800,1000,2219800,11919900,0,11919900
1149,40067,23034019,01- Annual,2017-01-01T00:00:00.000Z,131200,0,131200,790100,0,790100
1153,40067,23034019,01- Annual,2020-01-01T00:00:00.000Z,131200,0,131200,640600,2717000,3357600
1157,40994,24015015,01- Annual,2018-01-01T00:00:00.000Z,588000,3005200,3593200,10505100,19253000,29758100
1161,40994,24015015,01- Annual,2014-01-01T00:00:00.000Z,705600,1909300,2614900,12255900,11017600,23273500
1165,40994,24015015,,2012-01-01T00:00:00.000Z,0,1136500,1136500,13160000,7018000,20178000
1169,40995,24015017,,2011-01-01T00:00:00.000Z,694500,0,694500,0,0,0
1173,40995,24015017,01- Annual,2014-01-01T00:00:00.000Z,41900,0,41900,169964800,0,169964800
1177,40995,24015017,01- Annual,2018-01-01T00:00:00.000Z,43400,0,43400,774900,0,774900
1181,42115,25016009,,2009-01-01T00:00:00.000Z,3357400,1000,3358400,11379000,0,11379000
1185,43303,27002001,05- Review,2013-08-30T00:00:00.000Z,0,0,0,31869700,1412600,33282300
1189,43303,27002001,,2012-01-01T00:00:00.000Z,0,0,0,31869700,424700,32294400
1193,43303,27002001,05- Review,2019-03-26T00:00:00.000Z,0,0,0,38384400,4597200,42981600
1197,43303,27002001,01- Annual,2016-01-01T00:00:00.000Z,33100,0,33100,36556600,1972200,38528800
1201,43306,27002004,01- Annual,2020-01-01T00:00:00.000Z,0,361700,361700,5132800,1838000,6970800
1205,43306,27002004,01- Annual,2019-01-01T00:00:00.000Z,0,345900,345900,5132800,1405200,6538000
1209,43306,27002004,,2011-01-01T00:00:00.000Z,92000,75900,167900,3395600,53100,3448700
1213,43306,27002004,05- Review,2013-08-30T00:00:00.000Z,100000,71800,171800,4272900,190500,4463400
1217,43307,27002005,05- Review,2013-08-30T00:00:00.000Z,0,0,0,15214500,674200,15888700
1221,43307,27002005,,2011-01-01T00:00:00.000Z,0,0,0,12090600,212300,12302900
1225,43307,27002005,01- Annual,2019-01-01T00:00:00.000Z,0,0,0,18276300,4973600,23249900
1229,43307,27002005,01- Annual,2020-01-01T00:00:00.000Z,0,0,0,18276300,6505300,24781600
1233,43308,27002006,01- Annual,2016-01-01T00:00:00.000Z,14600,0,14600,16118700,872500,16991200
1237,43308,27002006,05- Review,2019-03-26T00:00:00.000Z,0,0,0,16924700,2033900,18958600
1241,43308,27002006,,2012-01-01T00:00:00.000Z,0,0,0,14089300,199100,14288400
1245,43308,27002006,,2009-01-01T00:00:00.000Z,0,0,0,13188100,199100,13387200
1239,43308,27002006,01- Annual,2017-01-01T00:00:00.000Z,0,0,0,16924700,434600,17359300
1243,43308,27002006,05- Review,2013-08-30T00:00:00.000Z,0,0,0,14089300,625000,14714300
1247,43309,27002010,01- Annual,2013-01-01T00:00:00.000Z,0,0,0,11207900,910000,12117900
1251,43309,27002010,,2011-01-01T00:00:00.000Z,0,0,0,8906600,159200,9065800
1255,43309,27002010,01- Annual,2019-01-01T00:00:00.000Z,0,0,0,13348800,3663100,17011900
1259,43309,27002010,01- Annual,2020-01-01T00:00:00.000Z,0,0,0,13348800,4791200,18140000
1263,43310,27003001,01- Annual,2016-01-01T00:00:00.000Z,8700,0,8700,9613400,519900,10133300
1267,43310,27003001,05- Review,2019-03-26T00:00:00.000Z,0,0,0,10094100,1212000,11306100
1271,43310,27003001,,2012-01-01T00:00:00.000Z,0,0,0,8406800,119400,8526200
1275,43310,27003001,,2009-01-01T00:00:00.000Z,0,0,0,7869000,119400,7988400
1279,43313,27004003,,2010-01-01T00:00:00.000Z,0,0,0,2467100,39800,2506900
1283,43313,27004003,01- Annual,2018-01-01T00:00:00.000Z,0,0,0,3740800,864000,4604800
1287,43313,27004003,01- Annual,2014-01-01T00:00:00.000Z,0,0,0,3104700,537500,3642200
1291,43385,27007077,05- Review,2020-03-31T00:00:00.000Z,0,0,0,10088200,2270200,12358400
1295,43385,27007077,01- Annual,2015-01-01T00:00:00.000Z,0,0,0,9171100,969400,10140500
1299,43385,27007077,01- Annual,2017-01-01T00:00:00.000Z,0,0,0,10088200,259000,10347200
1303,43385,27007077,05- Review,2013-08-30T00:00:00.000Z,0,0,0,8418500,372400,8790900
1307,44098,28004003,,2008-01-01T00:00:00.000Z,109500,191000,300500,26400000,45637900,72037900
1311,44098,28004003,,2012-01-01T00:00:00.000Z,91300,177100,268400,24000000,54965600,78965600
1315,44098,28004003,01- Annual,2018-01-01T00:00:00.000Z,91300,299700,391000,24000000,66490000,90490000
1319,44098,28004003,03- Board of Equalization,2018-07-26T00:00:00.000Z,91300,299700,391000,24000000,65008700,89008700
1323,44098,28004003,01- Annual,2016-01-01T00:00:00.000Z,91300,243300,334600,28000000,61426900,89426900
1327,44100,28004005,,2009-01-01T00:00:00.000Z,225100,0,225100,7712300,10280900,17993200
1331,44711,28018001,01- Annual,2013-01-01T00:00:00.000Z,150000,146100,296100,6000000,13323400,19323400
1335,44711,28018001,01- Annual,2015-01-01T00:00:00.000Z,150000,835500,985500,6600000,14456900,21056900
1339,44711,28018001,01- Annual,2019-01-01T00:00:00.000Z,150000,0,150000,6000000,10727200,16727200
1343,45694,29003010,01- Annual,2017-01-01T00:00:00.000Z,49800,147600,197400,30651700,46895000,77546700
1347,45694,29003010,01- Annual,2015-01-01T00:00:00.000Z,49800,150400,200200,27338000,54986200,82324200
1351,45694,29003010,,2010-01-01T00:00:00.000Z,47800,116700,164500,23195900,29731900,52927800
1355,45694,29003010,01- Annual,2013-01-01T00:00:00.000Z,49800,128900,178700,22781700,47813300,70595000
1359,45695,29003019,,2009-01-01T00:00:00.000Z,3300,0,3300,1504000,0,1504000
1363,45695,29003019,,2010-01-01T00:00:00.000Z,2600,0,2600,1276100,0,1276100
1367,45695,29003019,01- Annual,2014-01-01T00:00:00.000Z,2700,0,2700,519132500,0,519132500
1371,45695,29003019,01- Annual,2020-01-01T00:00:00.000Z,2700,0,2700,1364100,0,1364100
1375,51207,31022006,,2008-01-01T00:00:00.000Z,89000,0,89000,1403600,0,1403600
1379,51221,31024007,01- Annual,2013-01-01T00:00:00.000Z,216500,105500,322000,120000,258400,378400
1383,51221,31024007,01- Annual,2014-01-01T00:00:00.000Z,216500,126500,343000,240000,138400,378400
1387,51331,31026001,,2009-08-01T00:00:00.000Z,14400,239000,253400,132000,19000,151000
1391,51331,31026001,01- Annual,2013-01-01T00:00:00.000Z,71800,202500,274300,60000,52200,112200
1395,51331,31026001,03- Board of Equalization,2014-09-09T00:00:00.000Z,175700,88200,263900,60000,191600,251600
1399,51655,32001002,01- Annual,2016-01-01T00:00:00.000Z,24700,144800,169500,13282700,112022700,125305400
1403,51655,32001002,03- Board of Equalization,2017-10-31T00:00:00.000Z,24500,128800,153300,21777400,94390900,116168300
1407,51655,32001002,,2009-01-01T00:00:00.000Z,29400,170300,199700,12418900,67902700,80321600
1411,51655,32001002,,2010-01-01T00:00:00.000Z,23500,78000,101500,10537300,49722100,60259400
1415,51656,32001003,,2010-01-01T00:00:00.000Z,2200,0,2200,1007200,0,1007200
1419,51656,32001003,,2009-01-01T00:00:00.000Z,2800,0,2800,1187100,0,1187100
1423,51656,32001003,01- Annual,2017-01-01T00:00:00.000Z,2300,0,2300,2081700,0,2081700
1427,51658,32001005,01- Annual,2014-01-01T00:00:00.000Z,135000,174500,309500,19800000,31606800,51406800
1431,51658,32001005,01- Annual,2017-01-01T00:00:00.000Z,135000,162700,297700,24420000,34008700,58428700
1435,51658,32001005,,2008-01-01T00:00:00.000Z,162000,115900,277900,21846000,21690800,43536800
1439,51658,32001005,,2012-01-01T00:00:00.000Z,135000,145700,280700,19800000,28378000,48178000
1443,51687,32001046,,2010-01-01T00:00:00.000Z,23200,0,23200,10418000,0,10418000
1447,51687,32001046,,2009-01-01T00:00:00.000Z,29000,0,29000,12278400,0,12278400
1451,51687,32001046,01- Annual,2017-01-01T00:00:00.000Z,24200,0,24200,21531000,0,21531000
1455,51687,32001046,01- Annual,2014-01-01T00:00:00.000Z,24200,0,24200,11162200,0,11162200
1459,51688,32001047,01- Annual,2015-01-01T00:00:00.000Z,700,0,700,374900,0,374900
1463,51688,32001047,03- Board of Equalization,2017-10-31T00:00:00.000Z,700,0,700,657600,0,657600
1467,51688,32001047,01- Annual,2013-01-01T00:00:00.000Z,700,0,700,340900,0,340900
1471,51689,32001048,,2010-01-01T00:00:00.000Z,24200,0,24200,10867900,0,10867900
1475,51689,32001048,,2009-01-01T00:00:00.000Z,30300,0,30300,12808600,0,12808600
1479,51689,32001048,01- Annual,2018-01-01T00:00:00.000Z,25200,0,25200,18211400,0,18211400
1483,51689,32001048,01- Annual,2014-01-01T00:00:00.000Z,25200,0,25200,11644200,0,11644200
1487,51690,32001049,01- Annual,2014-01-01T00:00:00.000Z,0,0,0,1344191400,0,1344191400
1491,51690,32001049,01- Annual,2018-01-01T00:00:00.000Z,15500,0,15500,11172700,0,11172700
1495,51690,32001049,01- Annual,2013-01-01T00:00:00.000Z,15500,0,15500,7143700,0,7143700
1499,52294,32003006,,2010-01-01T00:00:00.000Z,782500,505700,1288200,56000,42200,98200
1503,52294,32003006,,2009-01-01T00:00:00.000Z,920500,589800,1510300,66000,50400,116400
1507,52342,32006008,01- Annual,2014-01-01T00:00:00.000Z,433200,811100,1244300,240000,385700,625700
1511,52342,32006008,,2009-12-01T00:00:00.000Z,528000,484300,1012300,264000,100500,364500
1515,52342,32006008,,2010-01-01T00:00:00.000Z,449200,414200,863400,224000,106300,330300
1519,53213,32024002,,2011-01-01T00:00:00.000Z,69000,220900,289900,19855000,16224800,36079800
1523,53213,32024002,,2009-01-01T00:00:00.000Z,90000,242800,332800,23826000,17555600,41381600
1527,53213,32024002,01- Annual,2014-01-01T00:00:00.000Z,75000,236500,311500,21660000,80955400,102615400
1531,53213,32024002,01- Annual,2019-01-01T00:00:00.000Z,75000,203500,278500,21660000,82300900,103960900
1535,53213,32024002,01- Annual,2017-01-01T00:00:00.000Z,75000,242100,317100,26714000,80611100,107325100
1539,53554,34020024,,2009-01-01T00:00:00.000Z,72000,0,72000,17490000,51245300,68735300
1543,53556,34020030,,2012-01-01T00:00:00.000Z,4106200,13333300,17439500,26520000,100946100,127466100
1547,53556,34020030,03- Board of Equalization,2017-07-01T00:00:00.000Z,2677500,24375950,27053450,32708000,112451850,145159850
1551,53556,34020030,01- Annual,2017-01-01T00:00:00.000Z,2677500,25283600,27961100,32708000,113359500,146067500
1555,53556,34020030,01- Annual,2014-01-01T00:00:00.000Z,4106200,18643800,22750000,26520000,98780000,125300000
1559,53765,34020255,05- Review,2015-07-28T00:00:00.000Z,41600,266400,308000,23991000,133602100,157593100
1563,53765,34020255,01- Annual,2018-01-01T00:00:00.000Z,41600,0,41600,26795100,0,26795100
1567,53765,34020255,,2012-01-01T00:00:00.000Z,41600,273000,314600,21810000,124310400,146120400
1571,53766,34020256,,2009-01-01T00:00:00.000Z,30400,0,30400,15038100,0,15038100
1575,53766,34020256,,2011-01-01T00:00:00.000Z,27800,0,27800,13645700,0,13645700
1579,53766,34020256,01- Annual,2019-01-01T00:00:00.000Z,30400,0,30400,19558900,0,19558900
1583,53766,34020256,01- Annual,2020-01-01T00:00:00.000Z,32900,0,32900,19558900,0,19558900
1587,54061,34027025,01- Annual,2017-01-01T00:00:00.000Z,403700,575200,978900,53062000,96607600,149669600
1591,54061,34027025,,2012-01-01T00:00:00.000Z,403700,749000,1152700,37020000,121328600,158348600
1595,54061,34027025,,2009-01-01T00:00:00.000Z,403700,2436800,2840500,43032000,94244800,137276800
1599,54072,35001008,,2008-09-01T00:00:00.000Z,272700,488100,760800,25410000,50302500,75712500
1603,54072,35001008,01- Annual,2017-01-01T00:00:00.000Z,272700,1254200,1526900,33110000,65838400,98948400
1607,54072,35001008,01- Annual,2020-01-01T00:00:00.000Z,295400,2553800,2849200,33110000,78130700,111240700
1611,54077,35001019,01- Annual,2018-01-01T00:00:00.000Z,365600,733200,1098800,29928000,75615800,105543800
1615,54077,35001019,01- Annual,2015-01-01T00:00:00.000Z,365600,1913000,2278600,26796000,70021200,96817200
1619,54077,35001019,,2010-01-01T00:00:00.000Z,292500,563700,856200,19488000,39850400,59338400
1623,54077,35001019,,2008-01-01T00:00:00.000Z,365600,714900,1080500,22968000,45927200,68895200
1627,54280,35003001,05- Review,2014-09-08T00:00:00.000Z,261800,1000,262800,15293500,0,15293500
1631,54281,35003002,01- Annual,2015-01-01T00:00:00.000Z,216200,1000,217200,13891700,0,13891700
1635,54282,35003003,05- Review,2016-04-26T00:00:00.000Z,242300,7827900,8070200,11549400,133594600,145144000
1639,54282,35003003,01- Annual,2019-01-01T00:00:00.000Z,242300,7259700,7502000,12262300,133353200,145615500
1643,54282,35003003,,2008-01-01T00:00:00.000Z,242300,4377200,4619500,9410600,107720200,117130800
1647,54282,35003003,,2010-01-01T00:00:00.000Z,193800,3429600,3623400,7984700,87497600,95482300
1651,54283,35003004,,2011-01-01T00:00:00.000Z,199700,0,199700,7692500,0,7692500
2074,60209,14043031,,2012-01-01T00:00:00.000Z,576000,3590300,4166300,34930000,132334500,167264500
2078,60209,14043031,01- Annual,2014-01-01T00:00:00.000Z,576000,3482900,4058900,34930000,151198200,186128200
2082,60209,14043031,03- Board of Equalization,2016-08-31T00:00:00.000Z,576000,4071200,4647200,40419000,140375300,180794300
2086,60209,14043031,03- Board of Equalization,2019-10-29T00:00:00.000Z,576000,3279600,3855600,42914000,142907900,185821900
2090,60248,29014016,01- Annual,2018-01-01T00:00:00.000Z,1218100,0,1218100,8408100,0,8408100
2094,60248,29014016,05- Review,2018-08-29T00:00:00.000Z,1218100,1402000,2620100,8408100,42198300,50606400
2098,60248,29014016,01- Annual,2015-01-01T00:00:00.000Z,1216500,6095300,7311800,9237100,41396000,50633100
2102,60248,29014016,,2010-01-01T00:00:00.000Z,1162400,6251600,7414000,10528000,36393000,46921000
2106,60248,29014016,01- Annual,2013-01-01T00:00:00.000Z,1216500,8283800,9500300,8397400,37445100,45842500
2110,60249,29014017,05- Review,2020-03-10T00:00:00.000Z,622700,633900,1256600,3907600,19907100,23814700
2114,60249,29014017,05- Review,2013-10-31T00:00:00.000Z,568000,2810800,3378800,3921100,17484700,21405800
2118,60249,29014017,,2009-01-01T00:00:00.000Z,857300,1987600,2844900,2904000,6617500,9521500
2122,60249,29014017,03- Board of Equalization,2014-12-12T00:00:00.000Z,568000,2811100,3379100,3921100,17962700,21883800
2126,60249,29014017,03- Board of Equalization,2016-10-31T00:00:00.000Z,566100,2942400,3508500,4558900,16434700,20993600
2130,60250,29014018,01- Annual,2017-01-01T00:00:00.000Z,310600,334500,645100,2644600,10509400,13154000
2134,60250,29014018,01- Annual,2016-01-01T00:00:00.000Z,310600,1863500,2174100,2501600,10510800,13012400
2138,60250,29014018,,2011-01-01T00:00:00.000Z,282300,1510800,1793100,495000,2246300,2741300
2142,60250,29014018,,2011-08-01T00:00:00.000Z,282300,1511000,1793300,495000,2143600,2638600
2146,60250,29014018,01- Annual,2020-01-01T00:00:00.000Z,341700,346200,687900,2144200,11436300,13580500
2150,60290,14034013,,2009-01-01T00:00:00.000Z,271400,1816600,2088000,5610000,27295300,32905300
2154,60313,14030057,,2011-01-01T00:00:00.000Z,1474300,454000,1928300,0,0,0
2158,60314,14030058,,2008-01-01T00:00:00.000Z,827200,0,827200,6185500,0,6185500
2162,60314,14030058,,2009-01-01T00:00:00.000Z,827200,0,827200,6185500,0,6185500
2166,60399,06028031,,2011-01-01T00:00:00.000Z,211600,1055700,1267300,4070000,5167400,9237400
2170,60399,06028031,01- Annual,2016-01-01T00:00:00.000Z,230000,1364900,1594900,5173700,4323500,9497200
2174,60399,06028031,01- Annual,2019-01-01T00:00:00.000Z,199000,1401100,1600100,4323000,5340500,9663500
2178,60447,17010037,01- Annual,2018-01-01T00:00:00.000Z,11720700,38321500,50042200,19264000,71222600,90486600
2182,60447,17010037,01- Annual,2016-01-01T00:00:00.000Z,11720700,29979600,41700300,18144000,66479800,84623800
2186,60447,17010037,01- Annual,2015-01-01T00:00:00.000Z,11720700,36297100,48017800,17248000,66151100,83399100
2190,60447,17010037,,2011-01-01T00:00:00.000Z,10744000,32181800,42925800,13440000,44481100,57921100
2194,60447,17010037,,2009-01-01T00:00:00.000Z,11720700,28595300,40316000,14784000,67240500,82024500
2198,60799,14044021,,2012-01-01T00:00:00.000Z,343800,1049500,1393300,18060000,67710100,85770100
2202,62121,16018011,,2008-01-01T00:00:00.000Z,5390000,17068200,22458200,11849400,30943100,42792500
2206,62153,18024020,,2011-01-01T00:00:00.000Z,1288000,5263700,6551700,6840000,38860100,45700100
2210,62153,18024020,01- Annual,2014-01-01T00:00:00.000Z,1405100,10026800,11431900,6840000,49787700,56627700
2214,62153,18024020,01- Annual,2016-01-01T00:00:00.000Z,1405100,8642600,10047700,9234000,48074500,57308500
2218,62153,18024020,03- Board of Equalization,2019-10-11T00:00:00.000Z,1147000,9404600,10551600,9804000,49269600,59073600
2222,62579,15070002,,2010-01-01T00:00:00.000Z,1535500,0,1535500,6496000,0,6496000
2226,63377,18084013,,2011-01-01T00:00:00.000Z,354200,2544300,2898500,5940000,11777100,17717100
2230,63377,18084013,01- Annual,2018-01-01T00:00:00.000Z,385000,2652800,3037800,6480000,11912300,18392300
2234,63377,18084013,05- Review,2015-02-27T00:00:00.000Z,385000,2921800,3306800,7128000,13917600,21045600
2238,63380,31025113,,2008-01-01T00:00:00.000Z,348000,20000,368000,2400000,0,2400000
2242,63680,34027062,01- Annual,2012-01-01T00:00:00.000Z,973600,0,973600,29303100,0,29303100
2246,63680,34027062,05- Review,2013-10-23T00:00:00.000Z,976300,0,976300,24847400,0,24847400
2250,63680,34027062,01- Annual,2014-01-01T00:00:00.000Z,973600,0,973600,24777300,0,24777300
2254,63680,34027062,01- Annual,2018-01-01T00:00:00.000Z,822500,0,822500,21531000,0,21531000
2258,63681,34027063,01- Annual,2019-01-01T00:00:00.000Z,206500,1370000,1576500,22610200,100081800,122692000
2262,63681,34027063,01- Annual,2017-01-01T00:00:00.000Z,206500,1382900,1589400,27888100,99708100,127596200
2266,63681,34027063,,2008-11-01T00:00:00.000Z,248600,1291800,1540400,24948000,79689200,104637200
2270,63681,34027063,,2012-01-01T00:00:00.000Z,248600,1522500,1771100,26960400,89189800,116150200
2274,63681,34027063,,2009-09-01T00:00:00.000Z,248600,1548200,1796800,24948000,95190500,120138500
2278,63683,34027065,01- Annual,2011-01-01T00:00:00.000Z,856300,0,856300,23456800,0,23456800
2282,63683,34027065,05- Review,2011-10-23T00:00:00.000Z,855800,0,855800,19474600,0,19474600
2286,63683,34027065,03- Board of Equalization,2014-08-20T00:00:00.000Z,936100,0,936100,19471400,0,19471400
2290,63683,34027065,01- Annual,2017-01-01T00:00:00.000Z,791000,0,791000,24420500,0,24420500
2294,64730,17003583,01- Annual,2016-01-01T00:00:00.000Z,0,0,0,6303500,56277900,62581400
2298,64730,17003583,01- Annual,2014-01-01T00:00:00.000Z,0,0,0,15005500,55941700,70947200
2302,64730,17003583,,2010-01-01T00:00:00.000Z,0,0,0,11997400,46857900,58855300
2306,65311,32006028,,2009-01-01T00:00:00.000Z,2760000,10540000,13300000,17754000,74032700,91786700
2310,65611,14041187,,2010-01-01T00:00:00.000Z,199600,830200,1029800,6048000,22172500,28220500
2314,65611,14041187,01- Annual,2013-01-01T00:00:00.000Z,249500,1773300,2022800,7560000,34188500,41748500
2318,65611,14041187,03- Board of Equalization,2016-08-31T00:00:00.000Z,249500,1721900,1971400,8748000,31494100,40242100
2322,65611,14041187,01- Annual,2020-01-01T00:00:00.000Z,270300,1835100,2105400,9288000,34150200,43438200
2326,65611,14041187,03- Board of Equalization,2017-08-31T00:00:00.000Z,249500,1878000,2127500,9288000,28405400,37693400
2330,65751,25017098,01- Annual,2020-01-01T00:00:00.000Z,2694500,14846200,17540700,11340000,55488800,66828800
2334,65751,25017098,05- Review,2014-07-08T00:00:00.000Z,2449600,12245800,14695400,11280000,48186900,59466900
2338,65751,25017098,,2011-01-01T00:00:00.000Z,2253600,11668000,13921600,10340000,43203800,53543800
2342,65751,25017098,,2009-01-01T00:00:00.000Z,2939500,0,2939500,12408000,0,12408000
2346,65936,31025114,,2011-01-01T00:00:00.000Z,0,1194500,1194500,0,2313800,2313800
2350,66464,14035024,01- Annual,2013-01-01T00:00:00.000Z,20600,0,20600,1002000,0,1002000
2354,66470,18013011,,2012-01-01T00:00:00.000Z,7314700,38765700,46080400,17080000,69339000,86419000
2358,66470,18013011,01- Annual,2014-01-01T00:00:00.000Z,7314700,39919000,47233700,17080000,82282400,99362400
2362,66470,18013011,01- Annual,2020-01-01T00:00:00.000Z,7924300,63610200,71534500,20984000,90854900,111838900
2366,66878,11012029,,2010-01-01T00:00:00.000Z,311500,0,311500,11984000,28572300,40556300
2370,66954,31022101,01- Annual,2015-01-01T00:00:00.000Z,70700,397200,467900,6204000,8258100,14462100
2374,66954,31022101,,2010-01-01T00:00:00.000Z,67800,0,67800,5264000,1000,5265000
2378,66954,31022101,01- Annual,2020-01-01T00:00:00.000Z,77700,569600,647300,4154900,8612000,12766900
2382,66960,32024004,,2010-08-01T00:00:00.000Z,0,0,0,0,45034400,45034400
2386,66962,31022102,,2011-01-01T00:00:00.000Z,0,115300,115300,0,6048300,6048300
2390,66975,16038014,,2012-01-01T00:00:00.000Z,374000,0,374000,5321100,0,5321100
2394,66975,16038014,01- Annual,2016-01-01T00:00:00.000Z,415100,0,415100,6242100,0,6242100
2398,66975,16038014,01- Annual,2019-01-01T00:00:00.000Z,367800,3277100,3644900,5918700,35270200,41188900
2402,66976,16038015,01- Annual,2018-01-01T00:00:00.000Z,1599400,10631000,12230400,25536600,118627000,144163600
2406,66976,16038015,01- Annual,2014-01-01T00:00:00.000Z,1577000,0,1577000,20494100,0,20494100
2410,66976,16038015,,2011-01-01T00:00:00.000Z,1235800,0,1235800,16439100,0,16439100
2414,66989,25016012,,2012-01-01T00:00:00.000Z,4313900,23869500,28183400,15666600,69525000,85191600
2418,66989,25016012,05- Review,2013-08-29T00:00:00.000Z,4313900,20995000,25308900,15666600,73373400,89040000
2422,66989,25016012,05- Review,2015-06-05T00:00:00.000Z,4313800,22578300,26892100,17695300,70779500,88474800
2426,66989,25016012,05- Review,2018-02-16T00:00:00.000Z,4313800,26521700,30835500,15666600,68082500,83749100
2430,66990,25016013,05- Review,2020-04-02T00:00:00.000Z,549400,0,549400,1837900,0,1837900
2434,66990,25016013,01- Annual,2017-01-01T00:00:00.000Z,494200,0,494200,2213700,0,2213700
2438,66990,25016013,,2010-01-01T00:00:00.000Z,477200,0,477200,1715400,0,1715400
2442,66990,25016013,01- Annual,2013-01-01T00:00:00.000Z,494200,0,494200,1794900,0,1794900
2446,66991,25016014,,2012-07-01T00:00:00.000Z,16100,0,16100,58400,0,58400
2450,66991,25016014,01- Annual,2016-01-01T00:00:00.000Z,16100,0,16100,68200,0,68200
2454,66991,25016014,01- Annual,2020-01-01T00:00:00.000Z,17700,0,17700,58400,0,58400
2458,66996,32006031,01- Annual,2018-01-01T00:00:00.000Z,485300,7761500,8246800,4520000,0,4520000
2462,66998,32006033,01- Annual,2020-01-01T00:00:00.000Z,0,629600,629600,0,0,0
2466,66999,32006034,01- Annual,2019-01-01T00:00:00.000Z,961300,0,961300,11620000,74910900,86530900
2470,67000,32006035,01- Annual,2018-01-01T00:00:00.000Z,0,0,0,0,1643400,1643400
2474,67062,28004212,01- Annual,2019-01-01T00:00:00.000Z,377200,1384400,1761600,14040000,51423800,65463800
2478,67062,28004212,01- Annual,2016-01-01T00:00:00.000Z,377200,1613200,1990400,16380000,54443100,70823100
2482,67062,28004212,,2012-07-01T00:00:00.000Z,377200,1815700,2192900,14040000,53232900,67272900
1655,54283,35003004,,2009-01-01T00:00:00.000Z,217900,0,217900,8461700,0,8461700
1659,54283,35003004,01- Annual,2014-01-01T00:00:00.000Z,217900,0,217900,8974500,0,8974500
1663,54284,35003005,01- Annual,2015-01-01T00:00:00.000Z,217900,0,217900,9872000,0,9872000
1667,54284,35003005,01- Annual,2017-01-01T00:00:00.000Z,217900,0,217900,11025900,0,11025900
1671,54284,35003005,,2012-01-01T00:00:00.000Z,217900,0,217900,8974500,0,8974500
1675,54285,35003006,01- Annual,2020-01-01T00:00:00.000Z,175900,2751300,2927200,8600000,99927500,108527500
1679,54285,35003006,,2012-01-01T00:00:00.000Z,162400,2217400,2379800,7000000,87353800,94353800
1683,54285,35003006,01- Annual,2017-01-01T00:00:00.000Z,162400,1972300,2134700,8600000,91249100,99849100
1687,54285,35003006,01- Annual,2019-01-01T00:00:00.000Z,162400,2017200,2179600,8600000,94478900,103078900
1691,54285,35003006,01- Annual,2015-01-01T00:00:00.000Z,162400,2386700,2549100,7700000,101104700,108804700
1695,54286,35003007,01- Annual,2014-01-01T00:00:00.000Z,162400,0,162400,7000000,0,7000000
1699,54286,35003007,,2009-01-01T00:00:00.000Z,162400,0,162400,6600000,0,6600000
1703,54286,35003007,,2011-01-01T00:00:00.000Z,148800,0,148800,6000000,0,6000000
1707,54287,35003008,,2010-01-01T00:00:00.000Z,129900,0,129900,5600000,0,5600000
1711,54287,35003008,,2008-01-01T00:00:00.000Z,162400,0,162400,6600000,0,6600000
1715,54287,35003008,01- Annual,2019-01-01T00:00:00.000Z,162400,0,162400,8600000,0,8600000
1719,54289,35003010,,2011-01-01T00:00:00.000Z,899300,0,899300,23185700,0,23185700
1723,54293,35003015,05- Review,2014-09-08T00:00:00.000Z,232000,1000,233000,13550900,0,13550900
1727,54293,35003015,01- Annual,2018-01-01T00:00:00.000Z,196800,0,196800,16840400,0,16840400
1731,54294,35003016,01- Annual,2020-01-01T00:00:00.000Z,111300,0,111300,8793500,0,8793500
1735,54294,35003016,01- Annual,2016-01-01T00:00:00.000Z,121100,1000,122100,8187700,0,8187700
1739,54295,35003017,05- Review,2014-09-08T00:00:00.000Z,121100,1000,122100,7075800,0,7075800
1743,54295,35003017,01- Annual,2018-01-01T00:00:00.000Z,102800,0,102800,8793500,0,8793500
1747,54296,35003018,01- Annual,2020-01-01T00:00:00.000Z,111400,0,111400,8796700,0,8796700
1751,54296,35003018,01- Annual,2016-01-01T00:00:00.000Z,121200,1000,122200,8190700,0,8190700
1755,54297,35003019,05- Review,2014-09-08T00:00:00.000Z,121400,1000,122400,7092700,0,7092700
1759,54297,35003019,01- Annual,2019-01-01T00:00:00.000Z,123700,1000,124700,8794300,0,8794300
1763,54298,35003020,01- Annual,2015-01-01T00:00:00.000Z,121300,1000,122300,7792700,0,7792700
1767,54299,35003021,01- Annual,2014-01-01T00:00:00.000Z,145500,1000,146500,5317000,0,5317000
1771,54325,35005022,03- Board of Equalization,2018-07-25T00:00:00.000Z,37700,65400,103100,25714000,73548300,99262300
1775,54325,35005022,01- Annual,2017-01-01T00:00:00.000Z,37700,75600,113300,25714000,74038100,99752100
1779,54325,35005022,01- Annual,2014-01-01T00:00:00.000Z,37700,65200,102900,20930000,69740500,90670500
1783,54325,35005022,,2009-01-01T00:00:00.000Z,37700,48200,85900,19734000,57488200,77222200
1787,54334,35005031,,2008-01-01T00:00:00.000Z,21162600,102921200,124083800,33264000,88414500,121678500
1791,54334,35005031,,2012-01-01T00:00:00.000Z,21162600,99676600,120839200,35280000,75891500,111171500
1795,54334,35005031,03- Board of Equalization,2015-11-03T00:00:00.000Z,21162600,106662970,127825570,38808000,138294630,177102630
1799,54334,35005031,03- Board of Equalization,2017-10-10T00:00:00.000Z,21162600,118054300,139216900,43344000,130236400,173580400
1803,54334,35005031,05- Review,2020-03-20T00:00:00.000Z,22926200,147707100,170633300,43344000,154745900,198089900
1807,55126,35008005,01- Annual,2017-01-01T00:00:00.000Z,158100,691000,849100,25972000,21785500,47757500
1811,55126,35008005,01- Annual,2014-01-01T00:00:00.000Z,158100,565800,723900,21140000,24381300,45521300
1815,55126,35008005,,2009-01-01T00:00:00.000Z,158100,98700,256800,19932000,14971800,34903800
1819,55375,35010023,01- Annual,2013-01-01T00:00:00.000Z,185500,673600,859100,36512100,45408700,81920800
1823,55375,35010023,01- Annual,2014-01-01T00:00:00.000Z,185500,764200,949700,36512100,45810000,82322100
1827,55375,35010023,01- Annual,2017-01-01T00:00:00.000Z,185500,2136300,2321800,44857700,69088800,113946500
1831,55380,35010032,01- Annual,2019-01-01T00:00:00.000Z,208900,0,208900,50520000,106424000,156944000
1835,55380,35010032,01- Annual,2015-01-01T00:00:00.000Z,208900,0,208900,45233000,97816600,143049600
1839,55380,35010032,,2010-01-01T00:00:00.000Z,167100,0,167100,32896700,49120000,82016700
1843,55381,35010033,,2011-01-01T00:00:00.000Z,182800,0,182800,33657400,43350100,77007500
1847,55381,35010033,01- Annual,2016-01-01T00:00:00.000Z,199500,0,199500,45437500,88379100,133816600
1851,55381,35010033,01- Annual,2020-01-01T00:00:00.000Z,216100,0,216100,48242300,101246500,149488800
1855,55383,35011007,01- Annual,2013-01-01T00:00:00.000Z,0,0,0,0,0,0
1859,55384,35011008,,2009-01-01T00:00:00.000Z,200600,0,200600,36677200,134226200,170903400
1863,55384,35011008,,2011-01-01T00:00:00.000Z,183900,0,183900,33342900,120549900,153892800
1867,55663,36018005,,2010-01-01T00:00:00.000Z,214400,631700,846100,112000,193900,305900
1871,55663,36018005,01- Annual,2015-01-01T00:00:00.000Z,326400,1728000,2054400,0,615400,615400
1875,55672,36018014,01- Annual,2016-01-01T00:00:00.000Z,496800,2728400,3225200,87075000,148090700,235165700
1879,55672,36018014,03- Board of Equalization,2018-08-03T00:00:00.000Z,496800,2460200,2957000,92450000,170547500,262997500
1883,55672,36018014,,2009-01-01T00:00:00.000Z,496800,862400,1359200,70950000,124596200,195546200
1887,55672,36018014,,2011-01-01T00:00:00.000Z,455400,2576600,3032000,64500000,115453300,179953300
1891,56542,37010004,,2010-01-01T00:00:00.000Z,195800,15000,210800,452300,147400,599700
1895,56542,37010004,01- Annual,2016-01-01T00:00:00.000Z,226100,4300,230400,522400,147400,669800
1899,58083,38011004,01- Annual,2015-01-01T00:00:00.000Z,53400,1838200,1891600,8783600,198003000,206786600
1903,58083,38011004,01- Annual,2017-01-01T00:00:00.000Z,53400,1908800,1962200,9642000,189435200,199077200
1907,58083,38011004,01- Annual,2013-01-01T00:00:00.000Z,53400,1454300,1507700,7985100,180426500,188411600
1911,58083,38011004,01- Annual,2020-01-01T00:00:00.000Z,58800,1885800,1944600,9642000,234089500,243731500
1915,58084,38011005,,2010-01-01T00:00:00.000Z,26000,0,26000,3108300,0,3108300
1919,58084,38011005,01- Annual,2019-01-01T00:00:00.000Z,27100,0,27100,4890300,0,4890300
1923,58084,38011005,01- Annual,2015-01-01T00:00:00.000Z,27100,0,27100,4454900,0,4454900
1927,58086,38011007,01- Annual,2016-01-01T00:00:00.000Z,79100,0,79100,13605000,0,13605000
1931,58086,38011007,,2009-01-01T00:00:00.000Z,60700,0,60700,10682900,0,10682900
1935,58086,38011007,,2011-01-01T00:00:00.000Z,72800,0,72800,9079900,0,9079900
1939,58087,38011008,,2012-01-01T00:00:00.000Z,51600,0,51600,7719500,0,7719500
1943,58087,38011008,,2008-01-01T00:00:00.000Z,39600,0,39600,6970700,0,6970700
1947,58087,38011008,01- Annual,2018-01-01T00:00:00.000Z,51600,0,51600,9321300,0,9321300
1951,58088,38011009,01- Annual,2014-01-01T00:00:00.000Z,11100,0,11100,1653300,0,1653300
1955,58088,38011009,01- Annual,2017-01-01T00:00:00.000Z,11100,0,11100,1996400,0,1996400
1959,58088,38011009,01- Annual,2013-01-01T00:00:00.000Z,11100,0,11100,1653300,0,1653300
1963,58088,38011009,01- Annual,2020-01-01T00:00:00.000Z,12200,0,12200,1996400,0,1996400
1967,58089,38011010,,2010-01-01T00:00:00.000Z,8300,0,8300,993700,0,993700
1971,58089,38011010,01- Annual,2019-01-01T00:00:00.000Z,8700,0,8700,1563400,0,1563400
1975,58089,38011010,01- Annual,2015-01-01T00:00:00.000Z,8700,0,8700,1424200,0,1424200
1979,58091,38011012,01- Annual,2016-01-01T00:00:00.000Z,106900,0,106900,18382300,0,18382300
1983,58091,38011012,,2009-01-01T00:00:00.000Z,82100,0,82100,14434100,0,14434100
1987,58091,38011012,,2011-01-01T00:00:00.000Z,98400,0,98400,12268200,0,12268200
1991,58092,38011011,,2012-01-01T00:00:00.000Z,12000,0,12000,1794400,0,1794400
1995,58092,38011011,,2008-01-01T00:00:00.000Z,9200,0,9200,1620400,0,1620400
1999,58092,38011011,01- Annual,2018-01-01T00:00:00.000Z,12000,0,12000,2166800,0,2166800
2003,58116,18016019,01- Annual,2014-01-01T00:00:00.000Z,12754300,69309500,82063800,21000000,101271300,122271300
2007,58116,18016019,01- Annual,2013-01-01T00:00:00.000Z,12754300,67517600,80271900,21000000,84741400,105741400
2011,58116,18016019,,2012-01-01T00:00:00.000Z,12754300,67121400,79875700,21000000,44195500,65195500
2015,58264,15058015,,2008-01-01T00:00:00.000Z,189400,1160200,1349600,14454000,58596800,73050800
2019,58410,19015052,,2009-01-01T00:00:00.000Z,15000,345500,360500,198000,97300,295300
2023,58410,19015052,01- Annual,2014-01-01T00:00:00.000Z,125600,280700,406300,125600,93800,219400
2027,58884,14038008,01- Annual,2016-01-01T00:00:00.000Z,429000,3932400,4361400,18711000,77198000,95909000
2031,58884,14038008,03- Board of Equalization,2018-08-21T00:00:00.000Z,429000,3002600,3431600,19866000,77337600,97203600
2035,58884,14038008,,2009-01-01T00:00:00.000Z,429000,3303900,3732900,15246000,62057700,77303700
2039,58884,14038008,,2009-11-01T00:00:00.000Z,429000,3345200,3774200,15246000,59947500,75193500
2043,58908,06028028,01- Annual,2017-01-01T00:00:00.000Z,0,0,0,556700,0,556700
2047,58908,06028028,01- Annual,2014-01-01T00:00:00.000Z,0,0,0,459500,0,459500
2051,59638,18027013,01- Annual,2016-01-01T00:00:00.000Z,845300,4848700,5694000,20412000,90986500,111398500
2055,59638,18027013,03- Board of Equalization,2017-08-31T00:00:00.000Z,845300,3224000,4069300,21672000,94795300,116467300
2059,59638,18027013,01- Annual,2013-01-01T00:00:00.000Z,845300,2814400,3659700,17640000,80895500,98535500
2063,59638,18027013,,2011-01-01T00:00:00.000Z,774900,2511200,3286100,15120000,68203500,83323500
2486,67062,28004212,01- Annual,2013-01-01T00:00:00.000Z,377200,1857000,2234200,14040000,55308500,69348500
2490,67117,34020268,,2010-01-01T00:00:00.000Z,75000,222000,297000,14840000,53742400,68582400
2494,67117,34020268,01- Annual,2019-01-01T00:00:00.000Z,93800,446900,540700,22790000,100281200,123071200
2498,67408,31025115,01- Annual,2020-01-01T00:00:00.000Z,126500,178500,305000,2160000,3033000,5193000
2502,67408,31025115,01- Annual,2018-01-01T00:00:00.000Z,115000,163200,278200,2160000,3017500,5177500
2506,67408,31025115,01- Annual,2014-01-01T00:00:00.000Z,115000,195800,310800,2160000,2702500,4862500
2510,67408,31025115,,2011-01-01T00:00:00.000Z,105800,0,105800,1980000,0,1980000
2514,67415,31025116,,2010-01-01T00:00:00.000Z,124800,20000,144800,672100,0,672100
2518,67419,14060069,,2010-01-01T00:00:00.000Z,427200,0,427200,11088000,0,11088000
2522,67439,15070003,,2010-01-01T00:00:00.000Z,990000,254100,1244100,6496000,0,6496000
2526,67440,15070004,,2012-01-01T00:00:00.000Z,2532500,3951200,6483700,0,0,0
2530,67527,14060078,,2011-06-22T00:00:00.000Z,51900,0,51900,4636900,0,4636900
2534,67538,11012030,05- Review,2013-09-12T00:00:00.000Z,201500,871100,1072600,0,0,0
2538,67538,11012030,01- Annual,2016-01-01T00:00:00.000Z,9600,1064700,1074300,443500,0,443500
2542,67538,11012030,01- Annual,2020-01-01T00:00:00.000Z,12500,877900,890400,544900,0,544900
2546,67539,11012031,01- Annual,2019-01-01T00:00:00.000Z,6000,631800,637800,237600,0,237600
2550,67539,11012031,05- Review,2013-09-12T00:00:00.000Z,123500,533900,657400,0,0,0
2554,67540,11012032,,2012-01-01T00:00:00.000Z,0,0,0,12840000,86248500,99088500
2558,67540,11012032,01- Annual,2014-01-01T00:00:00.000Z,0,0,0,12840000,83107200,95947200
2562,67540,11012032,01- Annual,2019-01-01T00:00:00.000Z,309400,0,309400,12222200,88562100,100784300
2566,67563,17011058,01- Annual,2014-01-01T00:00:00.000Z,114100,178000,292100,1447600,1800100,3247700
2570,67746,14060080,,2012-01-01T00:00:00.000Z,542100,0,542100,17920000,0,17920000
2574,67746,14060080,03- Board of Equalization,2017-10-31T00:00:00.000Z,542100,3176200,3718300,22102000,76399800,98501800
2578,67746,14060080,01- Annual,2019-01-01T00:00:00.000Z,542100,4667000,5209100,22102000,79895600,101997600
2582,67751,17011059,,2012-01-01T00:00:00.000Z,918200,0,918200,8602400,0,8602400
2586,67752,17011060,01- Annual,2014-01-01T00:00:00.000Z,77800,121500,199300,987600,1228300,2215900
2590,67757,17011062,01- Annual,2013-01-01T00:00:00.000Z,1824600,0,1824600,9139800,1852200,10992000
2594,67758,17011063,,2012-01-01T00:00:00.000Z,63700,0,63700,348800,0,348800
2598,67759,17011064,01- Annual,2014-01-01T00:00:00.000Z,82000,64000,146000,410800,362400,773200
2602,67814,15070006,01- Annual,2013-01-01T00:00:00.000Z,0,0,0,8120000,13731100,21851100
2606,67836,31025131,,2012-01-01T00:00:00.000Z,0,0,0,0,2652300,2652300
2610,67837,18038025,05- Review,2014-09-03T00:00:00.000Z,1674800,6387000,8061800,11280000,49863600,61143600
2614,67837,18038025,03- Board of Equalization,2015-08-21T00:00:00.000Z,1674800,6163100,7837900,12408000,53065600,65473600
2618,67837,18038025,03- Board of Equalization,2017-08-31T00:00:00.000Z,1674800,10438900,12113700,13912000,58697100,72609100
2622,67838,17011065,01- Annual,2015-01-01T00:00:00.000Z,198900,0,198900,0,0,0
2626,67849,14044261,01- Annual,2013-01-01T00:00:00.000Z,343800,1064700,1408500,18060000,69090900,87150900
2630,67849,14044261,01- Annual,2015-01-01T00:00:00.000Z,343800,1684400,2028200,19866000,80247400,100113400
2634,67849,14044261,01- Annual,2018-01-01T00:00:00.000Z,343800,2313100,2656900,22188000,85114600,107302600
2638,67863,15058016,01- Annual,2019-01-01T00:00:00.000Z,189400,1558000,1747400,18834000,75660400,94494400
2642,67863,15058016,03- Board of Equalization,2016-09-19T00:00:00.000Z,189400,1387700,1577100,17739000,74482800,92221800
2646,67863,15058016,01- Annual,2013-01-01T00:00:00.000Z,189400,1299800,1489200,15330000,65410600,80740600
2650,67912,26001112,01- Annual,2019-01-01T00:00:00.000Z,772200,6350800,7123000,15420000,74253400,89673400
2654,67946,14035026,01- Annual,2013-01-01T00:00:00.000Z,27300,0,27300,1328700,0,1328700
2658,67981,35003439,01- Annual,2013-01-01T00:00:00.000Z,844900,0,844900,24778800,0,24778800
2662,67982,35003035,05- Review,2014-09-15T00:00:00.000Z,136100,0,136100,3991200,0,3991200
2666,68003,17005012,01- Annual,2018-01-01T00:00:00.000Z,758100,3754100,4512200,40764000,172403300,213167300
2670,68003,17005012,05- Review,2018-09-26T00:00:00.000Z,758100,3036300,3794400,40764000,160893100,201657100
2674,68006,35011010,05- Review,2018-03-07T00:00:00.000Z,159500,3269000,3428500,30824600,117562600,148387200
2678,68006,35011010,01- Annual,2017-01-01T00:00:00.000Z,159500,3264700,3424200,30824600,115762700,146587300
2682,68006,35011010,01- Annual,2015-01-01T00:00:00.000Z,405800,1216300,1622100,35266000,121005600,156271600
2686,68007,35011011,01- Annual,2013-01-01T00:00:00.000Z,0,0,0,31780000,113126100,144906100
2690,68007,35011011,01- Annual,2014-01-01T00:00:00.000Z,0,0,0,31780000,127428000,159208000
2694,68007,35011011,01- Annual,2019-01-01T00:00:00.000Z,246300,0,246300,47607400,129565200,177172600
2698,68034,14035028,01- Annual,2020-01-01T00:00:00.000Z,0,0,0,100,0,100
2702,68034,14035028,01- Annual,2017-01-01T00:00:00.000Z,0,0,0,100,0,100
2706,68103,05056127,01- Annual,2018-01-01T00:00:00.000Z,0,0,0,0,0,0
2710,68105,22011272,01- Annual,2019-01-01T00:00:00.000Z,333700,897600,1231300,4980000,9318700,14298700
2714,68107,14035029,01- Annual,2016-01-01T00:00:00.000Z,768900,4094400,4863300,40500000,136696100,177196100
2718,68107,14035029,05- Review,2019-03-27T00:00:00.000Z,768900,3664200,4433100,43000000,167692600,210692600
2722,68151,15078025,01- Annual,2018-01-01T00:00:00.000Z,1097900,6069500,7167400,13330000,69971700,83301700
2726,68151,15078025,01- Annual,2015-01-01T00:00:00.000Z,1097900,5567400,6665300,11935000,48875600,60810600
2730,68363,35003023,05- Review,2016-04-05T00:00:00.000Z,295800,429800,725600,7926700,11179300,19106000
2734,68363,35003023,01- Annual,2020-01-01T00:00:00.000Z,81000,0,81000,6397900,0,6397900
2738,68520,17011068,01- Annual,2019-01-01T00:00:00.000Z,1053800,7937600,8991400,16426000,67880800,84306800
2742,68520,17011068,01- Annual,2015-01-01T00:00:00.000Z,1053800,6326900,7380700,14707000,58537500,73244500
2746,68773,20012393,03- Board of Equalization,2015-09-28T00:00:00.000Z,132200,712321,844521,12551000,34045379,46596379
2750,68773,20012393,03- Board of Equalization,2018-07-25T00:00:00.000Z,132200,902000,1034200,14018000,39482200,53500200
2754,69223,15005010,01- Annual,2020-01-01T00:00:00.000Z,494500,4080400,4574900,8220500,14747300,22967800
2758,69223,15005010,01- Annual,2017-01-01T00:00:00.000Z,449600,4515300,4964900,10138600,13071700,23210300
2762,69230,14013051,01- Annual,2020-01-01T00:00:00.000Z,0,0,0,22962000,80343600,103305600
2766,69271,15003009,05- Review,2018-03-07T00:00:00.000Z,213300,0,213300,3899500,53263200,57162700
2770,69463,35003840,01- Annual,2017-01-01T00:00:00.000Z,2453500,14745300,17198800,60114000,206167900,266281900
2774,69463,35003840,01- Annual,2020-01-01T00:00:00.000Z,2657900,10898800,13556700,60114000,299857100,359971100
2778,69508,18004071,01- Annual,2019-01-01T00:00:00.000Z,136200,1086100,1222300,4767800,17652900,22420700
2782,69646,14032005,01- Annual,2018-01-01T00:00:00.000Z,355000,2030700,2385700,22790000,97203800,119993800
2786,69646,14032005,01- Annual,2020-01-01T00:00:00.000Z,384600,958500,1343100,22790000,107560000,130350000
2790,69706,23040016,01- Annual,2020-01-01T00:00:00.000Z,310900,1413300,1724200,6774300,14326300,21100600
2794,69725,34027033,01- Annual,2019-01-01T00:00:00.000Z,403700,681600,1085300,35432000,102100100,137532100
2798,69726,34027034,01- Annual,2020-01-01T00:00:00.000Z,131700,0,131700,13172800,0,13172800
2802,69801,34027572,01- Annual,2020-01-01T00:00:00.000Z,1441600,499000,1940600,20456800,112924200,133381000
2806,69893,16038019,01- Annual,2019-01-01T00:00:00.000Z,1646700,11618900,13265600,26503300,125048900,151552200
2810,70001,15078026,01- Annual,2020-01-01T00:00:00.000Z,41300,1000,42300,9107600,0,9107600
2067,59699,06026052,01- Annual,2014-01-01T00:00:00.000Z,275000,1322100,1597100,1320000,7692700,9012700
2071,60209,14043031,,2009-09-01T00:00:00.000Z,576000,3934800,4510800,32934000,134030600,166964600
2075,60209,14043031,,2010-01-01T00:00:00.000Z,460800,3244500,3705300,27944000,113497200,141441200
2079,60209,14043031,01- Annual,2015-01-01T00:00:00.000Z,576000,4030600,4606600,38423000,143010000,181433000
2083,60209,14043031,01- Annual,2017-01-01T00:00:00.000Z,576000,4002800,4578800,42914000,139704300,182618300
2087,60209,14043031,03- Board of Equalization,2019-10-28T00:00:00.000Z,576000,3279600,3855600,43490000,146187500,189677500
2091,60248,29014016,01- Annual,2017-01-01T00:00:00.000Z,1218100,1311700,2529800,10370000,41207300,51577300
2095,60248,29014016,01- Annual,2016-01-01T00:00:00.000Z,1218100,7306700,8524800,9809500,41212700,51022200
2099,60248,29014016,01- Annual,2014-01-01T00:00:00.000Z,1216500,6019100,7235600,8397400,39573200,47970600
2103,60248,29014016,,2012-01-01T00:00:00.000Z,1210800,7794500,9005300,11280200,48635600,59915800
2107,60248,29014016,,2008-01-01T00:00:00.000Z,1892800,6171500,8064300,12408000,44757400,57165400
2111,60249,29014017,01- Annual,2020-01-01T00:00:00.000Z,622700,633900,1256600,3907600,20942100,24849700
2115,60249,29014017,,2011-08-01T00:00:00.000Z,690000,3693100,4383100,2420000,10479700,12899700
2119,60249,29014017,,2011-01-01T00:00:00.000Z,690000,3692700,4382700,2420000,10982100,13402100
2123,60249,29014017,01- Annual,2016-01-01T00:00:00.000Z,566100,3412400,3978500,4558900,19247300,23806200
2127,60249,29014017,01- Annual,2017-01-01T00:00:00.000Z,566100,612600,1178700,4819400,19244800,24064200
2131,60250,29014018,03- Board of Equalization,2016-10-31T00:00:00.000Z,310600,1606800,1917400,2501600,8974800,11476400
2135,60250,29014018,03- Board of Equalization,2014-12-12T00:00:00.000Z,310200,1535300,1845500,2141500,9573700,11715200
2139,60250,29014018,,2009-01-01T00:00:00.000Z,339500,787300,1126800,594000,1341400,1935400
2143,60250,29014018,05- Review,2013-10-31T00:00:00.000Z,310200,1535100,1845300,2141500,9549200,11690700
2147,60250,29014018,05- Review,2020-03-10T00:00:00.000Z,341700,346200,687900,2144200,10871100,13015300
2151,60313,14030057,,2009-01-01T00:00:00.000Z,1734500,475600,2210100,0,0,0
2155,60313,14030057,,2008-01-01T00:00:00.000Z,1734500,475600,2210100,0,0,0
2159,60314,14030058,,2011-01-01T00:00:00.000Z,758200,0,758200,5725700,0,5725700
2163,60399,06028031,,2009-01-01T00:00:00.000Z,276000,515600,791600,4884000,1541200,6425200
2167,60399,06028031,,2008-01-01T00:00:00.000Z,276000,605800,881800,4884000,2273600,7157600
2171,60399,06028031,05- Review,2015-02-27T00:00:00.000Z,230000,1584900,1814900,4884000,5793900,10677900
2175,60399,06028031,01- Annual,2017-01-01T00:00:00.000Z,230000,1496400,1726400,5476000,4723200,10199200
2179,60447,17010037,05- Review,2017-09-21T00:00:00.000Z,11720700,37588000,49308700,19264000,60208400,79472400
2183,60447,17010037,01- Annual,2017-01-01T00:00:00.000Z,11720700,46459800,58180500,19264000,64737000,84001000
2187,60447,17010037,01- Annual,2014-01-01T00:00:00.000Z,11720700,39988700,51709400,15680000,65162400,80842400
2191,60447,17010037,,2012-01-01T00:00:00.000Z,11720700,31814600,43535300,15680000,49262400,64942400
2195,60799,14044021,,2009-01-01T00:00:00.000Z,343800,862900,1206700,17028000,42281400,59309400
2199,60799,14044021,,2011-01-01T00:00:00.000Z,315200,919800,1235000,15480000,66273800,81753800
2203,62153,18024020,,2008-01-01T00:00:00.000Z,1405100,2939100,4344200,7524000,16654700,24178700
2207,62153,18024020,,2012-01-01T00:00:00.000Z,1405100,8977800,10382900,6840000,46022100,52862100
2211,62153,18024020,01- Annual,2015-01-01T00:00:00.000Z,1405100,8129300,9534400,8778000,48023400,56801400
2215,62153,18024020,03- Board of Equalization,2015-09-08T00:00:00.000Z,1405100,6966600,8371700,8778000,48023400,56801400
2219,62153,18024020,01- Annual,2020-01-01T00:00:00.000Z,1522200,9509500,11031700,9804000,50193300,59997300
2223,63377,18084013,,2012-01-01T00:00:00.000Z,385000,2724600,3109600,6480000,12769500,19249500
2227,63377,18084013,,2008-01-01T00:00:00.000Z,462000,2490600,2952600,7128000,11070800,18198800
2231,63377,18084013,01- Annual,2020-01-01T00:00:00.000Z,500500,3092000,3592500,6480000,14669700,21149700
2235,63377,18084013,01- Annual,2017-01-01T00:00:00.000Z,385000,2937200,3322200,7992000,11759200,19751200
2239,63380,31025113,,2009-01-01T00:00:00.000Z,261000,20000,281000,1500000,0,1500000
2243,63680,34027062,01- Annual,2011-01-01T00:00:00.000Z,890600,0,890600,25065000,0,25065000
2247,63680,34027062,05- Review,2012-10-23T00:00:00.000Z,973000,0,973000,24763300,0,24763300
2251,63680,34027062,03- Board of Equalization,2014-08-20T00:00:00.000Z,973600,0,973600,21177300,0,21177300
2255,63680,34027062,01- Annual,2017-01-01T00:00:00.000Z,822700,0,822700,26560100,0,26560100
2259,63681,34027063,01- Annual,2020-01-01T00:00:00.000Z,227900,1520200,1748100,22680000,107429100,130109100
2263,63681,34027063,05- Review,2014-03-27T00:00:00.000Z,244400,1150400,1394800,26016200,97183000,123199200
2267,63681,34027063,,2008-01-01T00:00:00.000Z,248600,1604800,1853400,24948000,99062200,124010200
2271,63681,34027063,,2010-10-01T00:00:00.000Z,194700,1670900,1865600,21476000,84338000,105814000
2275,63683,34027065,01- Annual,2009-01-01T00:00:00.000Z,823500,0,823500,22746700,0,22746700
2279,63683,34027065,01- Annual,2008-01-01T00:00:00.000Z,809300,0,809300,22352200,0,22352200
2283,63683,34027065,05- Review,2010-10-23T00:00:00.000Z,745200,0,745200,18134500,0,18134500
2287,63683,34027065,01- Annual,2016-01-01T00:00:00.000Z,790900,0,790900,23097700,0,23097700
2291,64730,17003583,01- Annual,2017-01-01T00:00:00.000Z,0,0,0,6692600,51742600,58435200
2295,64730,17003583,05- Review,2016-08-17T00:00:00.000Z,0,0,0,6303500,52940600,59244100
2299,64730,17003583,01- Annual,2013-01-01T00:00:00.000Z,0,0,0,15005500,53418200,68423700
2303,64730,17003583,01- Annual,2020-01-01T00:00:00.000Z,0,0,0,6692600,64914100,71606700
2307,65311,32006028,,2009-11-01T00:00:00.000Z,1601600,6116200,7717800,17754000,64822800,82576800
2311,65611,14041187,,2012-01-01T00:00:00.000Z,249500,1491700,1741200,7560000,35178000,42738000
2315,65611,14041187,01- Annual,2014-01-01T00:00:00.000Z,249500,1828000,2077500,7560000,36507800,44067800
2319,65611,14041187,01- Annual,2017-01-01T00:00:00.000Z,249500,1878000,2127500,9288000,30011900,39299900
2323,65611,14041187,03- Board of Equalization,2019-10-28T00:00:00.000Z,249500,1764200,2013700,9537500,33930100,43467600
2327,65611,14041187,01- Annual,2018-01-01T00:00:00.000Z,249500,1762300,2011800,9288000,30448600,39736600
2331,65751,25017098,01- Annual,2016-01-01T00:00:00.000Z,2449600,13516700,15966300,13160000,46799000,59959000
2335,65751,25017098,01- Annual,2014-01-01T00:00:00.000Z,2449600,13245600,15695200,11280000,52775300,64055300
2339,65751,25017098,,2012-01-01T00:00:00.000Z,2449600,9106200,11555800,11280000,46129700,57409700
2343,65936,31025114,,2009-01-01T00:00:00.000Z,0,1554500,1554500,0,2024000,2024000
2347,65936,31025114,,2008-01-01T00:00:00.000Z,0,1135400,1135400,0,1436200,1436200
2351,66465,14035025,01- Annual,2013-01-01T00:00:00.000Z,20600,0,20600,1002000,0,1002000
2355,66470,18013011,,2010-10-01T00:00:00.000Z,0,3381800,3381800,0,6564700,6564700
2359,66470,18013011,01- Annual,2015-01-01T00:00:00.000Z,7314700,57691600,65006300,18788000,82645400,101433400
2363,66470,18013011,01- Annual,2019-01-01T00:00:00.000Z,7314700,63451000,70765700,20984000,88404200,109388200
2367,66889,14053061,01- Annual,,0,0,0,0,0,0
2371,66954,31022101,01- Annual,2016-01-01T00:00:00.000Z,70700,366300,437000,4350700,8179200,12529900
2375,66954,31022101,,2012-01-01T00:00:00.000Z,70700,0,70700,5640000,1000,5641000
2379,66960,32024004,01- Annual,2013-01-01T00:00:00.000Z,0,0,0,0,52981600,52981600
2383,66960,32024004,,2010-01-01T00:00:00.000Z,0,0,0,0,42359100,42359100
2387,66962,31022102,01- Annual,2013-01-01T00:00:00.000Z,0,137700,137700,0,8235500,8235500
2391,66975,16038014,,2010-01-01T00:00:00.000Z,299200,0,299200,4256900,0,4256900
2395,66975,16038014,01- Annual,2017-01-01T00:00:00.000Z,415100,0,415100,6627500,0,6627500
2399,66975,16038014,03- Board of Equalization,2018-10-10T00:00:00.000Z,415100,2803300,3218400,6680600,28692600,35373200
2403,66976,16038015,05- Review,2017-10-31T00:00:00.000Z,1599400,3056000,4655400,25536600,49002700,74539300
2407,66976,16038015,01- Annual,2015-01-01T00:00:00.000Z,1599400,0,1599400,22864100,0,22864100
2411,66976,16038015,01- Annual,2013-01-01T00:00:00.000Z,1577000,0,1577000,19178900,0,19178900
2415,66989,25016012,,2011-06-01T00:00:00.000Z,0,4888700,4888700,0,30030800,30030800
2419,66989,25016012,01- Annual,2014-01-01T00:00:00.000Z,4313800,24832800,29146600,15666600,76847800,92514400
2423,66989,25016012,01- Annual,2017-01-01T00:00:00.000Z,4313800,29371600,33685400,19322200,66993500,86315700
2427,66989,25016012,01- Annual,2019-01-01T00:00:00.000Z,4313800,26279500,30593300,15666600,68203700,83870300
2431,66990,25016013,01- Annual,2020-01-01T00:00:00.000Z,543700,0,543700,1794900,0,1794900
2435,66990,25016013,01- Annual,2016-01-01T00:00:00.000Z,494200,0,494200,2094100,0,2094100
2439,66990,25016013,,2012-07-01T00:00:00.000Z,494200,0,494200,1794900,0,1794900
2443,66991,25016014,01- Annual,2013-01-01T00:00:00.000Z,16100,0,16100,58400,0,58400
2447,66991,25016014,,2010-01-01T00:00:00.000Z,15500,0,15500,55800,0,55800
2451,66991,25016014,01- Annual,2017-01-01T00:00:00.000Z,16100,0,16100,72100,0,72100
2455,66991,25016014,05- Review,2020-04-02T00:00:00.000Z,17900,0,17900,59800,0,59800
2459,66997,32006032,01- Annual,2018-01-01T00:00:00.000Z,0,970200,970200,0,0,0
2463,66998,32006033,01- Annual,2019-01-01T00:00:00.000Z,0,909200,909200,0,0,0
2467,66999,32006034,01- Annual,2020-01-01T00:00:00.000Z,1057400,0,1057400,11620000,76755800,88375800
2471,67062,28004212,01- Annual,2018-01-01T00:00:00.000Z,377200,1534800,1912000,14040000,60064800,74104800
420,26000,15074012,01- Annual,2014-01-01T00:00:00.000Z,17100,0,17100,1462700,7087700,8550400
424,26000,15074012,01- Annual,2016-01-01T00:00:00.000Z,17100,0,17100,1692500,7380200,9072700
428,26000,15074012,01- Annual,2018-01-01T00:00:00.000Z,17100,0,17100,1797000,0,1797000
432,26001,15074013,01- Annual,2017-01-01T00:00:00.000Z,17100,0,17100,1797000,7326500,9123500
436,26001,15074013,03- Board of Equalization,2019-10-10T00:00:00.000Z,17400,0,17400,1790800,7666500,9457300
440,26001,15074013,01- Annual,2015-01-01T00:00:00.000Z,17100,0,17100,1608900,7326800,8935700
444,26001,15074013,,2009-01-01T00:00:00.000Z,17100,0,17100,1374400,0,1374400
448,26002,15074014,,2010-01-01T00:00:00.000Z,13700,0,13700,1166100,0,1166100
452,26002,15074014,,2008-01-01T00:00:00.000Z,17100,0,17100,1374400,0,1374400
456,26002,15074014,05- Review,2015-09-03T00:00:00.000Z,17100,0,17100,1608900,7324300,8933200
460,26002,15074014,01- Annual,2019-01-01T00:00:00.000Z,17100,0,17100,1797000,7936300,9733300
464,26002,15074014,01- Annual,2020-01-01T00:00:00.000Z,18800,0,18800,1790800,7957100,9747900
468,26003,15074015,03- Board of Equalization,2018-08-21T00:00:00.000Z,8600,0,8600,898500,3781600,4680100
472,26003,15074015,03- Board of Equalization,2016-09-19T00:00:00.000Z,8600,0,8600,846200,3740700,4586900
476,26003,15074015,01- Annual,2013-01-01T00:00:00.000Z,8600,0,8600,731300,2868200,3599500
480,26003,15074015,,2012-01-01T00:00:00.000Z,8600,0,8600,731300,0,731300
484,26004,15074016,,2011-01-01T00:00:00.000Z,28200,0,28200,2252200,0,2252200
488,26004,15074016,01- Annual,2014-01-01T00:00:00.000Z,30700,0,30700,2627600,12777800,15405400
492,26004,15074016,01- Annual,2016-01-01T00:00:00.000Z,30700,0,30700,3040500,13305200,16345700
496,26004,15074016,01- Annual,2018-01-01T00:00:00.000Z,30700,0,30700,3228200,0,3228200
500,26005,15074017,01- Annual,2017-01-01T00:00:00.000Z,6700,0,6700,703200,2889300,3592500
504,26005,15074017,03- Board of Equalization,2019-10-10T00:00:00.000Z,6800,0,6800,700800,3023400,3724200
508,26005,15074017,01- Annual,2015-01-01T00:00:00.000Z,6700,0,6700,629600,2889400,3519000
512,26005,15074017,,2009-01-01T00:00:00.000Z,6700,0,6700,537800,0,537800
516,26006,15074018,,2010-01-01T00:00:00.000Z,12100,0,12100,1030100,0,1030100
520,26006,15074018,,2008-01-01T00:00:00.000Z,15100,0,15100,1214100,0,1214100
524,26006,15074018,05- Review,2015-09-03T00:00:00.000Z,15100,0,15100,1421300,6499000,7920300
528,26006,15074018,01- Annual,2019-01-01T00:00:00.000Z,15100,0,15100,1587400,7042100,8629500
532,26006,15074018,01- Annual,2020-01-01T00:00:00.000Z,16600,0,16600,1582000,7060600,8642600
536,26007,15074019,03- Board of Equalization,2018-08-21T00:00:00.000Z,8600,0,8600,898500,3886600,4785100
540,26007,15074019,03- Board of Equalization,2016-09-19T00:00:00.000Z,8600,0,8600,846200,3844900,4691100
544,26007,15074019,01- Annual,2013-01-01T00:00:00.000Z,8600,0,8600,731300,2947900,3679200
548,26007,15074019,,2012-01-01T00:00:00.000Z,8600,0,8600,731300,0,731300
552,26012,15075007,01- Annual,2017-01-01T00:00:00.000Z,8400,0,8400,2018000,1000,2019000
556,26013,15075008,01- Annual,2018-01-01T00:00:00.000Z,1700,0,1700,403600,0,403600
560,26014,15075011,01- Annual,2017-01-01T00:00:00.000Z,12300,0,12300,2948000,0,2948000
564,26015,15075012,01- Annual,2018-01-01T00:00:00.000Z,4100,0,4100,982700,0,982700
568,26016,15075013,01- Annual,2017-01-01T00:00:00.000Z,8400,0,8400,2018000,1000,2019000
572,26017,15075014,01- Annual,2018-01-01T00:00:00.000Z,12700,0,12700,3027000,0,3027000
576,26018,15075016,01- Annual,2017-01-01T00:00:00.000Z,8400,0,8400,2018000,0,2018000
580,26019,15075017,01- Annual,2018-01-01T00:00:00.000Z,6800,0,6800,1614400,0,1614400
584,26020,15075018,01- Annual,2017-01-01T00:00:00.000Z,16400,0,16400,3930700,0,3930700
588,26021,15075019,01- Annual,2018-01-01T00:00:00.000Z,4200,0,4200,1009000,1000,1010000
592,26022,15075020,01- Annual,2017-01-01T00:00:00.000Z,33800,0,33800,8071900,1000,8072900
596,26051,15078002,,2011-01-01T00:00:00.000Z,16000,59000,75000,55000,49800,104800
600,26052,15078003,01- Annual,2013-01-01T00:00:00.000Z,46800,1000,47800,462800,0,462800
604,26052,15078003,,2012-01-01T00:00:00.000Z,46800,1000,47800,462800,0,462800
608,26053,15078004,,2011-01-01T00:00:00.000Z,191400,1000,192400,1769100,0,1769100
612,26054,15078005,01- Annual,2013-01-01T00:00:00.000Z,91200,0,91200,901600,0,901600
616,26054,15078005,,2012-01-01T00:00:00.000Z,91200,0,91200,901600,0,901600
620,26055,15078006,01- Annual,2019-01-01T00:00:00.000Z,19900,0,19900,4758900,1000,4759900
624,26056,15078010,01- Annual,2017-01-01T00:00:00.000Z,8400,0,8400,2018000,1000,2019000
628,26058,15078012,01- Annual,2019-01-01T00:00:00.000Z,4100,0,4100,982700,0,982700
632,26059,15078013,,2012-01-01T00:00:00.000Z,146000,0,146000,1442400,0,1442400
636,26059,15078013,01- Annual,2013-01-01T00:00:00.000Z,146000,0,146000,1442400,0,1442400
640,26060,15078014,,2011-01-01T00:00:00.000Z,89200,0,89200,824200,0,824200
644,26061,15078015,,2012-01-01T00:00:00.000Z,121600,0,121600,1202000,0,1202000
648,26061,15078015,01- Annual,2013-01-01T00:00:00.000Z,121600,0,121600,1202000,0,1202000
652,26062,15078016,,2011-01-01T00:00:00.000Z,111500,0,111500,1030300,0,1030300
656,26063,15078017,,2012-01-01T00:00:00.000Z,121600,0,121600,1202000,0,1202000
660,26063,15078017,01- Annual,2013-01-01T00:00:00.000Z,121600,0,121600,1202000,0,1202000
664,26064,15078018,,2011-01-01T00:00:00.000Z,88500,0,88500,818000,0,818000
668,26066,15078021,01- Annual,2018-01-01T00:00:00.000Z,6300,0,6300,1513700,1000,1514700
672,26067,15078022,01- Annual,2017-01-01T00:00:00.000Z,9600,0,9600,2304400,0,2304400
676,26068,15078023,,2009-01-01T00:00:00.000Z,46300,1000,47300,431100,0,431100
680,26069,15078024,01- Annual,2018-01-01T00:00:00.000Z,36600,0,36600,8747500,0,8747500
684,26395,15087028,01- Annual,2020-01-01T00:00:00.000Z,58682100,215511300,274193400,0,0,0
688,26395,15087028,01- Annual,2014-01-01T00:00:00.000Z,58682100,230061900,288744000,0,0,0
692,27064,16015100,01- Annual,2020-01-01T00:00:00.000Z,1432800,0,1432800,3142100,0,3142100
696,27081,16022003,01- Annual,2020-01-01T00:00:00.000Z,3363800,0,3363800,7376500,0,7376500
700,28240,16033009,05- Review,2020-03-06T00:00:00.000Z,89800,36100,125900,3523400,1290700,4814100
704,28242,16033011,05- Review,2020-03-06T00:00:00.000Z,297900,119700,417600,11697800,4285100,15982900
708,28244,16033013,05- Review,2020-03-06T00:00:00.000Z,131900,53000,184900,5177300,1896500,7073800
712,28246,16033016,05- Review,2020-03-06T00:00:00.000Z,69500,27900,97400,2727100,999000,3726100
716,28248,16033018,05- Review,2020-03-06T00:00:00.000Z,388600,156200,544800,15256400,5588700,20845100
720,28250,16033022,05- Review,2020-03-06T00:00:00.000Z,77100,31000,108100,3028000,1109200,4137200
724,28251,16034001,,2011-01-01T00:00:00.000Z,175000,1190200,1365200,15635400,71909000,87544400
728,28251,16034001,01- Annual,2013-01-01T00:00:00.000Z,222800,1277200,1500000,18241400,91101700,109343100
732,28251,16034001,01- Annual,2015-01-01T00:00:00.000Z,191000,1510200,1701200,20065500,104653600,124719100
736,28251,16034001,01- Annual,2017-01-01T00:00:00.000Z,190900,1604100,1795000,22404100,94771500,117175600
740,28252,16034002,01- Annual,2017-01-01T00:00:00.000Z,17900,0,17900,2100000,0,2100000
744,28252,16034002,01- Annual,2016-01-01T00:00:00.000Z,17900,0,17900,1975000,0,1975000
748,28252,16034002,,2012-01-01T00:00:00.000Z,20800,0,20800,1706800,0,1706800
752,28255,16034031,01- Annual,2020-01-01T00:00:00.000Z,23100,0,23100,2500000,0,2500000
756,28255,16034031,,2009-01-01T00:00:00.000Z,21300,0,21300,1915800,0,1915800
760,28255,16034031,01- Annual,2015-01-01T00:00:00.000Z,21300,0,21300,2235100,0,2235100
764,28255,16034031,01- Annual,2019-01-01T00:00:00.000Z,21300,0,21300,2500000,0,2500000
768,28618,16038002,,2009-01-01T00:00:00.000Z,344400,0,344400,231000,0,231000
772,28619,16038003,,2008-01-01T00:00:00.000Z,4505800,1000,4506800,2820300,0,2820300
776,28621,16038005,,2009-01-01T00:00:00.000Z,6699800,1000,6700800,4493900,0,4493900
780,28622,16038006,,2008-01-01T00:00:00.000Z,4392900,0,4392900,2749600,0,2749600
784,28624,16038009,,2008-11-01T00:00:00.000Z,2642100,0,2642100,1772200,0,1772200
788,28625,16038010,,2009-01-01T00:00:00.000Z,2364100,0,2364100,1585700,0,1585700
792,28626,16038011,,2008-01-01T00:00:00.000Z,69400,0,69400,43400,0,43400
796,28628,16038013,,2008-11-01T00:00:00.000Z,227900,0,227900,152900,0,152900
800,28665,17003010,,2012-01-01T00:00:00.000Z,0,0,0,333200,0,333200
804,28665,17003010,01- Annual,2017-01-01T00:00:00.000Z,0,0,0,2788600,0,2788600
808,28665,17003010,01- Annual,2016-01-01T00:00:00.000Z,0,0,0,2626500,0,2626500
812,28666,17003011,01- Annual,2015-01-01T00:00:00.000Z,0,0,0,369200,0,369200
816,28666,17003011,01- Annual,2019-01-01T00:00:00.000Z,0,0,0,2788600,0,2788600
820,28666,17003011,01- Annual,2013-01-01T00:00:00.000Z,0,0,0,333200,0,333200
824,28667,17003012,,2010-01-01T00:00:00.000Z,0,0,0,711700,0,711700
828,28667,17003012,01- Annual,2014-01-01T00:00:00.000Z,0,0,0,888000,0,888000
1249,43309,27002010,,2010-01-01T00:00:00.000Z,0,0,0,8906200,159200,9065400
1253,43309,27002010,01- Annual,2018-01-01T00:00:00.000Z,0,0,0,13348800,3132200,16481000
1257,43309,27002010,01- Annual,2014-01-01T00:00:00.000Z,0,0,0,11207900,1947900,13155800
1261,43310,27003001,05- Review,2020-03-31T00:00:00.000Z,0,0,0,10094100,2270200,12364300
1265,43310,27003001,01- Annual,2015-01-01T00:00:00.000Z,0,0,0,9176500,969400,10145900
1269,43310,27003001,01- Annual,2017-01-01T00:00:00.000Z,0,0,0,10094100,259000,10353100
1273,43310,27003001,05- Review,2013-08-30T00:00:00.000Z,0,0,0,8406800,372400,8779200
1277,43313,27004003,01- Annual,2013-01-01T00:00:00.000Z,0,0,0,3104700,251100,3355800
1281,43313,27004003,,2011-01-01T00:00:00.000Z,0,0,0,2467200,39800,2507000
1285,43313,27004003,01- Annual,2019-01-01T00:00:00.000Z,0,0,0,3740800,1010500,4751300
1289,43313,27004003,01- Annual,2020-01-01T00:00:00.000Z,0,0,0,3740800,1321700,5062500
1293,43385,27007077,01- Annual,2016-01-01T00:00:00.000Z,8700,0,8700,9607800,519900,10127700
1297,43385,27007077,05- Review,2019-03-26T00:00:00.000Z,0,0,0,10088200,1212000,11300200
1301,43385,27007077,,2012-01-01T00:00:00.000Z,0,0,0,8418500,119400,8537900
1305,43385,27007077,,2009-01-01T00:00:00.000Z,0,0,0,7880000,119400,7999400
1309,44098,28004003,01- Annual,2013-01-01T00:00:00.000Z,91300,184200,275500,24000000,59146500,83146500
1313,44098,28004003,03- Board of Equalization,2016-09-07T00:00:00.000Z,91300,230700,322000,28000000,60082200,88082200
1317,44098,28004003,03- Board of Equalization,2019-10-21T00:00:00.000Z,91300,308500,399800,24000000,68987900,92987900
1321,44098,28004003,01- Annual,2014-01-01T00:00:00.000Z,91300,199400,290700,24000000,61259200,85259200
1325,44099,28004004,,2008-01-01T00:00:00.000Z,227500,0,227500,7797700,0,7797700
1329,44711,28018001,,2008-01-01T00:00:00.000Z,180000,128800,308800,6336000,6594500,12930500
1333,44711,28018001,,2012-01-01T00:00:00.000Z,150000,120000,270000,6000000,11470800,17470800
1337,44711,28018001,01- Annual,2014-01-01T00:00:00.000Z,150000,182000,332000,6000000,15792400,21792400
1341,44711,28018001,01- Annual,2020-01-01T00:00:00.000Z,165000,0,165000,6000000,11937800,17937800
1345,45694,29003010,01- Annual,2019-01-01T00:00:00.000Z,49800,183600,233400,24852800,61066500,85919300
1349,45694,29003010,05- Review,2016-08-15T00:00:00.000Z,49800,145400,195200,28994900,47791100,76786000
1353,45694,29003010,,2012-01-01T00:00:00.000Z,49800,129800,179600,22781700,53431700,76213400
1357,45694,29003010,,2008-01-01T00:00:00.000Z,59700,96600,156300,27338000,35088200,62426200
1361,45695,29003019,,2011-01-01T00:00:00.000Z,2500,0,2500,1253300,0,1253300
1365,45695,29003019,01- Annual,2016-01-01T00:00:00.000Z,2700,0,2700,1595100,0,1595100
1369,45695,29003019,01- Annual,2018-01-01T00:00:00.000Z,2700,0,2700,1367200,0,1367200
1373,51205,31022004,,2008-01-01T00:00:00.000Z,22100,0,22100,349200,0,349200
1377,51221,31024007,,2008-01-01T00:00:00.000Z,204500,113000,317500,132000,198100,330100
1381,51221,31024007,,2012-01-01T00:00:00.000Z,216500,105500,322000,120000,244300,364300
1385,51294,31025049,,2010-01-01T00:00:00.000Z,56000,0,56000,2016000,0,2016000
1389,51331,31026001,,2011-01-01T00:00:00.000Z,76800,169600,246400,55000,45000,100000
1393,51331,31026001,,2008-01-01T00:00:00.000Z,14400,171300,185700,132000,23400,155400
1397,51655,32001002,01- Annual,2015-01-01T00:00:00.000Z,24500,143300,167800,12418900,114907600,127326500
1401,51655,32001002,01- Annual,2017-01-01T00:00:00.000Z,24500,145500,170000,21777400,109598700,131376100
1405,51655,32001002,03- Board of Equalization,2018-08-21T00:00:00.000Z,24500,163200,187700,17657400,105883100,123540500
1409,51655,32001002,,2012-01-01T00:00:00.000Z,24500,118500,143000,11289900,77630800,88920700
1413,51655,32001002,03- Board of Equalization,2019-10-30T00:00:00.000Z,24500,211500,236000,17657400,107805400,125462800
1417,51656,32001003,,2012-01-01T00:00:00.000Z,2300,0,2300,1079200,0,1079200
1421,51656,32001003,01- Annual,2019-01-01T00:00:00.000Z,2300,0,2300,1687900,0,1687900
1425,51656,32001003,01- Annual,2015-01-01T00:00:00.000Z,2300,0,2300,1187100,0,1187100
1429,51658,32001005,03- Board of Equalization,2015-11-03T00:00:00.000Z,135000,146602,281602,21780000,29396298,51176298
1433,51658,32001005,01- Annual,2020-01-01T00:00:00.000Z,148500,274700,423200,19800000,53716400,73516400
1437,51658,32001005,05- Review,2013-10-23T00:00:00.000Z,135000,148700,283700,19800000,28239000,48039000
1441,51658,32001005,,2010-01-01T00:00:00.000Z,129600,114400,244000,18536000,24800400,43336400
1445,51687,32001046,,2012-01-01T00:00:00.000Z,24200,0,24200,11162200,0,11162200
1449,51687,32001046,01- Annual,2019-01-01T00:00:00.000Z,24200,0,24200,17457600,0,17457600
1453,51687,32001046,01- Annual,2015-01-01T00:00:00.000Z,24200,0,24200,12278400,0,12278400
1457,51688,32001047,01- Annual,2020-01-01T00:00:00.000Z,800,0,800,533100,0,533100
1461,51688,32001047,01- Annual,2017-01-01T00:00:00.000Z,700,0,700,657500,0,657500
1465,51688,32001047,,2008-01-01T00:00:00.000Z,900,0,900,374900,0,374900
1469,51688,32001047,,2011-01-01T00:00:00.000Z,700,0,700,312400,0,312400
1473,51689,32001048,,2012-01-01T00:00:00.000Z,25200,0,25200,11644200,0,11644200
1477,51689,32001048,01- Annual,2019-01-01T00:00:00.000Z,25200,0,25200,18211400,0,18211400
1481,51689,32001048,01- Annual,2016-01-01T00:00:00.000Z,25400,0,25400,13699500,0,13699500
1485,51690,32001049,01- Annual,2020-01-01T00:00:00.000Z,17000,0,17000,11172700,42049100,53221800
1489,51690,32001049,01- Annual,2016-01-01T00:00:00.000Z,15600,0,15600,8404600,0,8404600
1493,51690,32001049,,2008-01-01T00:00:00.000Z,18600,0,18600,7858100,0,7858100
1497,51690,32001049,,2011-01-01T00:00:00.000Z,14300,0,14300,6548400,0,6548400
1501,52294,32003006,,2012-01-01T00:00:00.000Z,778500,600700,1379200,60000,61400,121400
1505,52294,32003006,01- Annual,2015-01-01T00:00:00.000Z,838500,641300,1479800,0,195000,195000
1509,52342,32006008,,2008-01-01T00:00:00.000Z,528000,651500,1179500,264000,124400,388400
1513,52342,32006008,,2012-01-01T00:00:00.000Z,433200,606800,1040000,240000,174900,414900
1517,53213,32024002,,2010-08-01T00:00:00.000Z,72000,201400,273400,20216000,14921700,35137700
1521,53213,32024002,,2008-11-01T00:00:00.000Z,72000,110400,182400,24024000,23831900,47855900
1525,53213,32024002,04- Court Order,,0,0,0,0,0,0
1529,53213,32024002,03- Board of Equalization,2015-08-21T00:00:00.000Z,75000,257600,332600,23826000,75172400,98998400
1533,53213,32024002,01- Annual,2018-01-01T00:00:00.000Z,75000,201500,276500,21660000,87859800,109519800
1537,53213,32024002,01- Annual,2020-01-01T00:00:00.000Z,82500,215900,298400,21660000,87437100,109097100
1541,53556,34020030,,2008-01-01T00:00:00.000Z,4479500,25167200,29646700,29172000,95733200,124905200
1545,53556,34020030,,2010-01-01T00:00:00.000Z,3583600,21240200,24823800,24752000,76881400,101633400
1549,53556,34020030,01- Annual,2019-01-01T00:00:00.000Z,3212900,26337200,29550100,38012000,107246900,145258900
1553,53556,34020030,05- Review,2015-08-12T00:00:00.000Z,2677500,21881900,24559400,29172000,116304000,145476000
1557,53765,34020255,01- Annual,2020-01-01T00:00:00.000Z,45100,616400,661500,26795100,182267800,209062900
1561,53765,34020255,01- Annual,2016-01-01T00:00:00.000Z,41600,270600,312200,25237300,136061500,161298800
1565,53765,34020255,,2010-01-01T00:00:00.000Z,33300,219800,253100,17480400,95275700,112756100
1569,53765,34020255,,2008-01-01T00:00:00.000Z,41600,247000,288600,20601900,105694200,126296100
1573,53766,34020256,01- Annual,2013-01-01T00:00:00.000Z,30400,0,30400,15920000,0,15920000
1577,53766,34020256,01- Annual,2017-01-01T00:00:00.000Z,30400,0,30400,19558900,0,19558900
1581,53766,34020256,01- Annual,2015-01-01T00:00:00.000Z,30400,0,30400,17512000,0,17512000
1585,54061,34027025,01- Annual,2015-01-01T00:00:00.000Z,403700,823200,1226900,47509000,107429800,154938800
1589,54061,34027025,,2011-10-01T00:00:00.000Z,370100,717600,1087700,36772800,104807300,141580100
1593,54061,34027025,01- Annual,2013-01-01T00:00:00.000Z,403700,749000,1152700,43190000,101885100,145075100
1597,54072,35001008,,2008-01-01T00:00:00.000Z,272700,498000,770700,25410000,54174300,79584300
1601,54072,35001008,,2011-01-01T00:00:00.000Z,250000,561400,811400,23100000,50673100,73773100
1605,54072,35001008,01- Annual,2015-01-01T00:00:00.000Z,272700,1253700,1526400,29645000,64330500,93975500
1609,54072,35001008,01- Annual,2019-01-01T00:00:00.000Z,272700,1954700,2227400,33110000,74184800,107294800
1613,54077,35001019,01- Annual,2020-01-01T00:00:00.000Z,396000,581400,977400,29928000,90224700,120152700
1617,54077,35001019,05- Review,2015-09-21T00:00:00.000Z,286100,864500,1150600,26796000,68026800,94822800
1621,54077,35001019,,2012-01-01T00:00:00.000Z,365600,1289000,1654600,24360000,61652700,86012700
1625,54280,35003001,01- Annual,2016-01-01T00:00:00.000Z,261800,1000,262800,17696700,0,17696700
1629,54280,35003001,01- Annual,2019-01-01T00:00:00.000Z,266700,1000,267700,18962400,0,18962400
1633,54281,35003002,01- Annual,2014-01-01T00:00:00.000Z,278200,1000,279200,10160100,0,10160100
1637,54282,35003003,01- Annual,2015-01-01T00:00:00.000Z,242300,2424400,2666700,10979000,134202600,145181600
1641,54282,35003003,01- Annual,2017-01-01T00:00:00.000Z,242300,8353300,8595600,12262300,130931800,143194100
1645,54282,35003003,,2012-01-01T00:00:00.000Z,242300,2082300,2324600,9980900,125030700,135011600
1649,54283,35003004,01- Annual,2020-01-01T00:00:00.000Z,236000,0,236000,11025900,0,11025900
1653,54283,35003004,01- Annual,2013-01-01T00:00:00.000Z,217900,0,217900,8974500,0,8974500
1657,54283,35003004,01- Annual,2018-01-01T00:00:00.000Z,217900,0,217900,11025900,0,11025900
832,28926,17003298,01- Annual,2020-01-01T00:00:00.000Z,0,0,0,139400,0,139400
836,28926,17003298,01- Annual,2018-01-01T00:00:00.000Z,0,0,0,121700,0,121700
840,28926,17003298,,2011-01-01T00:00:00.000Z,0,0,0,14200,0,14200
844,28927,17003299,,2012-01-01T00:00:00.000Z,0,0,0,41700,0,41700
848,28927,17003299,01- Annual,2017-01-01T00:00:00.000Z,0,0,0,348500,0,348500
852,28927,17003299,01- Annual,2016-01-01T00:00:00.000Z,0,0,0,328200,0,328200
856,28928,17003300,01- Annual,2015-01-01T00:00:00.000Z,0,0,0,48400,0,48400
860,28928,17003300,01- Annual,2019-01-01T00:00:00.000Z,0,0,0,348500,0,348500
864,28928,17003300,01- Annual,2013-01-01T00:00:00.000Z,0,0,0,41700,0,41700
868,29226,17005003,,2010-01-01T00:00:00.000Z,63300,0,63300,3043300,0,3043300
872,29227,17005004,,2011-01-01T00:00:00.000Z,73700,0,73700,3287300,0,3287300
876,29229,17005006,,2012-01-01T00:00:00.000Z,147000,0,147000,7009400,0,7009400
880,29231,17005008,,2010-01-01T00:00:00.000Z,41200,0,41200,1982600,0,1982600
884,29232,17005009,,2011-01-01T00:00:00.000Z,49500,0,49500,2205300,0,2205300
888,29233,17005010,,2012-01-01T00:00:00.000Z,56400,0,56400,2689000,0,2689000
892,29283,17011006,,2011-01-01T00:00:00.000Z,102000,0,102000,893200,0,893200
896,29285,17011008,,2011-01-01T00:00:00.000Z,62100,0,62100,544500,0,544500
900,29286,17011009,,2008-01-01T00:00:00.000Z,125700,0,125700,562000,1000,563000
904,29289,17011013,,2010-01-01T00:00:00.000Z,151600,0,151600,829500,0,829500
908,29290,17011015,,2008-01-01T00:00:00.000Z,470500,0,470500,2104100,1000,2105100
912,29291,17011016,,2010-01-01T00:00:00.000Z,973100,0,973100,5323800,0,5323800
916,29318,17012012,01- Annual,2014-01-01T00:00:00.000Z,966000,1928300,2894300,0,0,0
920,29329,17013017,01- Annual,2016-01-01T00:00:00.000Z,40700,585800,626500,24615200,121357900,145973100
924,29329,17013017,,2011-01-01T00:00:00.000Z,37300,347900,385200,18233500,91410800,109644300
928,29329,17013017,,2009-01-01T00:00:00.000Z,40700,353900,394600,20084800,85644400,105729200
932,29330,17013019,01- Annual,2013-01-01T00:00:00.000Z,55300,0,55300,24786500,84620100,109406600
936,29330,17013019,,2012-01-01T00:00:00.000Z,55300,0,55300,24786500,84295300,109081800
940,29330,17013019,01- Annual,2019-01-01T00:00:00.000Z,55300,0,55300,35527300,100494600,136021900
944,29332,17014001,01- Annual,2015-01-01T00:00:00.000Z,901700,4339700,5241400,19558000,73950000,93508000
948,29332,17014001,01- Annual,2019-01-01T00:00:00.000Z,901700,4290000,5191700,21844000,80357700,102201700
952,29332,17014001,,2012-01-01T00:00:00.000Z,901700,0,901700,17780000,20000,17800000
956,32270,18003111,,2008-01-01T00:00:00.000Z,108000,862100,970100,37950000,124587400,162537400
960,32270,18003111,,2012-01-01T00:00:00.000Z,108000,940800,1048800,34500000,150231700,184731700
964,32270,18003111,03- Board of Equalization,2016-09-07T00:00:00.000Z,108000,1091200,1199200,46575000,144478500,191053500
968,32270,18003111,01- Annual,2019-01-01T00:00:00.000Z,108000,782400,890400,49450000,162021100,211471100
972,32270,18003111,01- Annual,2017-01-01T00:00:00.000Z,108000,1144600,1252600,49450000,147205600,196655600
976,32675,18003602,01- Annual,2014-01-01T00:00:00.000Z,144000,1096800,1240800,33840000,177155900,210995900
980,32675,18003602,01- Annual,2016-01-01T00:00:00.000Z,144000,1386100,1530100,45684000,163922600,209606600
984,32675,18003602,,2011-01-01T00:00:00.000Z,132000,892300,1024300,33840000,124871800,158711800
988,32675,18003602,,2009-01-01T00:00:00.000Z,144000,807000,951000,37224000,123664900,160888900
992,32685,18004066,,2008-01-01T00:00:00.000Z,613600,4686800,5300400,16479800,76447000,92926800
996,32685,18004066,,2011-01-01T00:00:00.000Z,562400,5457100,6019500,14981600,82306700,97288300
1000,32685,18004066,03- Board of Equalization,2016-10-04T00:00:00.000Z,564512,6030140,6594652,18607184,101249128,119856312
1004,32685,18004066,01- Annual,2019-01-01T00:00:00.000Z,527200,6671500,7198700,18451500,108439300,126890800
1008,32685,18004066,01- Annual,2015-01-01T00:00:00.000Z,613600,6461800,7075400,19226400,106427800,125654200
1012,32691,18005040,01- Annual,2020-01-01T00:00:00.000Z,309700,0,309700,10821500,0,10821500
1016,32691,18005040,01- Annual,2016-01-01T00:00:00.000Z,359500,0,359500,11850800,0,11850800
1020,32691,18005040,03- Board of Equalization,2019-09-12T00:00:00.000Z,309700,110,309810,10836600,0,10836600
1024,32691,18005040,01- Annual,2018-01-01T00:00:00.000Z,220500,0,220500,7716600,0,7716600
1028,32691,18005040,,2012-01-01T00:00:00.000Z,359500,0,359500,8778400,0,8778400
1032,32691,18005040,01- Annual,2013-01-01T00:00:00.000Z,359500,0,359500,10241400,0,10241400
1036,32889,18007031,,2009-01-01T00:00:00.000Z,75000,73200,148200,17424000,32353700,49777700
1040,32940,18013001,,2008-01-01T00:00:00.000Z,988300,0,988300,1643600,0,1643600
1044,32944,18013006,,2008-01-01T00:00:00.000Z,880300,0,880300,1463900,0,1463900
1048,32948,18013010,,2008-01-01T00:00:00.000Z,1738100,1606000,3344100,2890500,0,2890500
1052,33220,18029007,,2011-01-01T00:00:00.000Z,1366300,1000,1367300,8940000,0,8940000
1056,33220,18029007,01- Annual,2020-01-01T00:00:00.000Z,1349200,11442400,12791600,13072000,60925700,73997700
1060,33220,18029007,01- Annual,2015-01-01T00:00:00.000Z,1245400,7716800,8962200,10032000,52927900,62959900
1064,33352,18038019,,2011-01-01T00:00:00.000Z,880000,67000,947000,5905700,188000,6093700
1068,33356,18038023,,2010-01-01T00:00:00.000Z,341400,0,341400,2235400,0,2235400
1072,33424,18041002,,2012-01-01T00:00:00.000Z,11000,896100,907100,240000,225500,465500
1076,33424,18041002,,2008-01-01T00:00:00.000Z,11000,903500,914500,264000,95300,359300
1080,33610,18054007,01- Annual,2014-01-01T00:00:00.000Z,137500,49500,187000,546000,1163600,1709600
1084,33610,18054007,01- Annual,2018-01-01T00:00:00.000Z,144400,132200,276600,663400,1891700,2555100
1088,33610,18054007,01- Annual,2013-01-01T00:00:00.000Z,137500,127900,265400,546000,1457700,2003700
1092,33610,18054007,,2011-01-01T00:00:00.000Z,126500,90600,217100,514800,1049900,1564700
1096,33614,18054011,01- Annual,2013-01-01T00:00:00.000Z,15000,351300,366300,198000,374000,572000
1100,33614,18054011,01- Annual,2014-01-01T00:00:00.000Z,152200,527900,680100,198000,316300,514300
1104,33616,18054013,,2009-01-01T00:00:00.000Z,270000,397600,667600,264000,171000,435000
1108,33616,18054013,,2011-01-01T00:00:00.000Z,314000,313300,627300,220000,180100,400100
1112,34352,18084003,01- Annual,2013-01-01T00:00:00.000Z,326100,48700,374800,14980000,11005100,25985100
1116,34352,18084003,01- Annual,2017-01-01T00:00:00.000Z,326100,212000,538100,18404000,10234700,28638700
1120,34352,18084003,01- Annual,2020-01-01T00:00:00.000Z,353300,629500,982800,18404000,13086300,31490300
1124,34492,19007004,01- Annual,2017-01-01T00:00:00.000Z,74400,64800,139200,1836400,997200,2833600
1128,34496,19007008,01- Annual,2017-01-01T00:00:00.000Z,60800,51900,112700,1500500,797700,2298200
1132,35641,20012020,01- Annual,2020-01-01T00:00:00.000Z,654400,0,654400,8170300,0,8170300
1136,37496,21034018,04- Court Order,,0,0,0,0,0,0
1140,40065,23034017,01- Annual,2018-01-01T00:00:00.000Z,1738500,1000,1739500,9339500,0,9339500
1144,40066,23034018,01- Annual,2019-01-01T00:00:00.000Z,2218800,1552700,3771500,11919900,6619200,18539100
1148,40066,23034018,01- Annual,2017-01-01T00:00:00.000Z,2440700,1000,2441700,14701200,0,14701200
1152,40067,23034019,01- Annual,2019-01-01T00:00:00.000Z,119300,86300,205600,640600,367700,1008300
1156,40994,24015015,01- Annual,2017-01-01T00:00:00.000Z,588000,2175600,2763600,12956300,14309000,27265300
1160,40994,24015015,01- Annual,2015-01-01T00:00:00.000Z,588000,2126300,2714300,11555600,14651900,26207500
1164,40994,24015015,,2010-01-01T00:00:00.000Z,0,838200,838200,10528000,6854400,17382400
1168,40995,24015017,01- Annual,2020-01-01T00:00:00.000Z,47700,0,47700,774900,0,774900
1172,40995,24015017,01- Annual,2016-01-01T00:00:00.000Z,43400,0,43400,904100,0,904100
1176,40995,24015017,01- Annual,2019-01-01T00:00:00.000Z,43400,0,43400,774900,0,774900
1180,42114,25016006,,2009-01-01T00:00:00.000Z,2280900,0,2280900,7730600,0,7730600
1184,42117,25016011,,2009-01-01T00:00:00.000Z,184300,0,184300,624500,0,624500
1188,43303,27002001,,2010-01-01T00:00:00.000Z,0,0,0,25324700,424700,25749400
1192,43303,27002001,01- Annual,2018-01-01T00:00:00.000Z,0,0,0,38384400,8910500,47294900
1196,43303,27002001,01- Annual,2014-01-01T00:00:00.000Z,0,0,0,31869700,5541800,37411500
1200,43306,27002004,05- Review,2020-03-31T00:00:00.000Z,0,361700,361700,5132800,1161200,6294000
1204,43306,27002004,01- Annual,2015-01-01T00:00:00.000Z,100000,81600,181600,4666200,495900,5162100
1208,43306,27002004,01- Annual,2017-01-01T00:00:00.000Z,0,186400,186400,5132800,132500,5265300
1212,43306,27002004,01- Annual,2013-01-01T00:00:00.000Z,100000,67600,167600,4272900,349100,4622000
1216,43307,27002005,,2009-01-01T00:00:00.000Z,0,0,0,14241200,212300,14453500
1220,43307,27002005,,2012-01-01T00:00:00.000Z,0,0,0,15214500,212300,15426800
1224,43307,27002005,05- Review,2019-03-26T00:00:00.000Z,0,0,0,18276300,2194100,20470400
1228,43307,27002005,01- Annual,2016-01-01T00:00:00.000Z,15800,0,15800,17406000,941300,18347300
1232,43308,27002006,01- Annual,2020-01-01T00:00:00.000Z,0,0,0,16924700,6030400,22955100
1236,43308,27002006,01- Annual,2019-01-01T00:00:00.000Z,0,0,0,16924700,4610400,21535100
1240,43308,27002006,,2011-01-01T00:00:00.000Z,0,0,0,11196400,199100,11395500
1244,43308,27002006,01- Annual,2013-01-01T00:00:00.000Z,0,0,0,14089300,1145400,15234700
1661,54283,35003004,01- Annual,2016-01-01T00:00:00.000Z,217900,0,217900,10384800,0,10384800
1665,54284,35003005,01- Annual,2019-01-01T00:00:00.000Z,217900,0,217900,11025900,0,11025900
1669,54284,35003005,,2008-01-01T00:00:00.000Z,217900,0,217900,8461700,0,8461700
1673,54284,35003005,,2010-01-01T00:00:00.000Z,174300,0,174300,7179600,0,7179600
1677,54285,35003006,,2010-10-01T00:00:00.000Z,129900,1924200,2054100,5600000,55346600,60946600
1681,54285,35003006,,2008-01-01T00:00:00.000Z,162400,0,162400,6600000,0,6600000
1685,54285,35003006,01- Annual,2018-01-01T00:00:00.000Z,162400,0,162400,8600000,0,8600000
1689,54285,35003006,05- Review,2018-03-29T00:00:00.000Z,162400,1944700,2107100,8600000,96736600,105336600
1693,54286,35003007,01- Annual,2016-01-01T00:00:00.000Z,162400,0,162400,8100000,0,8100000
1697,54286,35003007,01- Annual,2018-01-01T00:00:00.000Z,162400,0,162400,8600000,0,8600000
1701,54286,35003007,01- Annual,2013-01-01T00:00:00.000Z,162400,0,162400,7000000,0,7000000
1705,54286,35003007,01- Annual,2020-01-01T00:00:00.000Z,175900,0,175900,8600000,0,8600000
1709,54287,35003008,,2012-01-01T00:00:00.000Z,162400,0,162400,7000000,0,7000000
1713,54287,35003008,01- Annual,2017-01-01T00:00:00.000Z,162400,0,162400,8600000,0,8600000
1717,54287,35003008,01- Annual,2015-01-01T00:00:00.000Z,162400,0,162400,7700000,0,7700000
1721,54290,35003011,01- Annual,2014-01-01T00:00:00.000Z,849800,1000,850800,31041600,0,31041600
1725,54293,35003015,01- Annual,2014-01-01T00:00:00.000Z,298500,1000,299500,10901900,0,10901900
1729,54293,35003015,01- Annual,2017-01-01T00:00:00.000Z,196800,0,196800,16840400,1000,16841400
1733,54294,35003016,01- Annual,2019-01-01T00:00:00.000Z,102800,0,102800,8793500,0,8793500
1737,54294,35003016,01- Annual,2015-01-01T00:00:00.000Z,121100,1000,122100,7783300,0,7783300
1741,54295,35003017,01- Annual,2014-01-01T00:00:00.000Z,155800,1000,156800,5692600,0,5692600
1745,54295,35003017,01- Annual,2017-01-01T00:00:00.000Z,102800,0,102800,8793500,1000,8794500
1749,54296,35003018,01- Annual,2019-01-01T00:00:00.000Z,102800,0,102800,8796700,0,8796700
1753,54296,35003018,01- Annual,2015-01-01T00:00:00.000Z,121200,1000,122200,7786200,0,7786200
1757,54297,35003019,01- Annual,2014-01-01T00:00:00.000Z,156200,1000,157200,5706300,0,5706300
1761,54298,35003020,01- Annual,2016-01-01T00:00:00.000Z,121300,1000,122300,8197500,0,8197500
1765,54299,35003021,05- Review,2014-09-08T00:00:00.000Z,113100,1000,114100,6608900,0,6608900
1769,54299,35003021,01- Annual,2019-01-01T00:00:00.000Z,115300,1000,116300,8194400,0,8194400
1773,54325,35005022,05- Review,2019-08-13T00:00:00.000Z,37700,75100,112800,25714000,73495600,99209600
1777,54325,35005022,01- Annual,2016-01-01T00:00:00.000Z,37700,74400,112100,24219000,75448200,99667200
1781,54325,35005022,,2011-01-01T00:00:00.000Z,35200,92400,127600,17940000,55043100,72983100
1785,54325,35005022,01- Annual,2013-01-01T00:00:00.000Z,37700,61600,99300,20930000,58416600,79346600
1789,54334,35005031,,2010-01-01T00:00:00.000Z,16930100,94052700,110982800,33264000,78624500,111888500
1793,54334,35005031,01- Annual,2015-01-01T00:00:00.000Z,21162600,108636600,129799200,38808000,141029100,179837100
1797,54334,35005031,05- Review,2016-06-30T00:00:00.000Z,21162600,115744400,136907000,40824000,130890000,171714000
1801,54334,35005031,03- Board of Equalization,2018-08-15T00:00:00.000Z,21162600,118640500,139803100,43344000,138845100,182189100
1805,55126,35008005,01- Annual,2020-01-01T00:00:00.000Z,171300,940500,1111800,18120000,31351500,49471500
1809,55126,35008005,05- Review,2015-07-28T00:00:00.000Z,158100,688600,846700,23254000,24742200,47996200
1813,55126,35008005,,2011-01-01T00:00:00.000Z,144900,278400,423300,18120000,18493800,36613800
1817,55126,35008005,01- Annual,2013-01-01T00:00:00.000Z,158100,545800,703900,21140000,22725600,43865600
1821,55375,35010023,,2011-01-01T00:00:00.000Z,170000,627100,797100,31296100,34315700,65611800
1825,55375,35010023,01- Annual,2016-01-01T00:00:00.000Z,185500,1566800,1752300,42249700,70183400,112433100
1829,55375,35010023,01- Annual,2020-01-01T00:00:00.000Z,200900,3174800,3375700,44857700,80401600,125259300
1833,55380,35010032,01- Annual,2018-01-01T00:00:00.000Z,208900,0,208900,50520000,0,50520000
1837,55380,35010032,,2012-01-01T00:00:00.000Z,208900,0,208900,41120900,65324400,106445300
1841,55381,35010033,01- Annual,2013-01-01T00:00:00.000Z,199500,0,199500,39267000,57305500,96572500
1845,55381,35010033,01- Annual,2014-01-01T00:00:00.000Z,199500,0,199500,39267000,57686700,96953700
1849,55381,35010033,01- Annual,2017-01-01T00:00:00.000Z,199500,0,199500,48242300,87000700,135243000
1853,55383,35011007,,2011-01-01T00:00:00.000Z,188100,599300,787400,34097100,79465900,113563000
1857,55383,35011007,,2008-01-01T00:00:00.000Z,205200,750800,956000,37506800,85696900,123203700
1861,55384,35011008,01- Annual,2013-01-01T00:00:00.000Z,200700,0,200700,38900100,157797300,196697400
1865,55663,36018005,,2012-01-01T00:00:00.000Z,206400,721500,927900,120000,284800,404800
1869,55663,36018005,,2008-01-01T00:00:00.000Z,155500,2148500,2304000,132000,217500,349500
1873,55672,36018014,01- Annual,2014-01-01T00:00:00.000Z,496800,2827500,3324300,75250000,130886900,206136900
1877,55672,36018014,01- Annual,2020-01-01T00:00:00.000Z,590200,2306700,2896900,141642000,206154700,347796700
1881,55672,36018014,01- Annual,2018-01-01T00:00:00.000Z,496800,2174000,2670800,92450000,208206200,300656200
1885,55672,36018014,01- Annual,2013-01-01T00:00:00.000Z,496800,2847200,3344000,75250000,130854000,206104000
1889,56542,37010004,,2012-01-01T00:00:00.000Z,195800,15000,210800,452300,147400,599700
1893,56542,37010004,,2008-01-01T00:00:00.000Z,217500,15000,232500,502500,147400,649900
1897,56542,37010004,01- Annual,2014-01-01T00:00:00.000Z,195800,15000,210800,452300,147400,599700
1901,58083,38011004,01- Annual,2016-01-01T00:00:00.000Z,53400,1908800,1962200,9182800,193340700,202523500
1905,58083,38011004,,2009-01-01T00:00:00.000Z,41000,579500,620500,7210500,148148800,155359300
1909,58083,38011004,,2011-01-01T00:00:00.000Z,49100,1312500,1361600,6128600,160193900,166322500
1913,58084,38011005,,2012-01-01T00:00:00.000Z,27100,0,27100,4049900,0,4049900
1917,58084,38011005,,2008-01-01T00:00:00.000Z,20800,0,20800,3657100,0,3657100
1921,58084,38011005,01- Annual,2018-01-01T00:00:00.000Z,27100,0,27100,4890300,0,4890300
1925,58086,38011007,01- Annual,2014-01-01T00:00:00.000Z,79100,0,79100,11830400,0,11830400
1929,58086,38011007,01- Annual,2017-01-01T00:00:00.000Z,79100,0,79100,14285200,0,14285200
1933,58086,38011007,01- Annual,2013-01-01T00:00:00.000Z,79100,0,79100,11830400,0,11830400
1937,58086,38011007,01- Annual,2020-01-01T00:00:00.000Z,87000,0,87000,14285200,0,14285200
1941,58087,38011008,,2010-01-01T00:00:00.000Z,49600,0,49600,5924700,0,5924700
1945,58087,38011008,01- Annual,2019-01-01T00:00:00.000Z,51600,0,51600,9321300,0,9321300
1949,58087,38011008,01- Annual,2015-01-01T00:00:00.000Z,51600,0,51600,8491400,0,8491400
1953,58088,38011009,01- Annual,2016-01-01T00:00:00.000Z,11100,0,11100,1901300,0,1901300
1957,58088,38011009,,2009-01-01T00:00:00.000Z,8500,0,8500,1492900,0,1492900
1961,58088,38011009,,2011-01-01T00:00:00.000Z,10200,0,10200,1268900,0,1268900
1965,58089,38011010,,2012-01-01T00:00:00.000Z,8700,0,8700,1294700,0,1294700
1969,58089,38011010,,2008-01-01T00:00:00.000Z,6600,0,6600,1169200,0,1169200
1973,58089,38011010,01- Annual,2018-01-01T00:00:00.000Z,8700,0,8700,1563400,0,1563400
1977,58091,38011012,01- Annual,2014-01-01T00:00:00.000Z,106900,0,106900,15984600,0,15984600
1981,58091,38011012,01- Annual,2017-01-01T00:00:00.000Z,106900,0,106900,19301400,0,19301400
1985,58091,38011012,01- Annual,2013-01-01T00:00:00.000Z,106900,0,106900,15984600,0,15984600
1989,58091,38011012,01- Annual,2020-01-01T00:00:00.000Z,117600,0,117600,19301400,0,19301400
1993,58092,38011011,,2010-01-01T00:00:00.000Z,11500,0,11500,1377200,0,1377200
1997,58092,38011011,01- Annual,2019-01-01T00:00:00.000Z,12000,0,12000,2166800,0,2166800
2001,58092,38011011,01- Annual,2015-01-01T00:00:00.000Z,12000,0,12000,1973900,0,1973900
2005,58116,18016019,01- Annual,2016-01-01T00:00:00.000Z,12754300,82345100,95099400,24300000,111482600,135782600
2009,58116,18016019,,2010-01-01T00:00:00.000Z,10203500,62135800,72339300,16800000,40866500,57666500
2013,58264,15058015,,2011-01-01T00:00:00.000Z,173600,1260900,1434500,13140000,56113000,69253000
2017,58410,19015052,,2008-01-01T00:00:00.000Z,221100,238000,459100,66000,23800,89800
2021,58410,19015052,,2011-01-01T00:00:00.000Z,48000,269600,317600,165000,149400,314400
2025,58884,14038008,01- Annual,2015-01-01T00:00:00.000Z,429000,3928100,4357100,17787000,73845500,91632500
2029,58884,14038008,01- Annual,2018-01-01T00:00:00.000Z,429000,3729500,4158500,19866000,79326600,99192600
2033,58884,14038008,,2011-01-01T00:00:00.000Z,393300,3026400,3419700,13860000,54296300,68156300
2037,58884,14038008,01- Annual,2013-01-01T00:00:00.000Z,429000,3315400,3744400,16170000,62128000,78298000
2041,58908,06028028,01- Annual,2019-01-01T00:00:00.000Z,31000,0,31000,673700,0,673700
2045,58908,06028028,01- Annual,2015-01-01T00:00:00.000Z,0,0,0,726800,0,726800
2049,59638,18027013,01- Annual,2015-01-01T00:00:00.000Z,845300,4771800,5617100,19404000,90747000,110151000
2053,59638,18027013,03- Board of Equalization,2016-09-19T00:00:00.000Z,845300,4848700,5694000,20412000,90911100,111323100
2057,59638,18027013,01- Annual,2019-01-01T00:00:00.000Z,845300,7813900,8659200,21672000,91239400,112911400
2061,59638,18027013,,2009-01-01T00:00:00.000Z,845300,2879100,3724400,16632000,68374300,85006300
2065,59699,06026052,01- Annual,2013-01-01T00:00:00.000Z,275000,1276000,1551000,1320000,6948200,8268200
2069,60209,14043031,,2008-01-01T00:00:00.000Z,158900,687300,846200,32934000,134722900,167656900
2475,67062,28004212,03- Board of Equalization,2015-11-03T00:00:00.000Z,377200,1582970,1960170,15444000,53703230,69147230
2479,67062,28004212,01- Annual,2015-01-01T00:00:00.000Z,377200,2789500,3166700,15444000,56641700,72085700
2483,67062,28004212,,2012-11-01T00:00:00.000Z,377200,1937700,2314900,14040000,48350800,62390800
2487,67117,34020268,01- Annual,2013-01-01T00:00:00.000Z,93800,277100,370900,18550000,68277100,86827100
2491,67117,34020268,01- Annual,2014-01-01T00:00:00.000Z,93800,314200,408000,18550000,68626000,87176000
2495,67117,34020268,01- Annual,2018-01-01T00:00:00.000Z,93800,446400,540200,22790000,92395000,115185000
2499,67408,31025115,01- Annual,2017-01-01T00:00:00.000Z,115000,241500,356500,2043500,2888800,4932300
2503,67408,31025115,01- Annual,2016-01-01T00:00:00.000Z,115000,215200,330200,1946200,2688300,4634500
2507,67408,31025115,,2010-01-01T00:00:00.000Z,110400,0,110400,2016000,0,2016000
2511,67408,31025115,01- Annual,2013-01-01T00:00:00.000Z,115000,0,115000,2160000,213000,2373000
2515,67416,31025117,,2010-01-01T00:00:00.000Z,153600,0,153600,827900,0,827900
2519,67419,14060069,,2010-12-01T00:00:00.000Z,18700,0,18700,486100,0,486100
2523,67439,15070003,,2012-01-01T00:00:00.000Z,0,0,0,8120000,13278300,21398300
2527,67440,15070004,01- Annual,2013-01-01T00:00:00.000Z,2532500,3951200,6483700,0,0,0
2531,67538,11012030,,2012-01-01T00:00:00.000Z,201500,882200,1083700,0,0,0
2535,67538,11012030,01- Annual,2014-01-01T00:00:00.000Z,201500,931100,1132600,0,0,0
2539,67538,11012030,01- Annual,2019-01-01T00:00:00.000Z,9600,1030900,1040500,380200,0,380200
2543,67539,11012031,01- Annual,2020-01-01T00:00:00.000Z,7800,538000,545800,340600,0,340600
2547,67539,11012031,01- Annual,2016-01-01T00:00:00.000Z,6000,652600,658600,277200,0,277200
2551,67539,11012031,01- Annual,2013-01-01T00:00:00.000Z,123500,534400,657900,0,0,0
2555,67540,11012032,,2011-01-01T00:00:00.000Z,0,0,0,11770000,82131200,93901200
2559,67540,11012032,01- Annual,2015-01-01T00:00:00.000Z,309400,0,309400,13444400,82542800,95987200
2563,67540,11012032,01- Annual,2017-01-01T00:00:00.000Z,309400,0,309400,15074000,84625200,99699200
2567,67563,17011058,01- Annual,2013-01-01T00:00:00.000Z,114100,0,114100,1447600,216600,1664200
2571,67746,14060080,03- Board of Equalization,2015-09-28T00:00:00.000Z,542100,3203929,3746029,19789000,72877171,92666171
2575,67746,14060080,01- Annual,2018-01-01T00:00:00.000Z,542100,3621200,4163300,22102000,82369500,104471500
2579,67746,14060080,03- Board of Equalization,2019-06-27T00:00:00.000Z,542100,4406600,4948700,22102000,72377000,94479000
2583,67751,17011059,01- Annual,2013-01-01T00:00:00.000Z,797800,0,797800,10121600,1514000,11635600
2587,67753,17011061,01- Annual,2014-01-01T00:00:00.000Z,64100,99900,164000,813200,1010600,1823800
2591,67757,17011062,,2012-01-01T00:00:00.000Z,1824600,0,1824600,9982500,0,9982500
2595,67758,17011063,01- Annual,2013-01-01T00:00:00.000Z,63700,0,63700,319300,64700,384000
2599,67813,15070005,01- Annual,2014-01-01T00:00:00.000Z,1237600,249600,1487200,0,0,0
2603,67814,15070006,,2012-01-01T00:00:00.000Z,0,0,0,8120000,13278300,21398300
2607,67836,31025131,01- Annual,2013-01-01T00:00:00.000Z,0,102500,102500,0,2549800,2549800
2611,67837,18038025,01- Annual,2016-01-01T00:00:00.000Z,1674800,7594000,9268800,13160000,60543800,73703800
2615,67837,18038025,01- Annual,2019-01-01T00:00:00.000Z,1674800,11542500,13217300,11280000,63639200,74919200
2619,67837,18038025,01- Annual,2020-01-01T00:00:00.000Z,1842200,14184600,16026800,11280000,66407900,77687900
2623,67838,17011065,01- Annual,2016-01-01T00:00:00.000Z,208600,0,208600,0,0,0
2627,67849,14044261,01- Annual,2014-01-01T00:00:00.000Z,343800,1177300,1521100,18060000,76061400,94121400
2631,67849,14044261,01- Annual,2019-01-01T00:00:00.000Z,343800,2499400,2843200,22188000,84978700,107166700
2635,67849,14044261,01- Annual,2017-01-01T00:00:00.000Z,343800,2682000,3025800,22188000,81790400,103978400
2639,67863,15058016,01- Annual,2020-01-01T00:00:00.000Z,205200,1792900,1998100,18834000,76338700,95172700
2643,67863,15058016,01- Annual,2017-01-01T00:00:00.000Z,189400,1551800,1741200,18834000,74963400,93797400
2647,67912,26001112,05- Review,2016-05-20T00:00:00.000Z,772200,4472900,5245100,17990000,53582900,71572900
2651,67912,26001112,01- Annual,2018-01-01T00:00:00.000Z,772200,5098600,5870800,15420000,70066700,85486700
2655,67946,14035026,01- Annual,2013-01-01T00:00:00.000Z,27300,0,27300,1328700,0,1328700
2659,67981,35003439,05- Review,2014-09-15T00:00:00.000Z,981000,0,981000,28770000,0,28770000
2663,67982,35003035,05- Review,2014-09-08T00:00:00.000Z,233500,0,233500,4715500,0,4715500
2667,68003,17005012,03- Board of Equalization,2017-10-09T00:00:00.000Z,758100,2858300,3616400,40764000,155743500,196507500
2671,68003,17005012,01- Annual,2020-01-01T00:00:00.000Z,821300,3277600,4098900,40764000,162688500,203452500
2675,68006,35011010,01- Annual,2019-01-01T00:00:00.000Z,159500,3272500,3432000,30824600,130710500,161535100
2679,68006,35011010,01- Annual,2014-01-01T00:00:00.000Z,405800,721500,1127300,32060000,128554300,160614300
2683,68006,35011010,01- Annual,2013-01-01T00:00:00.000Z,405800,696100,1101900,32060000,114126000,146186000
2687,68007,35011011,01- Annual,2015-01-01T00:00:00.000Z,0,0,0,34958000,119945500,154903500
2691,68007,35011011,01- Annual,2017-01-01T00:00:00.000Z,246300,0,246300,47607400,114748500,162355900
2695,68007,35011011,05- Review,2018-03-07T00:00:00.000Z,246300,0,246300,47607400,116532600,164140000
2699,68034,14035028,05- Review,2019-03-27T00:00:00.000Z,0,0,0,100,0,100
2703,68034,14035028,01- Annual,2014-01-01T00:00:00.000Z,0,0,0,100,0,100
2707,68103,05056127,01- Annual,2019-01-01T00:00:00.000Z,0,21600,21600,0,0,0
2711,68105,22011272,01- Annual,2018-01-01T00:00:00.000Z,333700,896500,1230200,4980000,8076000,13056000
2715,68107,14035029,01- Annual,2017-01-01T00:00:00.000Z,768900,4236600,5005500,43000000,148345800,191345800
2719,68107,14035029,01- Annual,2020-01-01T00:00:00.000Z,833000,3492800,4325800,42999900,186504900,229504800
2723,68151,15078025,03- Board of Equalization,2017-10-31T00:00:00.000Z,1097900,5008200,6106100,13330000,66578400,79908400
2727,68362,35003022,05- Review,2016-05-16T00:00:00.000Z,2453500,3070200,5523700,56618900,79852100,136471000
2731,68363,35003023,01- Annual,2017-01-01T00:00:00.000Z,74800,0,74800,6397900,0,6397900
2735,68520,17011068,01- Annual,2020-01-01T00:00:00.000Z,1141600,10786800,11928400,16426000,72239800,88665800
2739,68520,17011068,01- Annual,2017-01-01T00:00:00.000Z,1053800,7145100,8198900,16426000,68225500,84651500
2743,68520,17011068,05- Review,2015-09-04T00:00:00.000Z,1053800,6326900,7380700,14707000,55821500,70528500
2747,68773,20012393,01- Annual,2016-01-01T00:00:00.000Z,132200,855800,988000,13203000,40044200,53247200
2751,68773,20012393,01- Annual,2018-01-01T00:00:00.000Z,132200,902000,1034200,14018000,41880800,55898800
2755,69223,15005010,01- Annual,2019-01-01T00:00:00.000Z,449600,3937200,4386800,8220500,13879200,22099700
2759,69223,15005010,03- Board of Equalization,2017-09-30T00:00:00.000Z,449600,4515300,4964900,10138600,12509400,22648000
2763,69271,15003009,01- Annual,2020-01-01T00:00:00.000Z,234600,0,234600,3899500,55478100,59377600
2767,69271,15003009,01- Annual,2018-01-01T00:00:00.000Z,213300,0,213300,3899500,49174600,53074100
2771,69463,35003840,01- Annual,2018-01-01T00:00:00.000Z,2453500,12905200,15358700,60114000,252858500,312972500
2775,69508,18004071,01- Annual,2020-01-01T00:00:00.000Z,136200,1166300,1302500,4767800,17908300,22676100
2779,69508,18004071,03- Board of Equalization,2018-07-25T00:00:00.000Z,116800,860600,977400,4086700,13809500,17896200
2783,69646,14032005,03- Board of Equalization,2018-10-25T00:00:00.000Z,355000,859000,1214000,22790000,96645700,119435700
2787,69705,23040015,01- Annual,2020-01-01T00:00:00.000Z,168200,761000,929200,3665700,7714200,11379900
2791,69717,19007040,01- Annual,2020-01-01T00:00:00.000Z,543700,2884700,3428400,12384000,60859600,73243600
2795,69725,34027033,05- Review,2018-08-23T00:00:00.000Z,403700,681600,1085300,35432000,98133600,133565600
2799,69726,34027034,01- Annual,2018-01-01T00:00:00.000Z,143700,0,143700,17630000,0,17630000
2803,69889,13018058,01- Annual,2020-01-01T00:00:00.000Z,281200,1570200,1851400,14878000,71458500,86336500
2807,69893,16038019,01- Annual,2020-01-01T00:00:00.000Z,1784000,12088100,13872100,26503300,136052000,162555300
2811,70257,35004017,05- Review,2020-03-16T00:00:00.000Z,160500,795200,955700,0,0,0
1248,43309,27002010,05- Review,2013-08-30T00:00:00.000Z,0,0,0,11207900,496500,11704400
1252,43309,27002010,01- Annual,2017-01-01T00:00:00.000Z,0,0,0,13348800,345300,13694100
1256,43309,27002010,01- Annual,2015-01-01T00:00:00.000Z,0,0,0,12135200,1292600,13427800
1260,43309,27002010,05- Review,2020-03-31T00:00:00.000Z,0,0,0,13348800,3027000,16375800
1264,43310,27003001,01- Annual,2014-01-01T00:00:00.000Z,0,0,0,8406800,1460900,9867700
1268,43310,27003001,01- Annual,2018-01-01T00:00:00.000Z,0,0,0,10094100,2349100,12443200
1272,43310,27003001,,2010-01-01T00:00:00.000Z,0,0,0,6680300,119400,6799700
1276,43313,27004003,,2009-01-01T00:00:00.000Z,0,0,0,2906100,39800,2945900
1280,43313,27004003,,2012-01-01T00:00:00.000Z,0,0,0,3104700,39800,3144500
1284,43313,27004003,05- Review,2019-03-26T00:00:00.000Z,0,0,0,3740800,445800,4186600
1288,43313,27004003,01- Annual,2016-01-01T00:00:00.000Z,3200,0,3200,3562600,191200,3753800
1292,43385,27007077,01- Annual,2020-01-01T00:00:00.000Z,0,0,0,10088200,3593400,13681600
1296,43385,27007077,01- Annual,2019-01-01T00:00:00.000Z,0,0,0,10088200,2747300,12835500
1300,43385,27007077,,2011-01-01T00:00:00.000Z,0,0,0,6690000,119400,6809400
1304,43385,27007077,01- Annual,2013-01-01T00:00:00.000Z,0,0,0,8418500,682500,9101000
1308,44098,28004003,05- Review,2013-07-30T00:00:00.000Z,91300,184200,275500,24000000,59087700,83087700
1312,44098,28004003,,2011-01-01T00:00:00.000Z,84000,200100,284100,22000000,53775000,75775000
1316,44098,28004003,01- Annual,2020-01-01T00:00:00.000Z,100400,295600,396000,24000000,72740000,96740000
1320,44098,28004003,01- Annual,2015-01-01T00:00:00.000Z,91300,233800,325100,26400000,67253200,93653200
1324,44098,28004003,03- Board of Equalization,2015-08-31T00:00:00.000Z,91300,239200,330500,26400000,61348700,87748700
1328,44100,28004005,,2008-01-01T00:00:00.000Z,225100,0,225100,7712300,0,7712300
1332,44711,28018001,,2011-01-01T00:00:00.000Z,138000,80900,218900,5280000,7284300,12564300
1336,44711,28018001,01- Annual,2016-01-01T00:00:00.000Z,150000,752100,902100,7000000,12275900,19275900
1340,44711,28018001,01- Annual,2017-01-01T00:00:00.000Z,150000,682100,832100,7400000,11826400,19226400
1344,45694,29003010,01- Annual,2018-01-01T00:00:00.000Z,49800,0,49800,24852800,0,24852800
1348,45694,29003010,01- Annual,2016-01-01T00:00:00.000Z,49800,143500,193300,28994900,50464600,79459500
1352,45694,29003010,,2012-05-01T00:00:00.000Z,49800,124200,174000,22781700,46702600,69484300
1356,45694,29003010,,2009-01-01T00:00:00.000Z,59700,112200,171900,27338000,30852700,58190700
1360,45695,29003019,01- Annual,2013-01-01T00:00:00.000Z,2700,0,2700,1253300,0,1253300
1364,45695,29003019,05- Review,2015-06-26T00:00:00.000Z,2700,0,2700,1500500,0,1500500
1368,45695,29003019,01- Annual,2019-01-01T00:00:00.000Z,2700,0,2700,1367200,0,1367200
1372,51204,31022003,,2008-01-01T00:00:00.000Z,12600,0,12600,198000,2000000,2198000
1376,51208,31022099,,2008-01-01T00:00:00.000Z,14200,0,14200,223400,0,223400
1380,51221,31024007,,2010-01-01T00:00:00.000Z,224500,76200,300700,112000,176900,288900
1384,51221,31024007,01- Annual,2015-01-01T00:00:00.000Z,336500,-2000,334500,0,440000,440000
1388,51331,31026001,,2010-01-01T00:00:00.000Z,75800,162000,237800,56000,29000,85000
1392,51331,31026001,,2009-01-01T00:00:00.000Z,14400,239000,253400,132000,59300,191300
1396,51655,32001002,01- Annual,2014-01-01T00:00:00.000Z,100,134000,134100,2124369300,107223300,2231592600
1400,51655,32001002,03- Board of Equalization,2016-09-06T00:00:00.000Z,24700,144800,169500,13282700,111875200,125157900
1404,51655,32001002,01- Annual,2019-01-01T00:00:00.000Z,24500,163500,188000,17657400,121339400,138996800
1408,51655,32001002,01- Annual,2013-01-01T00:00:00.000Z,24500,120700,145200,11289900,89562200,100852100
1412,51655,32001002,01- Annual,2020-01-01T00:00:00.000Z,26900,214900,241800,17657400,111740800,129398200
1416,51656,32001003,,2011-01-01T00:00:00.000Z,2200,0,2200,989300,0,989300
1420,51656,32001003,,2008-01-01T00:00:00.000Z,2800,0,2800,1187100,0,1187100
1424,51656,32001003,01- Annual,2016-01-01T00:00:00.000Z,2400,0,2400,1269700,0,1269700
1428,51658,32001005,01- Annual,2015-01-01T00:00:00.000Z,135000,156600,291600,21780000,31213300,52993300
1432,51658,32001005,01- Annual,2018-01-01T00:00:00.000Z,135000,269400,404400,19800000,42312300,62112300
1436,51658,32001005,,2009-01-01T00:00:00.000Z,162000,71900,233900,21846000,19049800,40895800
1440,51658,32001005,,2011-01-01T00:00:00.000Z,124200,138300,262500,18205000,28622100,46827100
1444,51687,32001046,,2011-01-01T00:00:00.000Z,22300,0,22300,10232000,0,10232000
1448,51687,32001046,,2008-01-01T00:00:00.000Z,29000,0,29000,12278400,0,12278400
1452,51687,32001046,01- Annual,2016-01-01T00:00:00.000Z,24400,0,24400,13132400,0,13132400
1456,51687,32001046,01- Annual,2020-01-01T00:00:00.000Z,26600,0,26600,17457600,0,17457600
1460,51688,32001047,01- Annual,2016-01-01T00:00:00.000Z,700,0,700,401000,0,401000
1464,51688,32001047,01- Annual,2019-01-01T00:00:00.000Z,700,0,700,533100,0,533100
1468,51688,32001047,,2012-01-01T00:00:00.000Z,700,0,700,340900,0,340900
1472,51689,32001048,,2011-01-01T00:00:00.000Z,23200,0,23200,10673800,0,10673800
1476,51689,32001048,,2008-01-01T00:00:00.000Z,30300,0,30300,12808600,0,12808600
1480,51689,32001048,01- Annual,2017-01-01T00:00:00.000Z,25200,0,25200,22460700,0,22460700
1484,51689,32001048,01- Annual,2020-01-01T00:00:00.000Z,27800,0,27800,18211400,0,18211400
1488,51690,32001049,01- Annual,2015-01-01T00:00:00.000Z,15500,0,15500,7858100,0,7858100
1492,51690,32001049,01- Annual,2019-01-01T00:00:00.000Z,15500,0,15500,11172700,6149800,17322500
1496,51690,32001049,,2012-01-01T00:00:00.000Z,15500,0,15500,7143700,0,7143700
1500,52294,32003006,,2011-01-01T00:00:00.000Z,783500,512100,1295600,55000,56900,111900
1504,52294,32003006,,2008-01-01T00:00:00.000Z,920500,569300,1489800,66000,40800,106800
1508,52342,32006008,01- Annual,2015-01-01T00:00:00.000Z,673200,571100,1244300,0,627700,627700
1512,52342,32006008,01- Annual,2013-01-01T00:00:00.000Z,433200,634600,1067800,240000,177200,417200
1516,53213,32024002,,2010-01-01T00:00:00.000Z,72000,201400,273400,20216000,17597000,37813000
1520,53213,32024002,,2012-01-01T00:00:00.000Z,75000,227600,302600,21660000,18404100,40064100
1524,53213,32024002,,2008-01-01T00:00:00.000Z,72000,110400,182400,24024000,26385500,50409500
1528,53213,32024002,01- Annual,2015-01-01T00:00:00.000Z,75000,257600,332600,23826000,77664300,101490300
1532,53213,32024002,03- Board of Equalization,2018-09-19T00:00:00.000Z,75000,203200,278200,21660000,77377700,99037700
1536,53213,32024002,03- Board of Equalization,2016-09-07T00:00:00.000Z,75000,205900,280900,25270000,25742600,51012600
1540,53556,34020030,,2009-01-01T00:00:00.000Z,4479500,22483400,26962900,29172000,86718100,115890100
1544,53556,34020030,,2011-01-01T00:00:00.000Z,4106200,20248400,24354600,26520000,98851700,125371700
1548,53556,34020030,05- Review,2018-08-09T00:00:00.000Z,2677500,15233700,17911200,26520000,122550100,149070100
1552,53556,34020030,01- Annual,2016-01-01T00:00:00.000Z,2677500,22901900,25579400,30940000,116649900,147589900
1556,53556,34020030,03- Board of Equalization,2019-10-31T00:00:00.000Z,3212900,10356900,13569800,38012000,114039500,152051500
1560,53765,34020255,01- Annual,2015-01-01T00:00:00.000Z,41600,271100,312700,23991000,140445200,164436200
1564,53765,34020255,01- Annual,2017-01-01T00:00:00.000Z,41600,565300,606900,26795100,142475500,169270600
1568,53765,34020255,01- Annual,2013-01-01T00:00:00.000Z,41600,273000,314600,21810000,124310400,146120400
1572,53766,34020256,,2008-01-01T00:00:00.000Z,30400,0,30400,15038100,0,15038100
1576,53766,34020256,,2010-01-01T00:00:00.000Z,24300,0,24300,12759600,0,12759600
1580,53766,34020256,01- Annual,2016-01-01T00:00:00.000Z,30400,0,30400,18421700,0,18421700
1584,54061,34027025,01- Annual,2014-01-01T00:00:00.000Z,403700,793900,1197600,43190000,111799800,154989800
1588,54061,34027025,,2010-01-01T00:00:00.000Z,323000,2138100,2461100,36512000,97246200,133758200
1592,54061,34027025,,2008-09-01T00:00:00.000Z,403700,2424600,2828300,43032000,94000000,137032000
1596,54072,35001008,,2009-01-01T00:00:00.000Z,272700,469500,742200,25410000,49606700,75016700
1600,54072,35001008,,2012-01-01T00:00:00.000Z,272700,667100,939800,26950000,53440200,80390200
1604,54072,35001008,01- Annual,2016-01-01T00:00:00.000Z,272700,1216500,1489200,31185000,64180600,95365600
1608,54072,35001008,03- Board of Equalization,2019-10-24T00:00:00.000Z,272700,1954700,2227400,33110000,73966600,107076600
1612,54077,35001019,01- Annual,2019-01-01T00:00:00.000Z,365600,734200,1099800,29928000,78748000,108676000
1616,54077,35001019,01- Annual,2016-01-01T00:00:00.000Z,365600,799400,1165000,28188000,67924800,96112800
1620,54077,35001019,,2011-01-01T00:00:00.000Z,335100,1208800,1543900,20880000,56859700,77739700
1624,54077,35001019,,2009-01-01T00:00:00.000Z,365600,701300,1066900,22968000,47136700,70104700
1628,54280,35003001,01- Annual,2015-01-01T00:00:00.000Z,261800,1000,262800,16822600,0,16822600
1632,54281,35003002,05- Review,2014-09-08T00:00:00.000Z,216200,0,216200,12628800,1000,12629800
1636,54282,35003003,01- Annual,2016-01-01T00:00:00.000Z,242300,7827900,8070200,11549400,138298600,149848000
1640,54282,35003003,01- Annual,2018-01-01T00:00:00.000Z,242300,7327200,7569500,12262300,132689900,144952200
1644,54282,35003003,01- Annual,2013-01-01T00:00:00.000Z,242300,2082300,2324600,9980900,125646300,135627200
1648,54282,35003003,01- Annual,2020-01-01T00:00:00.000Z,262500,7564400,7826900,12262300,145215600,157477900
1652,54283,35003004,,2012-01-01T00:00:00.000Z,217900,0,217900,8974500,0,8974500
1656,54283,35003004,01- Annual,2017-01-01T00:00:00.000Z,217900,0,217900,11025900,0,11025900
2073,60209,14043031,05- Review,2013-08-27T00:00:00.000Z,576000,3064700,3640700,34930000,139891000,174821000
2077,60209,14043031,,2011-01-01T00:00:00.000Z,528000,3349300,3877300,27445000,128135500,155580500
2081,60209,14043031,01- Annual,2016-01-01T00:00:00.000Z,576000,4071200,4647200,40419000,142752800,183171800
2085,60209,14043031,01- Annual,2020-01-01T00:00:00.000Z,624000,3407000,4031000,42914000,150255300,193169300
2089,60209,14043031,01- Annual,2018-01-01T00:00:00.000Z,576000,3548900,4124900,42914000,144234400,187148400
2093,60248,29014016,01- Annual,2019-01-01T00:00:00.000Z,1218100,1404500,2622600,8408100,42261700,50669800
2097,60248,29014016,03- Board of Equalization,2014-12-12T00:00:00.000Z,1216500,6019100,7235600,8397400,39054200,47451600
2101,60248,29014016,,2009-01-01T00:00:00.000Z,1892800,5925100,7817900,12408000,48468000,60876000
2105,60248,29014016,05- Review,2013-10-31T00:00:00.000Z,1216500,6019200,7235700,8397400,37445100,45842500
2109,60248,29014016,05- Review,2020-03-10T00:00:00.000Z,1339900,1357400,2697300,8408100,42488200,50896300
2113,60249,29014017,01- Annual,2013-01-01T00:00:00.000Z,568000,3868000,4436000,3921100,17484700,21405800
2117,60249,29014017,,2010-01-01T00:00:00.000Z,602200,3238800,3841000,2464000,8517500,10981500
2121,60249,29014017,01- Annual,2015-01-01T00:00:00.000Z,568000,2846700,3414700,4313200,19333000,23646200
2125,60249,29014017,01- Annual,2019-01-01T00:00:00.000Z,566100,655900,1222000,3907600,19737200,23644800
2129,60250,29014018,01- Annual,2018-01-01T00:00:00.000Z,310600,0,310600,2144200,0,2144200
2133,60250,29014018,05- Review,2018-08-29T00:00:00.000Z,310600,357600,668200,2144200,10762100,12906300
2137,60250,29014018,01- Annual,2014-01-01T00:00:00.000Z,310200,1535300,1845500,2141500,10092700,12234200
2141,60250,29014018,,2012-01-01T00:00:00.000Z,256600,1651900,1908500,539400,2325500,2864900
2145,60250,29014018,,2008-01-01T00:00:00.000Z,339500,884600,1224100,594000,1450100,2044100
2149,60290,14034013,,2010-01-01T00:00:00.000Z,217100,1179400,1396500,4760000,23100000,27860000
2153,60313,14030057,,2012-01-01T00:00:00.000Z,1474300,454000,1928300,0,0,0
2157,60314,14030058,01- Annual,2013-01-01T00:00:00.000Z,9558100,0,9558100,0,0,0
2161,60314,14030058,,2010-01-01T00:00:00.000Z,661700,0,661700,5245700,0,5245700
2165,60399,06028031,,2012-01-01T00:00:00.000Z,230000,1123500,1353500,4440000,6146400,10586400
2169,60399,06028031,01- Annual,2014-01-01T00:00:00.000Z,230000,1197100,1427100,4440000,5765000,10205000
2173,60399,06028031,01- Annual,2018-01-01T00:00:00.000Z,199000,1705700,1904700,5219300,4236800,9456100
2177,60447,17010037,01- Annual,2020-01-01T00:00:00.000Z,12697400,40907300,53604700,19264000,66509600,85773600
2181,60447,17010037,05- Review,2015-09-09T00:00:00.000Z,11720700,31408500,43129200,17248000,66219800,83467800
2185,60447,17010037,05- Review,2014-05-30T00:00:00.000Z,11720700,36037200,47757900,15680000,64034800,79714800
2189,60447,17010037,01- Annual,2013-01-01T00:00:00.000Z,11720700,31151000,42871700,15680000,56292500,71972500
2193,60447,17010037,,2010-01-01T00:00:00.000Z,11668600,25761000,37429600,12544000,50181400,62725400
2197,60799,14044021,,2010-09-01T00:00:00.000Z,275000,904700,1179700,14448000,57282700,71730700
2201,60799,14044021,,2008-03-01T00:00:00.000Z,0,239700,239700,0,11744800,11744800
2205,62153,18024020,,2008-11-01T00:00:00.000Z,0,86400,86400,0,489800,489800
2209,62153,18024020,,2009-01-01T00:00:00.000Z,1405100,2939100,4344200,7524000,16654700,24178700
2213,62153,18024020,01- Annual,2017-01-01T00:00:00.000Z,1405100,9176400,10581500,9804000,46191800,55995800
2217,62153,18024020,05- Review,2018-04-30T00:00:00.000Z,1405100,7365600,8770700,9804000,46306800,56110800
2221,62153,18024020,03- Board of Equalization,2016-09-30T00:00:00.000Z,1405100,8642600,10047700,9234000,47777400,57011400
2225,63377,18084013,,2010-01-01T00:00:00.000Z,369600,1668200,2037800,6048000,8138600,14186600
2229,63377,18084013,,2008-01-01T00:00:00.000Z,462000,2490600,2952600,7128000,11070800,18198800
2233,63377,18084013,01- Annual,2016-01-01T00:00:00.000Z,385000,2759200,3144200,7560000,12450600,20010600
2237,63377,18084013,01- Annual,2014-01-01T00:00:00.000Z,385000,2893600,3278600,6480000,12924300,19404300
2241,63680,34027062,01- Annual,2010-01-01T00:00:00.000Z,775500,0,775500,23342600,0,23342600
2245,63680,34027062,01- Annual,2013-01-01T00:00:00.000Z,973600,0,973600,29303100,0,29303100
2249,63680,34027062,05- Review,2010-10-23T00:00:00.000Z,775000,0,775000,19723300,0,19723300
2253,63680,34027062,01- Annual,2015-01-01T00:00:00.000Z,822500,0,822500,23684500,0,23684500
2257,63681,34027063,03- Board of Equalization,2017-07-01T00:00:00.000Z,206500,1382900,1589400,27888100,97105400,124993500
2261,63681,34027063,03- Board of Equalization,2015-09-28T00:00:00.000Z,206500,1178313,1384813,24868800,103976087,128844887
2265,63681,34027063,01- Annual,2014-01-01T00:00:00.000Z,244400,1150400,1394800,26016200,97261800,123278000
2269,63681,34027063,,2011-01-01T00:00:00.000Z,223600,1805600,2029200,23061100,94938700,117999800
2273,63681,34027063,,2009-01-01T00:00:00.000Z,248600,1644000,1892600,24948000,103915000,128863000
2277,63683,34027065,01- Annual,2012-01-01T00:00:00.000Z,936100,0,936100,27423000,0,27423000
2281,63683,34027065,05- Review,2012-10-23T00:00:00.000Z,935600,0,935600,22768500,0,22768500
2285,63683,34027065,01- Annual,2014-01-01T00:00:00.000Z,936100,0,936100,22781400,0,22781400
2289,63683,34027065,01- Annual,2018-01-01T00:00:00.000Z,790900,0,790900,19796600,0,19796600
2293,64730,17003583,01- Annual,2019-01-01T00:00:00.000Z,0,0,0,6692600,60478000,67170600
2297,64730,17003583,03- Board of Equalization,2014-09-29T00:00:00.000Z,0,0,0,15005500,55881300,70886800
2301,64730,17003583,,2012-01-01T00:00:00.000Z,0,0,0,15005500,54535300,69540800
2305,65311,32006028,,2008-01-01T00:00:00.000Z,2541000,1970300,4511300,16962000,13186200,30148200
2309,65611,14041187,,2009-01-01T00:00:00.000Z,249500,0,249500,7128000,16545700,23673700
2313,65611,14041187,,2008-01-01T00:00:00.000Z,249500,0,249500,7128000,0,7128000
2317,65611,14041187,01- Annual,2015-01-01T00:00:00.000Z,249500,1640600,1890100,8316000,36936600,45252600
2321,65611,14041187,01- Annual,2016-01-01T00:00:00.000Z,249500,1772500,2022000,8748000,32527900,41275900
2325,65611,14041187,01- Annual,2019-01-01T00:00:00.000Z,249500,1764200,2013700,9288000,32697400,41985400
2329,65751,25017098,01- Annual,2019-01-01T00:00:00.000Z,2449600,15091100,17540700,11340000,50247800,61587800
2333,65751,25017098,01- Annual,2015-01-01T00:00:00.000Z,2449600,9804900,12254500,12408000,52893000,65301000
2337,65751,25017098,,2008-01-01T00:00:00.000Z,2939500,0,2939500,12408000,0,12408000
2341,65751,25017098,,2010-01-01T00:00:00.000Z,2351600,10447300,12798900,10528000,38697800,49225800
2345,65936,31025114,,2012-01-01T00:00:00.000Z,0,1255500,1255500,0,2530700,2530700
2349,66463,14035023,01- Annual,2013-01-01T00:00:00.000Z,20600,0,20600,1002000,0,1002000
2353,66470,18013011,,2011-01-01T00:00:00.000Z,6705200,30056300,36761500,14640000,60748300,75388300
2357,66470,18013011,,2009-01-01T00:00:00.000Z,7314700,0,7314700,16104000,0,16104000
2361,66470,18013011,01- Annual,2016-01-01T00:00:00.000Z,7314700,58501800,65816500,19764000,82502600,102266600
2365,66878,11012029,,2009-01-01T00:00:00.000Z,389400,0,389400,14124000,3662100,17786100
2369,66954,31022101,01- Annual,2017-01-01T00:00:00.000Z,70700,229900,300600,4172500,8237300,12409800
2373,66954,31022101,,2009-01-01T00:00:00.000Z,84800,0,84800,6204000,1000,6205000
2377,66954,31022101,01- Annual,2013-01-01T00:00:00.000Z,70700,0,70700,5640000,790400,6430400
2381,66960,32024004,,2012-01-01T00:00:00.000Z,0,0,0,0,52981600,52981600
2385,66962,31022102,,2012-01-01T00:00:00.000Z,0,123000,123000,0,7528300,7528300
2389,66975,16038014,,2011-01-01T00:00:00.000Z,342900,0,342900,4560900,0,4560900
2393,66975,16038014,01- Annual,2014-01-01T00:00:00.000Z,437500,0,437500,5685900,0,5685900
2397,66975,16038014,01- Annual,2018-01-01T00:00:00.000Z,415100,2825900,3241000,6627500,31533700,38161200
2401,66976,16038015,03- Board of Equalization,2018-10-10T00:00:00.000Z,1599400,10545700,12145100,25741400,107938800,133680200
2405,66976,16038015,01- Annual,2016-01-01T00:00:00.000Z,1599400,0,1599400,24051900,0,24051900
2409,66976,16038015,,2012-01-01T00:00:00.000Z,1348200,0,1348200,19178900,0,19178900
2413,66989,25016012,,2011-01-01T00:00:00.000Z,3991800,0,3991800,14705400,0,14705400
2417,66989,25016012,01- Annual,2015-01-01T00:00:00.000Z,4313800,24576300,28890100,17233300,75227200,92460500
2421,66989,25016012,01- Annual,2016-01-01T00:00:00.000Z,4313800,23450200,27764000,18277800,65638900,83916700
2425,66989,25016012,01- Annual,2018-01-01T00:00:00.000Z,4313800,0,4313800,15666600,0,15666600
2429,66989,25016012,05- Review,2020-04-02T00:00:00.000Z,4795200,26941000,31736200,16042200,73839100,89881300
2433,66990,25016013,01- Annual,2018-01-01T00:00:00.000Z,494200,0,494200,1794900,0,1794900
2437,66990,25016013,01- Annual,2014-01-01T00:00:00.000Z,494200,0,494200,1794900,0,1794900
2441,66990,25016013,,2011-01-01T00:00:00.000Z,457300,0,457300,1684800,0,1684800
2445,66991,25016014,,2012-01-01T00:00:00.000Z,16100,0,16100,58400,0,58400
2449,66991,25016014,01- Annual,2015-01-01T00:00:00.000Z,16100,0,16100,64300,0,64300
2453,66991,25016014,01- Annual,2019-01-01T00:00:00.000Z,16100,0,16100,58400,0,58400
2457,66996,32006031,01- Annual,2019-01-01T00:00:00.000Z,373900,7273400,7647300,4520000,0,4520000
2461,66997,32006032,01- Annual,2020-01-01T00:00:00.000Z,0,629600,629600,0,0,0
2465,66999,32006034,01- Annual,2018-01-01T00:00:00.000Z,1247600,0,1247600,11620000,80040000,91660000
2469,67000,32006035,01- Annual,2019-01-01T00:00:00.000Z,0,0,0,0,1536600,1536600
2473,67062,28004212,03- Board of Equalization,2018-10-24T00:00:00.000Z,377200,1382700,1759900,14040000,53267900,67307900
2477,67062,28004212,03- Board of Equalization,2016-06-30T00:00:00.000Z,377200,1613200,1990400,16380000,50798500,67178500
2481,67062,28004212,,2010-01-01T00:00:00.000Z,362100,1583200,1945300,13160000,52029200,65189200
1660,54283,35003004,01- Annual,2015-01-01T00:00:00.000Z,217900,0,217900,9872000,0,9872000
1664,54284,35003005,01- Annual,2014-01-01T00:00:00.000Z,217900,0,217900,8974500,0,8974500
1668,54284,35003005,,2009-01-01T00:00:00.000Z,217900,0,217900,8461700,0,8461700
1672,54284,35003005,,2011-01-01T00:00:00.000Z,199700,0,199700,7692500,0,7692500
1676,54285,35003006,,2010-01-01T00:00:00.000Z,129900,1924200,2054100,5600000,73003600,78603600
1680,54285,35003006,01- Annual,2013-01-01T00:00:00.000Z,162400,2246800,2409200,7000000,91790100,98790100
1684,54285,35003006,05- Review,2016-09-22T00:00:00.000Z,162400,1977700,2140100,8100000,94753200,102853200
1688,54285,35003006,03- Board of Equalization,2018-08-03T00:00:00.000Z,162400,1944700,2107100,8600000,94207900,102807900
1692,54285,35003006,01- Annual,2016-01-01T00:00:00.000Z,162400,2351300,2513700,8100000,98582200,106682200
1696,54286,35003007,01- Annual,2019-01-01T00:00:00.000Z,162400,0,162400,8600000,0,8600000
1700,54286,35003007,,2008-01-01T00:00:00.000Z,162400,0,162400,6600000,0,6600000
1704,54286,35003007,,2010-01-01T00:00:00.000Z,129900,0,129900,5600000,0,5600000
1708,54287,35003008,,2011-01-01T00:00:00.000Z,148800,0,148800,6000000,0,6000000
1712,54287,35003008,,2009-01-01T00:00:00.000Z,162400,0,162400,6600000,0,6600000
1716,54287,35003008,01- Annual,2014-01-01T00:00:00.000Z,162400,0,162400,7000000,0,7000000
1720,54289,35003010,,2012-01-01T00:00:00.000Z,981000,0,981000,27295700,0,27295700
1724,54293,35003015,01- Annual,2015-01-01T00:00:00.000Z,232000,1000,233000,14906000,0,14906000
1728,54293,35003015,01- Annual,2019-01-01T00:00:00.000Z,196800,0,196800,16840400,0,16840400
1732,54294,35003016,01- Annual,2017-01-01T00:00:00.000Z,102800,0,102800,8793500,1000,8794500
1736,54294,35003016,01- Annual,2014-01-01T00:00:00.000Z,155800,1000,156800,5692600,0,5692600
1740,54295,35003017,01- Annual,2015-01-01T00:00:00.000Z,121100,1000,122100,7783300,0,7783300
1744,54295,35003017,01- Annual,2019-01-01T00:00:00.000Z,102800,0,102800,8793500,0,8793500
1748,54296,35003018,01- Annual,2017-01-01T00:00:00.000Z,102800,0,102800,8796700,1000,8797700
1752,54296,35003018,01- Annual,2014-01-01T00:00:00.000Z,155900,1000,156900,5694700,0,5694700
1756,54297,35003019,01- Annual,2015-01-01T00:00:00.000Z,121400,1000,122400,7802000,0,7802000
1760,54298,35003020,01- Annual,2019-01-01T00:00:00.000Z,123500,1000,124500,8783800,0,8783800
1764,54298,35003020,05- Review,2014-09-08T00:00:00.000Z,121300,0,121300,7084300,1000,7085300
1768,54299,35003021,01- Annual,2016-01-01T00:00:00.000Z,113100,1000,114100,7647400,0,7647400
1772,54325,35005022,01- Annual,2020-01-01T00:00:00.000Z,40800,78400,119200,25714000,75105700,100819700
1776,54325,35005022,03- Board of Equalization,2015-08-21T00:00:00.000Z,37700,70000,107700,23023000,75417900,98440900
1780,54325,35005022,,2012-01-01T00:00:00.000Z,37700,64900,102600,20930000,62779900,83709900
1784,54325,35005022,,2008-01-01T00:00:00.000Z,37700,48200,85900,19734000,52556600,72290600
1788,54334,35005031,,2009-01-01T00:00:00.000Z,21162600,108647600,129810200,33264000,92762700,126026700
1792,54334,35005031,01- Annual,2014-01-01T00:00:00.000Z,21162600,104174700,125337300,35280000,144093700,179373700
1796,54334,35005031,01- Annual,2017-01-01T00:00:00.000Z,21162600,126655400,147818000,43344000,130236400,173580400
1800,54334,35005031,01- Annual,2020-01-01T00:00:00.000Z,22926200,159650300,182576500,43344000,154745900,198089900
1804,55126,35008005,01- Annual,2019-01-01T00:00:00.000Z,158100,862800,1020900,18120000,31576700,49696700
1808,55126,35008005,01- Annual,2016-01-01T00:00:00.000Z,158100,649000,807100,24462000,21284400,45746400
1812,55126,35008005,,2012-01-01T00:00:00.000Z,158100,545300,703400,21140000,22593700,43733700
1816,55126,35008005,,2008-01-01T00:00:00.000Z,158100,86000,244100,19932000,21477600,41409600
1820,55375,35010023,,2010-01-01T00:00:00.000Z,148400,624800,773200,29209700,34315700,63525400
1824,55375,35010023,01- Annual,2015-01-01T00:00:00.000Z,185500,961800,1147300,40163300,67719200,107882500
1828,55375,35010023,01- Annual,2019-01-01T00:00:00.000Z,185500,2829900,3015400,44857700,73678100,118535800
1832,55380,35010032,01- Annual,2017-01-01T00:00:00.000Z,208900,0,208900,50520000,99794900,150314900
1836,55380,35010032,01- Annual,2014-01-01T00:00:00.000Z,208900,0,208900,41120900,66170100,107291000
1840,55380,35010032,01- Annual,2013-01-01T00:00:00.000Z,208900,0,208900,41120900,64845600,105966500
1844,55381,35010033,,2012-01-01T00:00:00.000Z,199500,0,199500,39267000,57651100,96918100
1848,55381,35010033,01- Annual,2018-01-01T00:00:00.000Z,199500,0,199500,48242300,0,48242300
1852,55383,35011007,,2012-01-01T00:00:00.000Z,205200,555100,760300,39779900,96643000,136422900
1856,55383,35011007,01- Annual,2013-01-01T00:00:00.000Z,205200,582500,787700,39779900,105198200,144978100
1860,55384,35011008,,2008-01-01T00:00:00.000Z,200600,0,200600,36677200,141913000,178590200
1864,55384,35011008,,2012-01-01T00:00:00.000Z,200600,0,200600,38900100,151265900,190166000
1868,55663,36018005,01- Annual,2013-01-01T00:00:00.000Z,206400,722000,928400,120000,288300,408300
1872,55663,36018005,01- Annual,2014-01-01T00:00:00.000Z,206400,1464200,1670600,120000,383400,503400
1876,55672,36018014,01- Annual,2017-01-01T00:00:00.000Z,496800,1984700,2481500,92450000,141657800,234107800
1880,55672,36018014,03- Board of Equalization,2016-09-07T00:00:00.000Z,496800,2728400,3225200,87075000,134421500,221496500
1884,55672,36018014,,2008-01-01T00:00:00.000Z,496800,879800,1376600,70950000,113711600,184661600
1888,55672,36018014,,2012-01-01T00:00:00.000Z,496800,2847200,3344000,75250000,130718800,205968800
1892,56542,37010004,01- Annual,2013-01-01T00:00:00.000Z,195800,15000,210800,452300,147400,599700
1896,56542,37010004,01- Annual,2015-01-01T00:00:00.000Z,215400,15000,230400,497500,147400,644900
1900,58083,38011004,03- Board of Equalization,2015-10-07T00:00:00.000Z,53400,1784713,1838113,8783600,192155987,200939587
1904,58083,38011004,01- Annual,2019-01-01T00:00:00.000Z,53400,1599900,1653300,9642000,222393200,232035200
1908,58083,38011004,,2010-01-01T00:00:00.000Z,51300,1141900,1193200,6128600,138156100,144284700
1912,58084,38011005,01- Annual,2020-01-01T00:00:00.000Z,29800,0,29800,4890300,0,4890300
1916,58084,38011005,01- Annual,2013-01-01T00:00:00.000Z,27100,0,27100,4049900,0,4049900
1920,58084,38011005,01- Annual,2017-01-01T00:00:00.000Z,27100,0,27100,4890300,0,4890300
1924,58084,38011005,01- Annual,2014-01-01T00:00:00.000Z,27100,0,27100,4049900,0,4049900
1928,58086,38011007,01- Annual,2018-01-01T00:00:00.000Z,79100,0,79100,14285200,0,14285200
1932,58086,38011007,,2008-01-01T00:00:00.000Z,60700,0,60700,10682900,0,10682900
1936,58086,38011007,,2012-01-01T00:00:00.000Z,79100,0,79100,11830400,0,11830400
1940,58087,38011008,,2011-01-01T00:00:00.000Z,47500,0,47500,5924700,0,5924700
1944,58087,38011008,,2009-01-01T00:00:00.000Z,39600,0,39600,6970700,0,6970700
1948,58087,38011008,01- Annual,2016-01-01T00:00:00.000Z,51600,0,51600,8877400,0,8877400
1952,58088,38011009,01- Annual,2015-01-01T00:00:00.000Z,11100,0,11100,1818600,0,1818600
1956,58088,38011009,01- Annual,2019-01-01T00:00:00.000Z,11100,0,11100,1996400,0,1996400
1960,58088,38011009,,2010-01-01T00:00:00.000Z,10600,0,10600,1268900,0,1268900
1964,58089,38011010,01- Annual,2020-01-01T00:00:00.000Z,9500,0,9500,1563400,0,1563400
1968,58089,38011010,01- Annual,2013-01-01T00:00:00.000Z,8700,0,8700,1294700,0,1294700
1972,58089,38011010,01- Annual,2017-01-01T00:00:00.000Z,8700,0,8700,1563400,0,1563400
1976,58089,38011010,01- Annual,2014-01-01T00:00:00.000Z,8700,0,8700,1294700,0,1294700
1980,58091,38011012,01- Annual,2018-01-01T00:00:00.000Z,106900,0,106900,19301400,0,19301400
1984,58091,38011012,,2008-01-01T00:00:00.000Z,82100,0,82100,14434100,0,14434100
1988,58091,38011012,,2012-01-01T00:00:00.000Z,106900,0,106900,15984700,0,15984700
1992,58092,38011011,,2011-01-01T00:00:00.000Z,11000,0,11000,1377200,0,1377200
1996,58092,38011011,01- Annual,2013-01-01T00:00:00.000Z,12000,0,12000,1794400,0,1794400
2000,58092,38011011,01- Annual,2016-01-01T00:00:00.000Z,12000,0,12000,2063600,0,2063600
2004,58116,18016019,01- Annual,2015-01-01T00:00:00.000Z,12754300,77491300,90245600,23100000,109425400,132525400
2008,58116,18016019,,2009-01-01T00:00:00.000Z,12754300,68448400,81202700,19800000,44019400,63819400
2012,58264,15058015,,2012-01-01T00:00:00.000Z,189400,1256800,1446200,15330000,62935200,78265200
2016,58264,15058015,,2009-01-01T00:00:00.000Z,189400,1049900,1239300,14454000,53544600,67998600
2020,58410,19015052,,2010-01-01T00:00:00.000Z,45000,262500,307500,168000,99600,267600
2024,58410,19015052,01- Annual,2015-01-01T00:00:00.000Z,251200,155100,406300,0,225500,225500
2028,58884,14038008,01- Annual,2017-01-01T00:00:00.000Z,429000,4246500,4675500,19866000,78733900,98599900
2032,58884,14038008,01- Annual,2019-01-01T00:00:00.000Z,429000,3062900,3491900,19866000,78599900,98465900
2036,58884,14038008,,2012-01-01T00:00:00.000Z,429000,3327300,3756300,16170000,60653200,76823200
2040,58908,06028028,01- Annual,2013-01-01T00:00:00.000Z,0,0,0,459500,0,459500
2044,58908,06028028,01- Annual,2016-01-01T00:00:00.000Z,0,0,0,536500,0,536500
2048,58908,06028028,01- Annual,2020-01-01T00:00:00.000Z,34100,0,34100,673700,0,673700
2052,59638,18027013,01- Annual,2017-01-01T00:00:00.000Z,845300,4910600,5755900,21672000,94795300,116467300
2056,59638,18027013,01- Annual,2020-01-01T00:00:00.000Z,915800,8596000,9511800,21672000,97043000,118715000
2060,59638,18027013,,2012-01-01T00:00:00.000Z,845300,2685700,3531000,15120000,81068300,96188300
2064,59699,06026052,,2012-01-01T00:00:00.000Z,275000,1276000,1551000,1320000,6786500,8106500
2068,59718,29023007,,2008-01-01T00:00:00.000Z,2903500,9467300,12370800,16104000,65924600,82028600
2072,60209,14043031,,2008-11-01T00:00:00.000Z,158900,687300,846200,32934000,129322600,162256600
2485,67062,28004212,,2011-01-01T00:00:00.000Z,347000,1741100,2088100,12925000,58589100,71514100
2489,67117,34020268,,2012-01-01T00:00:00.000Z,93800,273100,366900,18550000,67343500,85893500
2493,67117,34020268,01- Annual,2016-01-01T00:00:00.000Z,93800,400500,494300,21465000,82199200,103664200
2497,67117,34020268,01- Annual,2020-01-01T00:00:00.000Z,101600,275300,376900,22790000,102741600,125531600
2501,67408,31025115,01- Annual,2019-01-01T00:00:00.000Z,115000,163500,278500,2160000,2701000,4861000
2505,67408,31025115,01- Annual,2015-01-01T00:00:00.000Z,115000,242700,357700,2376000,3348700,5724700
2509,67408,31025115,,2011-06-01T00:00:00.000Z,0,159700,159700,0,2501200,2501200
2513,67415,31025116,,2012-01-01T00:00:00.000Z,290000,20000,310000,1500000,0,1500000
2517,67419,14060069,,2011-01-01T00:00:00.000Z,489500,0,489500,11880000,0,11880000
2521,67427,22001723,,2010-01-01T00:00:00.000Z,144000,0,144000,10752000,0,10752000
2525,67440,15070004,,2011-01-01T00:00:00.000Z,2321400,3741800,6063200,0,0,0
2529,67527,14060078,,2011-05-01T00:00:00.000Z,110000,0,110000,9840000,0,9840000
2533,67538,11012030,01- Annual,2013-01-01T00:00:00.000Z,201500,871800,1073300,0,0,0
2537,67538,11012030,01- Annual,2015-01-01T00:00:00.000Z,9600,919000,928600,418200,0,418200
2541,67538,11012030,01- Annual,2018-01-01T00:00:00.000Z,9600,0,9600,380200,0,380200
2545,67539,11012031,01- Annual,2017-01-01T00:00:00.000Z,6000,661000,667000,293100,0,293100
2549,67539,11012031,01- Annual,2014-01-01T00:00:00.000Z,123500,570600,694100,0,0,0
2553,67539,11012031,,2012-01-01T00:00:00.000Z,123500,540700,664200,0,0,0
2557,67540,11012032,05- Review,2013-09-12T00:00:00.000Z,0,0,0,12840000,84553000,97393000
2561,67540,11012032,01- Annual,2016-01-01T00:00:00.000Z,309400,0,309400,14259200,84400900,98660100
2565,67540,11012032,01- Annual,2020-01-01T00:00:00.000Z,402200,0,402200,17518500,90985600,108504100
2569,67563,17011058,,2012-01-01T00:00:00.000Z,131300,0,131300,1230400,0,1230400
2573,67746,14060080,01- Annual,2016-01-01T00:00:00.000Z,542100,3458100,4000200,20817000,75383700,96200700
2577,67746,14060080,03- Board of Equalization,2018-07-18T00:00:00.000Z,542100,4645900,5188000,22102000,80383000,102485000
2581,67751,17011059,01- Annual,2014-01-01T00:00:00.000Z,797800,1244400,2042200,10121600,12582300,22703900
2585,67752,17011060,,2012-01-01T00:00:00.000Z,89600,0,89600,839300,0,839300
2589,67753,17011061,01- Annual,2013-01-01T00:00:00.000Z,64100,0,64100,813200,121600,934800
2593,67758,17011063,01- Annual,2014-01-01T00:00:00.000Z,63700,49700,113400,319300,281500,600800
2597,67759,17011064,,2012-01-01T00:00:00.000Z,82000,0,82000,448700,0,448700
2601,67813,15070005,01- Annual,2013-01-01T00:00:00.000Z,1237600,249600,1487200,0,0,0
2605,67814,15070006,03- Board of Equalization,2013-10-16T00:00:00.000Z,0,0,0,8120000,10570600,18690600
2609,67837,18038025,01- Annual,2014-01-01T00:00:00.000Z,1674800,7406400,9081200,11280000,54952600,66232600
2613,67837,18038025,01- Annual,2015-01-01T00:00:00.000Z,1674800,8798200,10473000,12408000,53065600,65473600
2617,67837,18038025,01- Annual,2018-01-01T00:00:00.000Z,1674800,11047500,12722300,11280000,64753200,76033200
2621,67838,17011065,01- Annual,2019-01-01T00:00:00.000Z,219000,0,219000,0,0,0
2625,67838,17011065,01- Annual,2013-01-01T00:00:00.000Z,179600,0,179600,0,0,0
2629,67849,14044261,01- Annual,2016-01-01T00:00:00.000Z,343800,2666700,3010500,19866000,78573300,98439300
2633,67849,14044261,03- Board of Equalization,2017-10-31T00:00:00.000Z,343800,2141800,2485600,20210000,81071000,101281000
2637,67863,15058016,01- Annual,2018-01-01T00:00:00.000Z,189400,1301700,1491100,18834000,75200000,94034000
2641,67863,15058016,01- Annual,2016-01-01T00:00:00.000Z,189400,1387700,1577100,17739000,74523000,92262000
2645,67863,15058016,01- Annual,2015-01-01T00:00:00.000Z,189400,1349900,1539300,16863000,69348600,86211600
2649,67912,26001112,05- Review,2019-07-01T00:00:00.000Z,772200,7132400,7904600,15420000,67003200,82423200
2653,67912,26001112,01- Annual,2020-01-01T00:00:00.000Z,849400,8425100,9274500,15420000,74084700,89504700
2657,67947,14035027,01- Annual,2013-01-01T00:00:00.000Z,3400,0,3400,167000,0,167000
2661,67982,35003035,01- Annual,2014-01-01T00:00:00.000Z,136100,0,136100,3991200,0,3991200
2665,68003,17005012,01- Annual,2017-01-01T00:00:00.000Z,758100,3888700,4646800,40764000,162861600,203625600
2669,68003,17005012,03- Board of Equalization,2019-10-29T00:00:00.000Z,758100,3039900,3798000,40764000,141248200,182012200
2673,68006,35011010,03- Board of Equalization,2019-10-31T00:00:00.000Z,159500,3272500,3432000,30824600,126813500,157638100
2677,68006,35011010,01- Annual,2018-01-01T00:00:00.000Z,159500,0,159500,30824600,0,30824600
2681,68006,35011010,01- Annual,2016-01-01T00:00:00.000Z,405800,1193000,1598800,37087400,119387300,156474700
2685,68007,35011011,01- Annual,2013-01-01T00:00:00.000Z,405800,696100,1101900,63840000,227252100,291092100
2689,68007,35011011,05- Review,2014-08-07T00:00:00.000Z,0,0,0,31780000,122956200,154736200
2693,68007,35011011,03- Board of Equalization,2019-10-28T00:00:00.000Z,246300,0,246300,47853700,128946200,176799900
2697,68007,35011011,01- Annual,2020-01-01T00:00:00.000Z,266900,0,266900,47607400,139277900,186885300
2701,68034,14035028,01- Annual,2018-01-01T00:00:00.000Z,0,0,0,100,0,100
2705,68034,14035028,01- Annual,2015-01-01T00:00:00.000Z,0,0,0,100,0,100
2709,68105,22011272,01- Annual,2020-01-01T00:00:00.000Z,367100,960500,1327600,4980000,11350400,16330400
2713,68105,22011272,01- Annual,2016-01-01T00:00:00.000Z,333700,265500,599200,5810000,7663400,13473400
2717,68107,14035029,01- Annual,2019-01-01T00:00:00.000Z,683000,3664100,4347100,38196800,167692500,205889300
2721,68151,15078025,01- Annual,2019-01-01T00:00:00.000Z,1097900,6076300,7174200,13330000,69818000,83148000
2725,68151,15078025,01- Annual,2016-01-01T00:00:00.000Z,1097900,5846600,6944500,12555000,50157400,62712400
2729,68363,35003023,05- Review,2016-05-16T00:00:00.000Z,0,0,0,100,0,100
2733,68363,35003023,01- Annual,2018-01-01T00:00:00.000Z,74800,0,74800,6397900,0,6397900
2737,68520,17011068,05- Review,2018-08-17T00:00:00.000Z,1053800,7929000,8982800,16426000,67137800,83563800
2741,68520,17011068,01- Annual,2016-01-01T00:00:00.000Z,1053800,6099800,7153600,15471000,63717400,79188400
2745,68773,20012393,01- Annual,2015-01-01T00:00:00.000Z,132200,793600,925800,12551000,38529900,51080900
2749,68773,20012393,01- Annual,2017-01-01T00:00:00.000Z,132200,1021500,1153700,14018000,40451900,54469900
2753,68773,20012393,01- Annual,2020-01-01T00:00:00.000Z,143200,945700,1088900,14018000,44312600,58330600
2757,69223,15005010,05- Review,2018-04-24T00:00:00.000Z,449600,3932800,4382400,8220500,13521900,21742400
2761,69230,14013051,01- Annual,2019-01-01T00:00:00.000Z,180000,857800,1037800,22962000,80655800,103617800
2765,69271,15003009,05- Review,2018-04-24T00:00:00.000Z,213300,0,213300,3899500,50868100,54767600
2769,69271,15003009,01- Annual,2017-01-01T00:00:00.000Z,213300,0,213300,4809400,49174600,53984000
2773,69463,35003840,03- Board of Equalization,2019-10-24T00:00:00.000Z,2453500,10513200,12966700,60114000,289244000,349358000
2777,69508,18004071,03- Board of Equalization,2019-09-12T00:00:00.000Z,136200,1086100,1222300,4767800,16975300,21743100
2781,69508,18004071,01- Annual,2017-01-01T00:00:00.000Z,97300,772600,869900,3405600,11284000,14689600
2785,69646,14032005,03- Board of Equalization,2019-10-15T00:00:00.000Z,355000,929600,1284600,22790000,97854900,120644900
2789,69706,23040016,01- Annual,2019-01-01T00:00:00.000Z,282600,8112700,8395300,6774300,509200,7283500
2793,69717,19007040,03- Board of Equalization,2019-09-03T00:00:00.000Z,501800,2680900,3182700,12298000,55466400,67764400
2797,69725,34027033,01- Annual,2020-01-01T00:00:00.000Z,238400,1252400,1490800,23847200,128391400,152238600
2801,69726,34027034,01- Annual,2019-01-01T00:00:00.000Z,0,0,0,17630000,0,17630000
2805,69889,13018058,03- Board of Equalization,2019-10-29T00:00:00.000Z,259600,1334900,1594500,14878000,61736800,76614800
2809,69937,35004011,05- Review,2020-03-16T00:00:00.000Z,537500,2662300,3199800,0,0,0
2076,60209,14043031,,2009-01-01T00:00:00.000Z,576000,3934800,4510800,32934000,134495500,167429500
2080,60209,14043031,03- Board of Equalization,2015-08-21T00:00:00.000Z,576000,4030600,4606600,38423000,138358500,176781500
2084,60209,14043031,01- Annual,2019-01-01T00:00:00.000Z,576000,3935900,4511900,42914000,147283500,190197500
2088,60209,14043031,03- Board of Equalization,2017-08-31T00:00:00.000Z,576000,4002800,4578800,42914000,137976400,180890400
2092,60248,29014016,03- Board of Equalization,2016-10-31T00:00:00.000Z,1218100,6300480,7518580,9809500,35190320,44999820
2096,60248,29014016,03- Board of Equalization,2015-08-21T00:00:00.000Z,1216500,6095500,7312000,9237100,41396000,50633100
2100,60248,29014016,,2011-01-01T00:00:00.000Z,1331900,7127900,8459800,10340000,46923600,57263600
2104,60248,29014016,,2011-08-01T00:00:00.000Z,1331900,7128500,8460400,10340000,44776900,55116900
2108,60248,29014016,01- Annual,2020-01-01T00:00:00.000Z,1339900,1357400,2697300,8408100,44841700,53249800
2112,60249,29014017,,2008-01-01T00:00:00.000Z,857300,2233300,3090600,2904000,7439800,10343800
2116,60249,29014017,,2012-01-01T00:00:00.000Z,627400,4038800,4666200,2640400,11384300,14024700
2120,60249,29014017,01- Annual,2014-01-01T00:00:00.000Z,568000,2811100,3379100,3921100,18481700,22402800
2124,60249,29014017,05- Review,2018-08-29T00:00:00.000Z,566100,654800,1220900,3907600,19707500,23615100
2128,60249,29014017,01- Annual,2018-01-01T00:00:00.000Z,566100,0,566100,3907600,0,3907600
2132,60250,29014018,01- Annual,2019-01-01T00:00:00.000Z,310600,358200,668800,2144200,10778300,12922500
2136,60250,29014018,01- Annual,2015-01-01T00:00:00.000Z,310200,1554700,1864900,2355600,10557600,12913200
2140,60250,29014018,,2010-01-01T00:00:00.000Z,246400,1325100,1571500,504000,1742200,2246200
2144,60250,29014018,01- Annual,2013-01-01T00:00:00.000Z,310200,2112500,2422700,2141500,9549200,11690700
2148,60290,14034013,,2008-01-01T00:00:00.000Z,271400,1939100,2210500,5610000,31765100,37375100
2152,60313,14030057,,2010-01-01T00:00:00.000Z,1474300,475600,1949900,0,0,0
2156,60313,14030057,01- Annual,2013-01-01T00:00:00.000Z,2100800,0,2100800,0,0,0
2160,60314,14030058,,2012-01-01T00:00:00.000Z,827200,0,827200,6925700,0,6925700
2164,60399,06028031,,2010-01-01T00:00:00.000Z,220800,923200,1144000,4144000,3471500,7615500
2168,60399,06028031,01- Annual,2013-01-01T00:00:00.000Z,230000,1170200,1400200,4440000,6210700,10650700
2172,60399,06028031,01- Annual,2015-01-01T00:00:00.000Z,199000,1344000,1543000,4663700,6861600,11525300
2176,60399,06028031,01- Annual,2020-01-01T00:00:00.000Z,218900,1466100,1685000,4323000,5577800,9900800
2180,60447,17010037,01- Annual,2019-01-01T00:00:00.000Z,11720700,45168500,56889200,19264000,63033700,82297700
2184,60447,17010037,03- Board of Equalization,2016-09-19T00:00:00.000Z,11720700,29979600,41700300,18144000,66229300,84373300
2188,60447,17010037,,2008-01-01T00:00:00.000Z,11720700,27981100,39701800,14784000,70876900,85660900
2192,60447,17010037,,2010-09-01T00:00:00.000Z,9376600,25761000,35137600,12544000,50181400,62725400
2196,60799,14044021,,2010-01-01T00:00:00.000Z,275000,904700,1179700,14448000,61481700,75929700
2200,60799,14044021,,2008-01-01T00:00:00.000Z,343800,862900,1206700,17028000,42281400,59309400
2204,62153,18024020,01- Annual,2013-01-01T00:00:00.000Z,1405100,7749900,9155000,6840000,46184900,53024900
2208,62153,18024020,,2010-01-01T00:00:00.000Z,1124100,4835200,5959300,6384000,35579100,41963100
2212,62153,18024020,05- Review,2014-11-04T00:00:00.000Z,1405100,8029400,9434500,6840000,49864500,56704500
2216,62153,18024020,01- Annual,2019-01-01T00:00:00.000Z,1405100,8922600,10327700,9804000,49896000,59700000
2220,62153,18024020,01- Annual,2018-01-01T00:00:00.000Z,1405100,9570500,10975600,9804000,47008200,56812200
2224,63377,18084013,,2009-01-01T00:00:00.000Z,462000,2362200,2824200,7128000,10741900,17869900
2228,63377,18084013,01- Annual,2013-01-01T00:00:00.000Z,385000,2724600,3109600,6480000,11942600,18422600
2232,63377,18084013,01- Annual,2019-01-01T00:00:00.000Z,385000,2659600,3044600,6480000,12596300,19076300
2236,63377,18084013,01- Annual,2015-01-01T00:00:00.000Z,385000,3061100,3446100,7128000,14615800,21743800
2240,63680,34027062,01- Annual,2009-01-01T00:00:00.000Z,856500,0,856500,24306200,0,24306200
2244,63680,34027062,01- Annual,2008-01-01T00:00:00.000Z,841600,0,841600,23884700,0,23884700
2248,63680,34027062,05- Review,2011-10-23T00:00:00.000Z,890100,0,890100,21180800,0,21180800
2252,63680,34027062,01- Annual,2016-01-01T00:00:00.000Z,822600,0,822600,25121400,0,25121400
2256,63681,34027063,03- Board of Equalization,2016-07-20T00:00:00.000Z,206500,1315300,1521800,26377500,101132300,127509800
2260,63681,34027063,01- Annual,2016-01-01T00:00:00.000Z,206500,1406600,1613100,26377500,103125300,129502800
2264,63681,34027063,01- Annual,2015-01-01T00:00:00.000Z,206500,1260000,1466500,24868800,104179500,129048300
2268,63681,34027063,01- Annual,2013-01-01T00:00:00.000Z,244400,1150400,1394800,26960400,91860100,118820500
2272,63681,34027063,,2010-01-01T00:00:00.000Z,194700,2470400,2665100,21476000,94164400,115640400
2276,63683,34027065,01- Annual,2010-01-01T00:00:00.000Z,745700,0,745700,21844900,0,21844900
2280,63683,34027065,05- Review,2013-10-23T00:00:00.000Z,938800,0,938800,22845800,0,22845800
2284,63683,34027065,01- Annual,2013-01-01T00:00:00.000Z,936100,0,936100,27423000,0,27423000
2288,63683,34027065,01- Annual,2015-01-01T00:00:00.000Z,790900,0,790900,21776600,0,21776600
2292,64730,17003583,01- Annual,2018-01-01T00:00:00.000Z,0,0,0,5842400,60111400,65953800
2296,64730,17003583,01- Annual,2015-01-01T00:00:00.000Z,0,0,0,16496000,55935100,72431100
2300,64730,17003583,,2011-01-01T00:00:00.000Z,0,0,0,12857600,47510700,60368300
2304,65005,34027453,01- Annual,2013-01-01T00:00:00.000Z,0,0,0,14840000,54418900,69258900
2308,65611,14041187,,2009-04-01T00:00:00.000Z,0,0,0,0,10152900,10152900
2312,65611,14041187,,2011-01-01T00:00:00.000Z,228700,891500,1120200,6480000,24216000,30696000
2316,65611,14041187,03- Board of Equalization,2014-08-29T00:00:00.000Z,249500,1684500,1934000,7560000,33364300,40924300
2320,65611,14041187,03- Board of Equalization,2015-08-21T00:00:00.000Z,249500,1640600,1890100,8316000,32367900,40683900
2324,65611,14041187,03- Board of Equalization,2019-10-29T00:00:00.000Z,249500,1764200,2013700,9288000,32165900,41453900
2328,65751,25017098,01- Annual,2018-01-01T00:00:00.000Z,2449600,15416000,17865600,11280000,50177200,61457200
2332,65751,25017098,01- Annual,2017-01-01T00:00:00.000Z,2449600,14470100,16919700,13912000,46698800,60610800
2336,65751,25017098,01- Annual,2013-01-01T00:00:00.000Z,2449600,12397200,14846800,11280000,48727800,60007800
2340,65751,25017098,,2012-07-01T00:00:00.000Z,2449600,13142100,15591700,11280000,50511600,61791600
2344,65936,31025114,,2010-01-01T00:00:00.000Z,0,1321100,1321100,0,1681300,1681300
2348,66462,14035022,01- Annual,2013-01-01T00:00:00.000Z,41200,0,41200,2004100,0,2004100
2352,66470,18013011,01- Annual,2013-01-01T00:00:00.000Z,7314700,37917200,45231900,17080000,75842200,92922200
2356,66470,18013011,,2010-01-01T00:00:00.000Z,5851800,8596400,14448200,13664000,16836800,30500800
2360,66470,18013011,01- Annual,2017-01-01T00:00:00.000Z,7314700,61805800,69120500,20984000,85392500,106376500
2364,66470,18013011,01- Annual,2018-01-01T00:00:00.000Z,7314700,56891500,64206200,20984000,90458100,111442100
2368,66954,31022101,01- Annual,2019-01-01T00:00:00.000Z,70700,352900,423600,4154900,8156900,12311800
2372,66954,31022101,01- Annual,2014-01-01T00:00:00.000Z,70700,409200,479900,5640000,8380600,14020600
2376,66954,31022101,,2011-01-01T00:00:00.000Z,65000,0,65000,5170000,1000,5171000
2380,66960,32024004,,2011-01-01T00:00:00.000Z,0,0,0,0,48960000,48960000
2384,66962,31022102,,2010-01-01T00:00:00.000Z,0,127800,127800,0,6584000,6584000
2388,66975,16038014,01- Annual,2013-01-01T00:00:00.000Z,437500,0,437500,5321100,0,5321100
2392,66975,16038014,01- Annual,2015-01-01T00:00:00.000Z,415100,0,415100,5933900,0,5933900
2396,66975,16038014,09- New Construction,2017-05-01T00:00:00.000Z,415100,812300,1227400,6627500,13026000,19653500
2400,66975,16038014,01- Annual,2020-01-01T00:00:00.000Z,398400,3409500,3807900,5918700,38373700,44292400
2404,66976,16038015,01- Annual,2017-01-01T00:00:00.000Z,1599400,0,1599400,25536600,0,25536600
2408,66976,16038015,,2010-01-01T00:00:00.000Z,1078600,0,1078600,15343100,0,15343100
2412,66989,25016012,01- Annual,2013-01-01T00:00:00.000Z,4313800,26503800,30817600,15666600,74463400,90130000
2416,66989,25016012,,2010-01-01T00:00:00.000Z,4165300,0,4165300,14972700,0,14972700
2420,66989,25016012,05- Review,2014-05-08T00:00:00.000Z,4313800,21558200,25872000,15666600,74003700,89670300
2424,66989,25016012,05- Review,2017-09-18T00:00:00.000Z,4313900,26236700,30550600,19322200,63978700,83300900
2428,66989,25016012,01- Annual,2020-01-01T00:00:00.000Z,4745200,32685300,37430500,15666600,72529300,88195900
2432,66990,25016013,01- Annual,2019-01-01T00:00:00.000Z,494200,0,494200,1794900,0,1794900
2436,66990,25016013,01- Annual,2015-01-01T00:00:00.000Z,494200,0,494200,1974400,0,1974400
2440,66990,25016013,,2012-01-01T00:00:00.000Z,494200,0,494200,1794900,0,1794900
2444,66991,25016014,,2011-01-01T00:00:00.000Z,14900,0,14900,54900,0,54900
2448,66991,25016014,01- Annual,2014-01-01T00:00:00.000Z,16100,0,16100,58400,0,58400
2452,66991,25016014,01- Annual,2018-01-01T00:00:00.000Z,16100,0,16100,58400,0,58400
2456,66996,32006031,01- Annual,2020-01-01T00:00:00.000Z,411300,5036400,5447700,4520000,0,4520000
2460,66997,32006032,01- Annual,2019-01-01T00:00:00.000Z,0,909200,909200,0,0,0
2464,66998,32006033,01- Annual,2018-01-01T00:00:00.000Z,0,970200,970200,0,0,0
2468,67000,32006035,01- Annual,2020-01-01T00:00:00.000Z,0,0,0,0,1574400,1574400
2472,67062,28004212,01- Annual,2020-01-01T00:00:00.000Z,414900,1586000,2000900,14040000,55562900,69602900
2476,67062,28004212,01- Annual,2017-01-01T00:00:00.000Z,377200,1552200,1929400,17316000,49690500,67006500
2480,67062,28004212,01- Annual,2014-01-01T00:00:00.000Z,377200,2362200,2739400,14040000,58234300,72274300
2484,67062,28004212,,2012-01-01T00:00:00.000Z,377200,1937700,2314900,14040000,48350800,62390800
2488,67117,34020268,,2011-01-01T00:00:00.000Z,86000,255500,341500,15900000,63773900,79673900
2492,67117,34020268,01- Annual,2015-01-01T00:00:00.000Z,93800,400200,494000,20405000,83188600,103593600
2496,67117,34020268,01- Annual,2017-01-01T00:00:00.000Z,93800,505800,599600,22790000,88100600,110890600
2500,67408,31025115,05- Review,2017-03-21T00:00:00.000Z,115000,105900,220900,2043500,2804700,4848200
2504,67408,31025115,05- Review,2015-03-13T00:00:00.000Z,115000,140400,255400,2376000,3087100,5463100
2508,67408,31025115,,2012-01-01T00:00:00.000Z,115000,0,115000,2160000,20000,2180000
2512,67415,31025116,,2011-01-01T00:00:00.000Z,266800,20000,286800,675000,0,675000
2516,67416,31025117,,2011-01-01T00:00:00.000Z,0,0,0,825000,0,825000
2520,67420,14060070,,2010-01-01T00:00:00.000Z,96000,0,96000,9184000,0,9184000
2524,67439,15070003,,2011-01-01T00:00:00.000Z,1134400,253700,1388100,6960000,0,6960000
2528,67440,15070004,01- Annual,2014-01-01T00:00:00.000Z,2532500,3951200,6483700,0,0,0
2532,67538,11012030,,2011-01-01T00:00:00.000Z,185400,918600,1104000,0,0,0
2536,67538,11012030,01- Annual,2015-04-01T00:00:00.000Z,9600,919000,928600,418200,0,418200
2540,67538,11012030,01- Annual,2017-01-01T00:00:00.000Z,9600,1078500,1088100,468900,0,468900
2544,67539,11012031,01- Annual,2018-01-01T00:00:00.000Z,6000,0,6000,237600,0,237600
2548,67539,11012031,01- Annual,2015-01-01T00:00:00.000Z,6000,563200,569200,261400,0,261400
2552,67539,11012031,,2011-01-01T00:00:00.000Z,113600,563000,676600,0,0,0
2556,67540,11012032,01- Annual,2013-01-01T00:00:00.000Z,0,0,0,12840000,90503200,103343200
2560,67540,11012032,03- Board of Equalization,2015-08-21T00:00:00.000Z,309400,0,309400,13444400,81947900,95392300
2564,67540,11012032,01- Annual,2018-01-01T00:00:00.000Z,309400,0,309400,12222200,0,12222200
2568,67563,17011058,,2011-01-01T00:00:00.000Z,121000,0,121000,1060100,0,1060100
2572,67746,14060080,01- Annual,2015-01-01T00:00:00.000Z,542100,3297300,3839400,19789000,75186900,94975900
2576,67746,14060080,01- Annual,2017-01-01T00:00:00.000Z,542100,3810400,4352500,22102000,79687100,101789100
2580,67746,14060080,01- Annual,2020-01-01T00:00:00.000Z,587300,4641000,5228300,22102000,85408800,107510800
2584,67752,17011060,01- Annual,2013-01-01T00:00:00.000Z,77800,0,77800,987600,147800,1135400
2588,67753,17011061,,2012-01-01T00:00:00.000Z,73800,0,73800,691100,0,691100
2592,67757,17011062,01- Annual,2014-01-01T00:00:00.000Z,1824600,1422100,3246700,9139800,8058500,17198300
2596,67759,17011064,01- Annual,2013-01-01T00:00:00.000Z,82000,0,82000,410800,83300,494100
2600,67813,15070005,,2012-01-01T00:00:00.000Z,1237600,249600,1487200,0,0,0
2604,67814,15070006,01- Annual,2014-01-01T00:00:00.000Z,0,0,0,8120000,14478200,22598200
2608,67837,18038025,01- Annual,2013-01-01T00:00:00.000Z,1674800,7707800,9382600,11280000,49461700,60741700
2612,67837,18038025,03- Board of Equalization,2015-08-21T00:00:00.000Z,1674800,8798200,10473000,12408000,50430500,62838500
2616,67837,18038025,01- Annual,2017-01-01T00:00:00.000Z,1674800,10981300,12656100,13912000,61947600,75859600
2620,67838,17011065,01- Annual,2020-01-01T00:00:00.000Z,219000,0,219000,0,0,0
2624,67838,17011065,01- Annual,2014-01-01T00:00:00.000Z,0,179600,179600,0,0,0
2628,67849,14044261,05- Review,2016-04-27T00:00:00.000Z,343800,2666700,3010500,20898000,77439700,98337700
2632,67849,14044261,03- Board of Equalization,2018-07-25T00:00:00.000Z,377600,2414900,2792500,20210000,85582700,105792700
2636,67849,14044261,01- Annual,2020-01-01T00:00:00.000Z,372500,2966300,3338800,22188000,87630700,109818700
2640,67863,15058016,05- Review,2015-09-03T00:00:00.000Z,189400,1349900,1539300,16863000,69308100,86171100
2644,67863,15058016,01- Annual,2014-01-01T00:00:00.000Z,189400,1379700,1569100,15330000,73784600,89114600
2648,67912,26001112,01- Annual,2016-01-01T00:00:00.000Z,772200,4472900,5245100,17990000,56785800,74775800
2652,67912,26001112,01- Annual,2017-01-01T00:00:00.000Z,772200,5181500,5953700,19018000,62224200,81242200
2656,67947,14035027,01- Annual,2013-01-01T00:00:00.000Z,3400,0,3400,167000,0,167000
2660,67981,35003439,01- Annual,2014-01-01T00:00:00.000Z,844900,0,844900,24778800,0,24778800
2664,67982,35003035,01- Annual,2013-01-01T00:00:00.000Z,136100,0,136100,3991200,0,3991200
2668,68003,17005012,01- Annual,2019-01-01T00:00:00.000Z,758100,3039900,3798000,40764000,144028600,184792600
2672,68006,35011010,01- Annual,2020-01-01T00:00:00.000Z,172800,1532500,1705300,30824600,140508900,171333500
2676,68006,35011010,03- Board of Equalization,2019-10-28T00:00:00.000Z,159500,3272500,3432000,30984100,130086000,161070100
2680,68006,35011010,05- Review,2014-08-07T00:00:00.000Z,405800,703000,1108800,32060000,124042900,156102900
2684,68006,35011010,01- Annual,2013-01-01T00:00:00.000Z,405800,696100,1101900,63840000,227252100,291092100
2688,68007,35011011,01- Annual,2016-01-01T00:00:00.000Z,0,0,0,36784600,118341200,155125800
2692,68007,35011011,01- Annual,2018-01-01T00:00:00.000Z,246300,0,246300,47607400,0,47607400
2696,68007,35011011,03- Board of Equalization,2019-10-31T00:00:00.000Z,246300,0,246300,47607400,128946200,176553600
2700,68034,14035028,01- Annual,2019-01-01T00:00:00.000Z,85900,100,86000,4803200,100,4803300
2704,68034,14035028,01- Annual,2016-01-01T00:00:00.000Z,0,0,0,100,0,100
2708,68103,05056127,01- Annual,2020-01-01T00:00:00.000Z,0,17900,17900,0,0,0
2712,68105,22011272,01- Annual,2017-01-01T00:00:00.000Z,333700,1595800,1929500,6142000,6034900,12176900
2716,68107,14035029,01- Annual,2018-01-01T00:00:00.000Z,768900,4176700,4945600,43000000,157558500,200558500
2720,68151,15078025,01- Annual,2020-01-01T00:00:00.000Z,1189400,6752500,7941900,13330000,75983700,89313700
2724,68151,15078025,01- Annual,2017-01-01T00:00:00.000Z,1097900,6049700,7147600,13330000,66578400,79908400
2728,68362,35003022,05- Review,2016-04-05T00:00:00.000Z,2157700,2640400,4798100,48692300,68672800,117365100
2732,68363,35003023,01- Annual,2019-01-01T00:00:00.000Z,74800,0,74800,6397900,0,6397900
2736,68520,17011068,01- Annual,2018-01-01T00:00:00.000Z,1053800,9970800,11024600,16426000,72199600,88625600
2740,68520,17011068,03- Board of Equalization,2017-10-31T00:00:00.000Z,1053800,6042600,7096400,16426000,68225500,84651500
2744,68641,17011069,01- Annual,2015-01-01T00:00:00.000Z,2081100,9642800,11723900,14707000,51077600,65784600
2748,68773,20012393,05- Review,2016-05-10T00:00:00.000Z,132200,855800,988000,13203000,37695500,50898500
2752,68773,20012393,01- Annual,2019-01-01T00:00:00.000Z,132200,903000,1035200,14018000,40055500,54073500
2756,69223,15005010,05- Review,2018-03-07T00:00:00.000Z,449600,4453200,4902800,8220500,14158600,22379100
2760,69223,15005010,01- Annual,2018-01-01T00:00:00.000Z,449600,4515300,4964900,8220500,13071700,21292200
2764,69271,15003009,01- Annual,2019-01-01T00:00:00.000Z,213300,0,213300,3899500,52212000,56111500
2768,69271,15003009,03- Board of Equalization,2017-09-30T00:00:00.000Z,213300,0,213300,4809400,47059000,51868400
2772,69463,35003840,01- Annual,2019-01-01T00:00:00.000Z,2453500,16407100,18860600,60114000,329895100,390009100
2776,69508,18004071,03- Board of Equalization,2019-10-31T00:00:00.000Z,136200,1105900,1242100,4767800,16955500,21723300
2780,69508,18004071,01- Annual,2018-01-01T00:00:00.000Z,376300,0,376300,13169700,0,13169700
2784,69646,14032005,01- Annual,2019-01-01T00:00:00.000Z,355000,929600,1284600,22790000,99273600,122063600
2788,69705,23040015,01- Annual,2019-01-01T00:00:00.000Z,152900,4368400,4521300,3665700,274200,3939900
2792,69717,19007040,01- Annual,2019-01-01T00:00:00.000Z,501800,2873800,3375600,12384000,62241600,74625600
2796,69725,34027033,01- Annual,2018-01-01T00:00:00.000Z,403700,0,403700,35432000,92452900,127884900
2800,69726,34027034,05- Review,2018-08-23T00:00:00.000Z,0,0,0,17630000,0,17630000
2804,69889,13018058,01- Annual,2019-01-01T00:00:00.000Z,259600,1334900,1594500,14878000,67287300,82165300
2808,69936,35004010,05- Review,2020-03-16T00:00:00.000Z,0,0,0,37840000,146680900,184520900
